引き込む	引き込ま
すきかえす	すきかえさ
看取る	看取ら
睦む	睦ま
きこす	きこさ
つける	つけ
封切る	封切ら
逃げまどう	逃げまどわ
さしだす	さしださ
わりきる	わりきら
飛び抜ける	飛び抜け
書き直せる	書き直せ
ひしめきあう	ひしめきあわ
乗り組む	乗り組ま
引き戻す	引き戻さ
持てる	持て
立あう	立あわ
基づく	基づか
弓引く	弓引か
ぶち壊す	ぶち壊さ
わきあがる	わきあがら
語りつぐ	語りつが
問掛ける	問掛け
狙われる	狙われ
埋めあわす	埋めあわさ
喚ぶ	喚ば
しりぞける	しりぞけ
こす	こさ
大人ぶる	大人ぶら
居る	居
ねじふせる	ねじふせ
しゃくりあげる	しゃくりあげ
にごせる	にごせ
較べる	較べ
罷り越す	罷り越さ
射せる	射せ
描きだす	描きださ
けっとばす	けっとばさ
満つ	満た
明け放す	明け放さ
返り咲ける	返り咲け
誘い合わせる	誘い合わせ
つきつける	つきつけ
埋る	埋ら
かき乱す	かき乱さ
だまし取る	だまし取ら
配り歩く	配り歩か
抱き込む	抱き込ま
めしあがる	めしあがら
つうずる	つうぜ
ずば抜ける	ずば抜け
泣きぬれる	泣きぬれ
くしけずる	くしけずら
つみとる	つみとら
割戻す	割戻さ
さだまる	さだまら
睨み合う	睨み合わ
かわれる	かわれ
そむ	そま
後らす	後らさ
ごわする	ごわし
迷わす	迷わさ
泥む	泥ま
仕出す	仕出さ
おくする	おくし
逆らえる	逆らえ
居あわせる	居あわせ
苛立つ	苛立た
堕ちる	堕ち
慮る	慮ら
怖じ気立つ	怖じ気立た
きずく	きずか
とりあつかえる	とりあつかえ
扱き雑ぜる	扱き雑ぜ
はじける	はじけ
ふしおがむ	ふしおがま
黙る	黙ら
のめす	のめさ
危ぶむ	危ぶま
いりびたる	いりびたら
洗い流す	洗い流さ
呉れる	呉れ
定まる	定まら
ばかせる	ばかせ
語りあう	語りあわ
敬える	敬え
食らわせる	食らわせ
わたる	わたら
いいまわす	いいまわさ
打ち抜ける	打ち抜け
ヒネる	ヒネら
転げでる	転げで
打ちのめす	打ちのめさ
思い合せる	思い合せ
萎れる	萎れ
総べる	総べ
鳴らす	鳴らさ
貸出す	貸出さ
差し換える	差し換え
もぐり込む	もぐり込ま
睨む	睨ま
打ちつづく	打ちつづか
おいかける	おいかけ
ふりつもる	ふりつもら
かわく	かわか
はしりだせる	はしりだせ
省みる	省み
出合う	出合わ
といかえす	といかえさ
かぶさる	かぶさら
こづく	こづか
這う	這わ
縫う	縫わ
降込む	降込ま
はめこむ	はめこま
すみわたる	すみわたら
いふ	いは
思へる	思へ
刷りこむ	刷りこま
くらわせる	くらわせ
ゆすぶる	ゆすぶら
触れ合える	触れ合え
はねあがる	はねあがら
察する	察し
ころげおちる	ころげおち
すぐす	すぐさ
押しかえす	押しかえさ
ただよわす	ただよわさ
結論づける	結論づけ
しばり上げる	しばり上げ
欠く	欠か
乗り継ぐ	乗り継が
ひめる	ひめ
むせびなく	むせびなか
やじる	やじら
けっする	けっし
みかぎる	みかぎら
わりあてる	わりあて
かき立てる	かき立て
あわてふためく	あわてふためか
吸付ける	吸付け
ごねる	ごね
ほざく	ほざか
せめぐ	せめが
食さがる	食さがら
追い打つ	追い打た
休まれる	休まれ
動じる	動じ
染まる	染まら
立ち迷う	立ち迷わ
染め上げる	染め上げ
たちむかう	たちむかわ
はかれる	はかれ
巻き付く	巻き付か
光らせる	光らせ
挫ける	挫け
燃え移る	燃え移ら
鈍する	鈍し
ふくれあがる	ふくれあがら
いいそこなう	いいそこなわ
ぶんなげる	ぶんなげ
生い立つ	生い立た
ごたつく	ごたつか
うろたえる	うろたえ
燃える	燃え
はむかう	はむかわ
推する	推し
取逃す	取逃さ
乗り通す	乗り通さ
よそおう	よそおわ
さむけだつ	さむけだた
こぼれおちる	こぼれおち
かいつくす	かいつくさ
祀る	祀ら
痛め付ける	痛め付け
持ちきる	持ちきら
疑える	疑え
掻き曇る	掻き曇ら
返り咲く	返り咲か
うばえる	うばえ
願い出る	願い出
落ち延びる	落ち延び
辱める	辱め
おったてる	おったて
編み出す	編み出さ
呼び止める	呼び止め
澄みきる	澄みきら
踏みきる	踏みきら
寄り付く	寄り付か
だきこむ	だきこま
轟かせる	轟かせ
仰ける	仰け
毒する	毒し
かかえる	かかえ
ほふる	ほふら
捻る	捻ら
触り合う	触り合わ
角張る	角張ら
悦ぶ	悦ば
いちづける	いちづけ
仕込める	仕込め
くいこめる	くいこめ
組みこむ	組みこま
おそう	おそわ
あつかえる	あつかえ
嘱する	嘱し
なげきくらす	なげきくらさ
けやぶる	けやぶら
つくりなおす	つくりなおさ
まるめる	まるめ
しびれる	しびれ
溶けあう	溶けあわ
突き合わす	突き合わさ
はぐる	はぐら
頼む	頼ま
ゆがむ	ゆがま
はみ出る	はみ出
あおむ	あおま
玩ぶ	玩ば
裁てる	裁て
ちりいそぐ	ちりいそが
棚引く	棚引か
引き下がる	引き下がら
てぐすねひく	てぐすねひか
括れる	括れ
引き締まる	引き締まら
参れる	参れ
立ちならぶ	立ちならば
そらうそぶく	そらうそぶか
羨む	羨ま
ふきかえす	ふきかえさ
はぐ	はが
みはらす	みはらさ
けおされる	けおされ
洒落れる	洒落れ
おもいやる	おもいやら
ふとる	ふとら
ちぢらす	ちぢらさ
うちまくる	うちまくら
明け残る	明け残ら
ひきわたす	ひきわたさ
ならびたてる	ならびたて
書き出せる	書き出せ
聞きつける	聞きつけ
研ぐ	研が
つきはなせる	つきはなせ
萌む	萌ま
ませる	ませ
折り込める	折り込め
ふり入れる	ふり入れ
押し分ける	押し分け
見慣れる	見慣れ
跳ねのける	跳ねのけ
染む	染ま
訃ぐ	訃が
拒める	拒め
貫き通せる	貫き通せ
くねる	くねら
ふりやむ	ふりやま
ゆらぐ	ゆらが
読み切れる	読み切れ
ようだつ	ようだた
またす	またさ
畳み込める	畳み込め
掛け合える	掛け合え
誘い出す	誘い出さ
のりまわす	のりまわさ
ほぐせる	ほぐせ
ぜっする	ぜっし
蔵する	蔵し
食い違う	食い違わ
印す	印さ
手古摺る	手古摺ら
まびける	まびけ
わりこむ	わりこま
しくむ	しくま
怪しむ	怪しま
締めつける	締めつけ
受ける	受け
立ちどまる	立ちどまら
はいりきる	はいりきら
証す	証さ
漕げる	漕げ
捜しまわる	捜しまわら
ゆきわたる	ゆきわたら
相入れる	相入れ
奏す	奏さ
悦べる	悦べ
料る	料ら
吸い寄せる	吸い寄せ
せぐくまる	せぐくまら
よえる	よえ
阻める	阻め
くるわす	くるわさ
わすれさる	わすれさら
隠る	隠ら
おもいのこす	おもいのこさ
探し出せる	探し出せ
成さがる	成さがら
およげる	およげ
引き換える	引き換え
引き離せる	引き離せ
さえわたる	さえわたら
抱き起こせる	抱き起こせ
むち打つ	むち打た
抗う	抗わ
しょげかえる	しょげかえら
取り調べる	取り調べ
捕われる	捕われ
なる	なら
ふししずむ	ふししずま
寂する	寂し
取り持つ	取り持た
おもいあたる	おもいあたら
語りかける	語りかけ
引っ越せる	引っ越せ
おもいなす	おもいなさ
けす	けさ
ぎらつく	ぎらつか
きりくむ	きりくま
刻める	刻め
世ばなれる	世ばなれ
ひっくくる	ひっくくら
そぼぬれる	そぼぬれ
教え諭す	教え諭さ
織り込める	織り込め
仰け反る	仰け反ら
けがれる	けがれ
聞漏らす	聞漏らさ
あざける	あざけら
飼う	飼わ
引っ括める	引っ括め
ひょうげる	ひょうげ
延べる	延べ
かけ隔てる	かけ隔て
播く	播か
かすめ取る	かすめ取ら
くだす	くださ
角立つ	角立た
ほこる	ほこら
芽ぶく	芽ぶか
疲れはてる	疲れはて
くわわる	くわわら
追い付く	追い付か
差し上る	差し上ら
踏ん切る	踏ん切ら
ぬきはなつ	ぬきはなた
言い付ける	言い付け
そよ吹く	そよ吹か
ぼる	ぼら
蹲る	蹲ら
繰下げる	繰下げ
率いる	率い
化かす	化かさ
労する	労し
持ちかえれる	持ちかえれ
つぎたす	つぎたさ
住成す	住成さ
締切る	締切ら
挙がる	挙がら
突っぱる	突っぱら
出歩ける	出歩け
せる	せら
躙り寄る	躙り寄ら
排す	排さ
いさよう	いさよわ
飲み潰す	飲み潰さ
迎える	迎え
参らす	参らさ
張りつく	張りつか
にげまわる	にげまわら
押掛ける	押掛け
掻き集める	掻き集め
住みつぶ	住みつば
妬む	妬ま
愁える	愁え
はりつめる	はりつめ
追い立てる	追い立て
そりかえる	そりかえら
演ずる	演ぜ
取り立てる	取り立て
縁どる	縁どら
侍れる	侍れ
飛び跳ねる	飛び跳ね
つかいこむ	つかいこま
忌む	忌ま
ひとかわむける	ひとかわむけ
くりよせる	くりよせ
掛け離れる	掛け離れ
立替える	立替え
蹴落す	蹴落さ
寝そべる	寝そべら
ひいでる	ひいで
ほりつける	ほりつけ
拾う	拾わ
もうしかねる	もうしかね
明るむ	明るま
張詰める	張詰め
吸いこむ	吸いこま
流れ着く	流れ着か
降り懸る	降り懸ら
植わる	植わら
追いやれる	追いやれ
すり付ける	すり付け
乗りつける	乗りつけ
飛あがる	飛あがら
いきおいづける	いきおいづけ
もどく	もどか
うつむける	うつむけ
たもちあう	たもちあわ
かっきづく	かっきづか
取れる	取れ
語り合う	語り合わ
討ち果たす	討ち果たさ
まわす	まわさ
たちあがれる	たちあがれ
取り毀す	取り毀さ
跡絶える	跡絶え
裏がえる	裏がえら
解明かす	解明かさ
加え持つ	加え持た
あてこめる	あてこめ
せき立てる	せき立て
くちる	くち
きがえる	きがえ
輝り返す	輝り返さ
じれる	じれ
やっかむ	やっかま
あそびまわれる	あそびまわれ
書入れる	書入れ
のり出す	のり出さ
あてはまる	あてはまら
ふえる	ふえ
折れ曲がる	折れ曲がら
惜しむ	惜しま
かきおくる	かきおくら
つきさせる	つきさせ
ひりつく	ひりつか
うかす	うかさ
薫ずる	薫ぜ
めしあげる	めしあげ
ききかえす	ききかえさ
焼け出す	焼け出さ
掛ける	掛け
置忘れる	置忘れ
筋ばる	筋ばら
浮腫む	浮腫ま
散らばる	散らばら
与する	与し
負かる	負から
願える	願え
重なる	重なら
弑する	弑し
つんざく	つんざか
読通す	読通さ
まるめこむ	まるめこま
息張る	息張ら
きおう	きおわ
直る	直ら
回り込む	回り込ま
つんのめる	つんのめら
おいしげる	おいしげら
屈む	屈ま
孵す	孵さ
取散らす	取散らさ
つぎあわせる	つぎあわせ
まちあわせる	まちあわせ
思い起す	思い起さ
決める	決め
漉く	漉か
引きおこす	引きおこさ
貧する	貧し
まるまる	まるまら
うまれかわる	うまれかわら
さきでる	さきで
突き合せる	突き合せ
しわめる	しわめ
出し切れる	出し切れ
居直る	居直ら
よびだせる	よびだせ
なんなんとする	なんなんとし
出会う	出会わ
叶える	叶え
かいくぐる	かいくぐら
遵う	遵わ
混ざる	混ざら
ずり落ちる	ずり落ち
挙げる	挙げ
減る	減ら
はきちがえる	はきちがえ
解け合う	解け合わ
せぐりあげる	せぐりあげ
みまわる	みまわら
飲み込める	飲み込め
拭き込む	拭き込ま
田舎びる	田舎び
かもしだせる	かもしだせ
行なう	行なわ
うるおす	うるおさ
とがらす	とがらさ
来あわす	来あわさ
みせつける	みせつけ
かたよせる	かたよせ
拒む	拒ま
閉じ込もる	閉じ込もら
かりとる	かりとら
おびやかす	おびやかさ
比す	比さ
仕損じる	仕損じ
打切れる	打切れ
息巻く	息巻か
追っ払う	追っ払わ
扠置く	扠置か
飛びのる	飛びのら
さかのぼる	さかのぼら
休らう	休らわ
生れかわる	生れかわら
かきたてる	かきたて
くっつける	くっつけ
寝とぼける	寝とぼけ
擂れる	擂れ
瀬切る	瀬切ら
試せる	試せ
託す	託さ
洩る	洩ら
向ける	向け
ぬすめる	ぬすめ
つれそう	つれそわ
もりたてる	もりたて
ふみこたえる	ふみこたえ
とりあつめる	とりあつめ
哮る	哮ら
見初める	見初め
突っ返す	突っ返さ
立ち退ける	立ち退け
寝ころぶ	寝ころば
試す	試さ
だきあわせる	だきあわせ
てっする	てっし
しのげる	しのげ
チラつく	チラつか
書抜く	書抜か
後ずさる	後ずさら
起す	起さ
さえずる	さえずら
裂く	裂か
そこなう	そこなわ
みいる	みいら
突ぷす	突ぷさ
はじき出す	はじき出さ
うめこむ	うめこま
出ばる	出ばら
乗り切れる	乗り切れ
ふくせる	ふくせ
かいもどす	かいもどさ
仕舞う	仕舞わ
かける	かけ
往ぬ	往な
聞える	聞え
読替える	読替え
はこびこむ	はこびこま
暇どる	暇どら
頂ける	頂け
競り落す	競り落さ
立込む	立込ま
晴あがる	晴あがら
費す	費さ
けたおす	けたおさ
いいのこす	いいのこさ
きりだす	きりださ
とりくずせる	とりくずせ
くいあう	くいあわ
ほそめる	ほそめ
切取る	切取ら
吐く	吐か
のろける	のろけ
しろしめす	しろしめさ
じする	じし
具える	具え
取りこむ	取りこま
渡せる	渡せ
ほめそやす	ほめそやさ
彩れる	彩れ
むくむ	むくま
与る	与ら
そろえる	そろえ
ねがう	ねがわ
嵌る	嵌ら
沖する	沖し
持する	持し
もがく	もがか
おれ込む	おれ込ま
運び出す	運び出さ
いがみあう	いがみあわ
はさみ切る	はさみ切ら
ふんだくる	ふんだくら
まなべる	まなべ
にごる	にごら
すきこのむ	すきこのま
座す	座さ
頑ばる	頑ばら
ずぬける	ずぬけ
縛りつける	縛りつけ
くみ取る	くみ取ら
履く	履か
とりおさえる	とりおさえ
話し込む	話し込ま
駆立てる	駆立て
のりつぐ	のりつが
あらす	あらさ
はきだす	はきださ
いたむ	いたま
売りはらう	売りはらわ
ひきかえる	ひきかえ
ふりしきる	ふりしきら
やすまる	やすまら
きたす	きたさ
ようする	ようし
かきしるせる	かきしるせ
はせむかう	はせむかわ
近寄せる	近寄せ
錬れる	錬れ
挙る	挙ら
差回す	差回さ
鬱ぐ	鬱が
含まる	含まら
遷す	遷さ
練る	練ら
寛げる	寛げ
ころがりこむ	ころがりこま
汲み取れる	汲み取れ
仕掛ける	仕掛け
めさる	めさら
はいる	はいら
造る	造ら
抱留める	抱留め
啜り上げる	啜り上げ
堕す	堕さ
はやまる	はやまら
入りびたる	入りびたら
つったてる	つったて
きわだたす	きわだたさ
みせびらかす	みせびらかさ
めあわせる	めあわせ
あやしむ	あやしま
乞う	乞わ
あざなう	あざなわ
切り回す	切り回さ
ながれでる	ながれで
伴う	伴わ
宛てがう	宛てがわ
取り直す	取り直さ
摘む	摘ま
見て取る	見て取ら
ひっかつぐ	ひっかつが
引具する	引具し
引き伸ばせる	引き伸ばせ
考えつく	考えつか
しわる	しわら
揺する	揺すら
みちたりる	みちたり
聞返す	聞返さ
作る	作ら
くやむ	くやま
ふり向く	ふり向か
手折る	手折ら
ぬえる	ぬえ
残れる	残れ
下さる	下さら
てんずる	てんぜ
やみほうける	やみほうけ
駆け込める	駆け込め
やしなう	やしなわ
冷める	冷め
むかえいれる	むかえいれ
慰する	慰し
あきあきする	あきあきし
勤まる	勤まら
移れる	移れ
吹掛ける	吹掛け
盛上げる	盛上げ
落し入れる	落し入れ
はせ着ける	はせ着け
しこめる	しこめ
きりまくる	きりまくら
引ける	引け
凌ぐ	凌が
張り合える	張り合え
みまかる	みまから
言いなす	言いなさ
説おこす	説おこさ
くっする	くっし
懸かる	懸から
ふさげる	ふさげ
いそがす	いそがさ
唄える	唄え
もる	もら
こびりつく	こびりつか
引換える	引換え
はじめる	はじめ
よろこびあう	よろこびあわ
すみなす	すみなさ
ともす	ともさ
食散らす	食散らさ
つみのこす	つみのこさ
伺う	伺わ
導く	導か
たたみこむ	たたみこま
寛ぐ	寛が
折り畳む	折り畳ま
はらいこむ	はらいこま
しゃがれる	しゃがれ
垣間みる	垣間み
みすごせる	みすごせ
差し昇る	差し昇ら
うごかす	うごかさ
黒みがかる	黒みがから
垂れこめる	垂れこめ
持上げる	持上げ
立働く	立働か
あみだす	あみださ
つきのける	つきのけ
返す	返さ
整える	整え
食み出でる	食み出で
ききおよぶ	ききおよば
進ぜる	進ぜ
かなぐりすてる	かなぐりすて
送り込む	送り込ま
かみ締める	かみ締め
振り乱す	振り乱さ
見失う	見失わ
彷徨く	彷徨か
離れる	離れ
張り飛ばす	張り飛ばさ
白茶ける	白茶け
はちきれる	はちきれ
漬かる	漬から
振乱す	振乱さ
筋張る	筋張ら
わめく	わめか
張りきる	張りきら
差す	差さ
つきとばす	つきとばさ
賦する	賦し
そりくり返る	そりくり返ら
ひわれる	ひわれ
押さえつける	押さえつけ
振り撒く	振り撒か
切り抜く	切り抜か
舐めずる	舐めずら
振り翳す	振り翳さ
連ねる	連ね
生き延びる	生き延び
まぶす	まぶさ
たて込む	たて込ま
ひく	ひか
鋳込む	鋳込ま
滑べる	滑べら
みすごす	みすごさ
感極まる	感極まら
言いくるめる	言いくるめ
いみきらう	いみきらわ
刈り急ぐ	刈り急が
賭す	賭さ
僻する	僻し
競り合える	競り合え
泣ぬれる	泣ぬれ
みまもれる	みまもれ
怒り狂う	怒り狂わ
撓める	撓め
つがえる	つがえ
待ち合わす	待ち合わさ
盗む	盗ま
側める	側め
先細る	先細ら
うけつぐ	うけつが
探れる	探れ
鼻じろむ	鼻じろま
挟む	挟ま
いこむ	いこま
たのしむ	たのしま
うりまくれる	うりまくれ
混ぜかえす	混ぜかえさ
取り出す	取り出さ
よびとめる	よびとめ
抜き出す	抜き出さ
跨る	跨ら
ほかなる	ほかなら
あり合せる	あり合せ
なきこむ	なきこま
つけ込む	つけ込ま
競り上げる	競り上げ
言い繕う	言い繕わ
繙く	繙か
推し進める	推し進め
価する	価し
もりあわせる	もりあわせ
いじる	いじら
釣り出す	釣り出さ
やっつける	やっつけ
ひり出す	ひり出さ
言い逃れる	言い逃れ
とびだせる	とびだせ
かえす	かえさ
しょう	しょわ
いじける	いじけ
もたげる	もたげ
出ぱる	出ぱら
こう	こわ
騙かす	騙かさ
苦しめる	苦しめ
やみつく	やみつか
打出せる	打出せ
ひっ掻く	ひっ掻か
えんづく	えんづか
窪める	窪め
ちまよう	ちまよわ
すぎる	すぎ
転がせる	転がせ
たちいる	たちいら
着飾れる	着飾れ
つきしたがう	つきしたがわ
ふりこむ	ふりこま
書き分ける	書き分け
浴する	浴し
編出す	編出さ
飛込む	飛込ま
驚き入る	驚き入ら
笑み割れる	笑み割れ
とりはからえる	とりはからえ
掬ぶ	掬ば
暗ます	暗まさ
茹でる	茹で
取り戻せる	取り戻せ
病みつく	病みつか
ネグる	ネグら
卷く	卷か
はこぶ	はこば
せんじる	せんじ
祈れる	祈れ
命じる	命じ
喜ぶ	喜ば
みしる	みしら
爛れる	爛れ
囀る	囀ら
さきだつ	さきだた
薨ずる	薨ぜ
見兼ねる	見兼ね
あいともなう	あいともなわ
小突く	小突か
おりあげる	おりあげ
きらめむ	きらめま
掻き起す	掻き起さ
思いかえす	思いかえさ
やりかえせる	やりかえせ
ちばしる	ちばしら
かみわける	かみわけ
さしおく	さしおか
なれ合う	なれ合わ
見かける	見かけ
おおわれる	おおわれ
かちあう	かちあわ
たたき起こせる	たたき起こせ
成り済ます	成り済まさ
おじけづく	おじけづか
くみ出せる	くみ出せ
なやむ	なやま
頼み込む	頼み込ま
ゆずる	ゆずら
転ずる	転ぜ
息まく	息まか
ひぞる	ひぞら
青む	青ま
づける	づけ
ひろう	ひろわ
ござる	ござら
蹴出す	蹴出さ
ふする	ふし
きりはらう	きりはらわ
遣いこむ	遣いこま
もたせ掛ける	もたせ掛け
遣り込める	遣り込め
なかす	なかさ
ちえづく	ちえづか
混ぜ合う	混ぜ合わ
噛める	噛め
煮え返る	煮え返ら
飾り立てる	飾り立て
古びる	古び
とび出る	とび出
感じる	感じ
奬める	奬め
吊す	吊さ
つれもどせる	つれもどせ
握れる	握れ
えり分ける	えり分け
焚き染める	焚き染め
由る	由ら
あまんじる	あまんじ
振替える	振替え
産みつける	産みつけ
植え込める	植え込め
沸き起これる	沸き起これ
目覚める	目覚め
委せる	委せ
住み慣れる	住み慣れ
思ほす	思ほさ
みちがえる	みちがえ
せめのぼる	せめのぼら
気どる	気どら
したしむ	したしま
持ち合わせる	持ち合わせ
置換わる	置換わら
聞流す	聞流さ
追い落とす	追い落とさ
焦れ込む	焦れ込ま
歌う	歌わ
極める	極め
ねせる	ねせ
つづめる	つづめ
ろんずる	ろんぜ
書き下ろす	書き下ろさ
綴れる	綴れ
かねる	かね
凍り付く	凍り付か
見損なう	見損なわ
すんたる	すんたら
計る	計ら
開き直れる	開き直れ
取りそろえる	取りそろえ
割り戻せる	割り戻せ
しみこむ	しみこま
にげうせる	にげうせ
しつける	しつけ
すりまぜる	すりまぜ
とりあう	とりあわ
匂わせる	匂わせ
転がり込む	転がり込ま
貸切る	貸切ら
縫い込む	縫い込ま
ひきつづける	ひきつづけ
割りあてる	割りあて
ぼうする	ぼうし
ひたす	ひたさ
振り落とす	振り落とさ
ひきおろす	ひきおろさ
みおろせる	みおろせ
立ふさがる	立ふさがら
切付ける	切付け
目慣れる	目慣れ
ころがる	ころがら
付き従う	付き従わ
はたらきかける	はたらきかけ
ちかづける	ちかづけ
立ち返る	立ち返ら
むかつく	むかつか
芽生える	芽生え
侮れる	侮れ
取り去れる	取り去れ
ぶちこわす	ぶちこわさ
期す	期さ
伝わる	伝わら
任じる	任じ
つま先立つ	つま先立た
うけあう	うけあわ
垂れ込む	垂れ込ま
勝取る	勝取ら
ちからつきる	ちからつき
踏んばる	踏んばら
かちこせる	かちこせ
たがる	たがら
おく	おか
咲き乱れる	咲き乱れ
ねんじる	ねんじ
留める	留め
打ちよせる	打ちよせ
つっこめる	つっこめ
おもう	おもわ
已める	已め
つちかう	つちかわ
ききかえせる	ききかえせ
みやる	みやら
仇する	仇し
きょうする	きょうし
むきなおる	むきなおら
突き放す	突き放さ
引き立てる	引き立て
やききる	やききら
取上げる	取上げ
あばれまわる	あばれまわら
きりとれる	きりとれ
忍び込める	忍び込め
取りあつかう	取りあつかわ
掻っ切る	掻っ切ら
突き止める	突き止め
もえひろがる	もえひろがら
ねぼける	ねぼけ
むかいあわす	むかいあわさ
捏ね返す	捏ね返さ
拘わる	拘わら
遣う	遣わ
たまわる	たまわら
ひっ篭る	ひっ篭ら
酔いしれる	酔いしれ
とどろく	とどろか
かかわりあう	かかわりあわ
カミつく	カミつか
いいきかせる	いいきかせ
隔てる	隔て
攻あぐむ	攻あぐま
ハサむ	ハサま
かざりたてる	かざりたて
呷る	呷ら
てわたす	てわたさ
取もつ	取もた
はぎとれる	はぎとれ
組替える	組替え
寝過す	寝過さ
けむる	けむら
ゆらせる	ゆらせ
畏れ入る	畏れ入ら
歩ける	歩け
すりつぶす	すりつぶさ
踏める	踏め
臆する	臆し
踏み越える	踏み越え
けかえす	けかえさ
疼く	疼か
語りこめる	語りこめ
ぬきとれる	ぬきとれ
つけ加える	つけ加え
なきさけぶ	なきさけば
くじく	くじか
名指す	名指さ
しょたいじみる	しょたいじみ
焦がれる	焦がれ
会わす	会わさ
坐る	坐ら
入れ揚げる	入れ揚げ
舐める	舐め
うけながす	うけながさ
てつだう	てつだわ
慈しむ	慈しま
握り潰す	握り潰さ
たえいる	たえいら
さばける	さばけ
からみあう	からみあわ
おる	おら
まきおこせる	まきおこせ
はげおちる	はげおち
よめる	よめ
かきぬける	かきぬけ
打ち捨てる	打ち捨て
みやぶれる	みやぶれ
受入れる	受入れ
掛合う	掛合わ
はなしあえる	はなしあえ
迫り出す	迫り出さ
すする	すすら
見極める	見極め
畳み込む	畳み込ま
擦りむける	擦りむけ
脱捨てる	脱捨て
訃げる	訃げ
しずれる	しずれ
取りなす	取りなさ
咲きそろう	咲きそろわ
あたりちらす	あたりちらさ
取り落す	取り落さ
押し迫る	押し迫ら
けぶる	けぶら
途絶える	途絶え
熔ける	熔け
かんがみる	かんがみ
かけへだてる	かけへだて
あかちゃける	あかちゃけ
懐く	懐か
来あわせる	来あわせ
叱りつける	叱りつけ
ながれあるく	ながれあるか
伸び悩む	伸び悩ま
おえる	おえ
験する	験し
略する	略し
追いすがる	追いすがら
かがめる	かがめ
さうぞく	さうぞか
溶きほぐす	溶きほぐさ
すりきれる	すりきれ
とりとめる	とりとめ
立ち塞がる	立ち塞がら
たくむ	たくま
便じる	便じ
聘する	聘し
破ける	破け
行き過ぎる	行き過ぎ
うきだす	うきださ
ひくまる	ひくまら
恋い焦がれる	恋い焦がれ
糊する	糊し
すみかわる	すみかわら
死におくれる	死におくれ
理る	理ら
こと切れる	こと切れ
採りあげる	採りあげ
かけこめる	かけこめ
倍する	倍し
へこます	へこまさ
燃えつきる	燃えつき
す	さ
引っさげる	引っさげ
破る	破ら
へる	へ
閉じ込める	閉じ込め
ひしぐ	ひしが
つかれ果てる	つかれ果て
くろめる	くろめ
たちかえる	たちかえら
かざる	かざら
酔いつぶれる	酔いつぶれ
仕あがる	仕あがら
持ち込む	持ち込ま
嘆き暮す	嘆き暮さ
垂れる	垂れ
あえる	あえ
篩い落す	篩い落さ
いきとどく	いきとどか
付まとう	付まとわ
ぶつける	ぶつけ
こみいる	こみいら
ゆずれる	ゆずれ
うらびれる	うらびれ
哮り立つ	哮り立た
くいさがる	くいさがら
上げる	上げ
回す	回さ
生れ変る	生れ変ら
滅ぶ	滅ば
利す	利さ
ちらめく	ちらめか
伍する	伍し
たてかえる	たてかえ
伺ふ	伺は
絶つ	絶た
透きとおる	透きとおら
布く	布か
とがる	とがら
こなれる	こなれ
とっちめる	とっちめ
ふめる	ふめ
出す	出さ
おしかくす	おしかくさ
こぐらかる	こぐらから
そう	そわ
突っ切る	突っ切ら
締め出す	締め出さ
のぞめる	のぞめ
読み破る	読み破ら
弛める	弛め
仰ぐ	仰が
ねじ切る	ねじ切ら
迸る	迸ら
かちほこる	かちほこら
有り得る	有り得
掻き消える	掻き消え
よみくだす	よみくださ
煎じつめる	煎じつめ
泣き腫らす	泣き腫らさ
貶する	貶し
突飛ばす	突飛ばさ
とぎれる	とぎれ
明らむ	明らま
あさる	あさら
待ちかまえる	待ちかまえ
したがえる	したがえ
畳める	畳め
呼び戻す	呼び戻さ
打上げる	打上げ
言放つ	言放た
抱き込める	抱き込め
そめあがる	そめあがら
見繕う	見繕わ
若返れる	若返れ
つかいこなす	つかいこなさ
泣き沈む	泣き沈ま
釈ける	釈け
跳びつく	跳びつか
きたえあげる	きたえあげ
うけとれる	うけとれ
ねじまげる	ねじまげ
割り引ける	割り引け
陥る	陥ら
沸きあがる	沸きあがら
嘶える	嘶え
立ち向かえる	立ち向かえ
引き降ろせる	引き降ろせ
替る	替ら
よみかえす	よみかえさ
ひきちぎれる	ひきちぎれ
弔える	弔え
汗する	汗し
窪まる	窪まら
配する	配し
せせる	せせら
褪める	褪め
さえ返る	さえ返ら
よむ	よま
すがりつく	すがりつか
理解し合う	理解し合わ
験す	験さ
まく	まか
たくらむ	たくらま
みたてる	みたて
思い浮かべる	思い浮かべ
焚きつける	焚きつけ
作れる	作れ
のびあがる	のびあがら
あいす	あいさ
あらだつ	あらだた
はりきれる	はりきれ
立ち退く	立ち退か
おびき寄せる	おびき寄せ
這いずる	這いずら
手折れる	手折れ
嘉する	嘉し
剃り落とせる	剃り落とせ
候う	候わ
しゃくり上げる	しゃくり上げ
貫く	貫か
葬る	葬ら
語り込む	語り込ま
食い荒らす	食い荒らさ
取り乱す	取り乱さ
参らせる	参らせ
譏る	譏ら
もうでる	もうで
死する	死し
継ぎあわせる	継ぎあわせ
悴む	悴ま
住みなす	住みなさ
しとる	しとら
とんがらかす	とんがらかさ
交ぜ返す	交ぜ返さ
立ち止る	立ち止ら
押黙る	押黙ら
書きあげる	書きあげ
貸し切る	貸し切ら
あつらえる	あつらえ
沸く	沸か
跳上がる	跳上がら
飲込む	飲込ま
つみあげる	つみあげ
徹す	徹さ
まどう	まどわ
引き揚げる	引き揚げ
書き付ける	書き付け
見落とす	見落とさ
掻き毟る	掻き毟ら
付け廻す	付け廻さ
消うせる	消うせ
さがしもとめる	さがしもとめ
かけあう	かけあわ
慣らせる	慣らせ
とりやめる	とりやめ
痩ける	痩け
押し隠せる	押し隠せ
架かる	架から
さわす	さわさ
こころがける	こころがけ
ぬかす	ぬかさ
飢える	飢え
ながせる	ながせ
成立つ	成立た
はなしだす	はなしださ
弱める	弱め
打返す	打返さ
打ち合わす	打ち合わさ
打ち切る	打ち切ら
うなずく	うなずか
ふくらます	ふくらまさ
吐ける	吐け
差掛ける	差掛け
打ち返す	打ち返さ
打払う	打払わ
思う	思わ
汲み乾す	汲み乾さ
はね上がる	はね上がら
さんけづく	さんけづか
よこたわる	よこたわら
寝取る	寝取ら
つっかえす	つっかえさ
あびる	あび
冀う	冀わ
刺さる	刺さら
ふきつける	ふきつけ
はせつける	はせつけ
乗り継げる	乗り継げ
改める	改め
吹き荒ぶ	吹き荒ば
遠ざける	遠ざけ
輝る	輝ら
懸隔てる	懸隔て
たちきる	たちきら
吹き飛ばせる	吹き飛ばせ
煩い付く	煩い付か
思い残す	思い残さ
そっくり返る	そっくり返ら
すておく	すておか
召しかかえる	召しかかえ
取り繕う	取り繕わ
呆れかえる	呆れかえら
しみ込む	しみ込ま
取消す	取消さ
くさる	くさら
ほのめく	ほのめか
聞分ける	聞分け
たもちあえる	たもちあえ
ゆく	ゆか
切れ込む	切れ込ま
ねれる	ねれ
むせる	むせ
たかぶる	たかぶら
ほどこせる	ほどこせ
かかり合う	かかり合わ
染み込む	染み込ま
積み残す	積み残さ
食える	食え
張り付ける	張り付け
つり合う	つり合わ
のし上がる	のし上がら
思い切れる	思い切れ
みかえる	みかえら
はしりぬける	はしりぬけ
拠る	拠ら
てる	て
だきとる	だきとら
攀じ登る	攀じ登ら
こいこがれる	こいこがれ
なみだする	なみだし
すべりこむ	すべりこま
見粉う	見粉わ
打落す	打落さ
きする	きし
ひきずりだせる	ひきずりだせ
ころげでる	ころげで
建ち並ぶ	建ち並ば
往く	往か
みとる	みとら
巡る	巡ら
読み流す	読み流さ
代る	代ら
罷める	罷め
かかえ込む	かかえ込ま
まぜっかえす	まぜっかえさ
おりあう	おりあわ
ゐる	ゐ
見せかける	見せかけ
かつげる	かつげ
きりまわす	きりまわさ
躊躇う	躊躇わ
しんじる	しんじ
堪え忍ぶ	堪え忍ば
すべりこめる	すべりこめ
おとす	おとさ
射竦める	射竦め
付加わる	付加わら
捲れる	捲れ
たがえる	たがえ
かかわり合う	かかわり合わ
はねだす	はねださ
うたいまくる	うたいまくら
過す	過さ
こおりつく	こおりつか
科す	科さ
連れ帰る	連れ帰ら
まくる	まくら
抓む	抓ま
おどり上がる	おどり上がら
切り立つ	切り立た
見馴れる	見馴れ
振り分ける	振り分け
撃ち合う	撃ち合わ
うかべる	うかべ
饐える	饐え
思いとどまる	思いとどまら
ふりおとす	ふりおとさ
組付く	組付か
聞き落す	聞き落さ
かき分ける	かき分け
洗える	洗え
うったえる	うったえ
借切る	借切ら
こぎ着ける	こぎ着け
脹らす	脹らさ
分かつ	分かた
言いならわす	言いならわさ
挿頭す	挿頭さ
飛び込める	飛び込め
切出す	切出さ
いつぶす	いつぶさ
休まる	休まら
降ろせる	降ろせ
はためく	はためか
もうす	もうさ
死にかける	死にかけ
諌める	諌め
もとめる	もとめ
駆回る	駆回ら
くりこせる	くりこせ
キメる	キメ
取片付ける	取片付け
いすくめる	いすくめ
へんじる	へんじ
ほつれる	ほつれ
交わす	交わさ
うりはらえる	うりはらえ
混ぜ返す	混ぜ返さ
あれくるう	あれくるわ
摂する	摂し
ねがえる	ねがえ
ながす	ながさ
言い過ぎる	言い過ぎ
すだてる	すだて
ぼかす	ぼかさ
押込める	押込め
立ち遅れる	立ち遅れ
むくれる	むくれ
ひるむ	ひるま
降くらす	降くらさ
やすまれる	やすまれ
通れる	通れ
買いあさる	買いあさら
巡らす	巡らさ
持ち去る	持ち去ら
縅す	縅さ
拭き取る	拭き取ら
あまえる	あまえ
じゅくす	じゅくさ
捻り回す	捻り回さ
過る	過ら
歩く	歩か
売りつくす	売りつくさ
ひらめく	ひらめか
叙する	叙し
咲かせる	咲かせ
おどりかかる	おどりかから
きかす	きかさ
契れる	契れ
つきあげる	つきあげ
おっつける	おっつけ
恋う	恋わ
くさらす	くさらさ
にじむ	にじま
みとれる	みとれ
欲張る	欲張ら
つっこむ	つっこま
呼び込める	呼び込め
取去る	取去ら
嵌め込む	嵌め込ま
焼きつける	焼きつけ
恵まれる	恵まれ
切かかる	切かから
見晴らす	見晴らさ
聞き出せる	聞き出せ
眩む	眩ま
得る	得
さおさす	さおささ
かわす	かわさ
替える	替え
といつめる	といつめ
濾せる	濾せ
突き抜ける	突き抜け
育て上げる	育て上げ
見すかせる	見すかせ
歴る	歴
生きる	生き
道ける	道け
願う	願わ
噛みわける	噛みわけ
取り決める	取り決め
着ける	着け
気がつく	気がつか
つつしむ	つつしま
泳げる	泳げ
おいる	おい
かいあげる	かいあげ
書き抜く	書き抜か
乾涸びる	乾涸び
繋げる	繋げ
割りふる	割りふら
縮れる	縮れ
紛らかす	紛らかさ
驚く	驚か
失う	失わ
かりかえる	かりかえ
かきそえる	かきそえ
買い取る	買い取ら
口ごもる	口ごもら
くいつく	くいつか
突詰める	突詰め
とりけす	とりけさ
しにたえる	しにたえ
煮詰まる	煮詰まら
あきれ果てる	あきれ果て
役立てる	役立て
ありつく	ありつか
動き出す	動き出さ
切り詰める	切り詰め
行交う	行交わ
求め行く	求め行か
枯ればむ	枯ればま
バカげる	バカげ
絡まる	絡まら
下げる	下げ
曳ける	曳け
せっぱ詰まる	せっぱ詰まら
組みつく	組みつか
ほうりだす	ほうりださ
手馴れる	手馴れ
転がる	転がら
抱き合う	抱き合わ
しおれる	しおれ
割り付ける	割り付け
飛ばせる	飛ばせ
にじる	にじら
よくばる	よくばら
つめこめる	つめこめ
夢見る	夢見
はんじる	はんじ
冷やす	冷やさ
めしかかえる	めしかかえ
丸め込む	丸め込ま
見落す	見落さ
飲潰す	飲潰さ
撃つ	撃た
むくう	むくわ
ありあまる	ありあまら
つまどる	つまどら
囃す	囃さ
認める	認め
ときめかす	ときめかさ
儀式張る	儀式張ら
恍ける	恍け
あたける	あたけ
制する	制し
見せ付ける	見せ付け
流れる	流れ
はせ参ずる	はせ参ぜ
掻き分ける	掻き分け
適す	適さ
出歩く	出歩か
舞上がる	舞上がら
関係付ける	関係付け
舂く	舂か
縁付ける	縁付け
まかり間違う	まかり間違わ
軽しめる	軽しめ
ひっこす	ひっこさ
ゆき暮れる	ゆき暮れ
ほれ込む	ほれ込ま
ふりはじめる	ふりはじめ
越える	越え
うめる	うめ
誅する	誅し
學ぶ	學ば
被ける	被け
かきながす	かきながさ
詰めかける	詰めかけ
窮め尽くす	窮め尽くさ
整え直す	整え直さ
遮れる	遮れ
しれわたる	しれわたら
すみなれる	すみなれ
なげこめる	なげこめ
投げ勝てる	投げ勝て
ていする	ていし
なやます	なやまさ
突きとばす	突きとばさ
当たれる	当たれ
さかだつ	さかだた
なげだせる	なげだせ
かきこむ	かきこま
振当てる	振当て
つかいわける	つかいわけ
誣いる	誣い
ゆき渡る	ゆき渡ら
はたける	はたけ
碎く	碎か
抱き着く	抱き着か
ひっくるめる	ひっくるめ
吹っ飛ぶ	吹っ飛ば
押しこめる	押しこめ
さいはじける	さいはじけ
ととのう	ととのわ
誹る	誹ら
わきおこれる	わきおこれ
はりあげる	はりあげ
折り合う	折り合わ
置きわすれる	置きわすれ
ひざまずく	ひざまずか
かたまる	かたまら
言誤る	言誤ら
うち続く	うち続か
有り触れる	有り触れ
生い育つ	生い育た
擦寄る	擦寄ら
書下す	書下さ
のこる	のこら
当て擦る	当て擦ら
思いなす	思いなさ
杓う	杓わ
とおせる	とおせ
住みかえる	住みかえ
そこしる	そこしら
責め落とす	責め落とさ
染出す	染出さ
つかめる	つかめ
いやます	いやまさ
竦む	竦ま
ならぶ	ならば
詰る	詰ら
排する	排し
のしかかる	のしかから
集る	集ら
振分ける	振分け
かんがえつく	かんがえつか
求まる	求まら
ゆわえ付ける	ゆわえ付け
吊れる	吊れ
聞き込む	聞き込ま
もえあがる	もえあがら
さきみだれる	さきみだれ
侮る	侮ら
まかり通る	まかり通ら
押し切れる	押し切れ
見とれる	見とれ
つづまる	つづまら
みさだめる	みさだめ
こましゃくれる	こましゃくれ
遊び回れる	遊び回れ
うつしとる	うつしとら
鞣す	鞣さ
でかける	でかけ
勝ちぬく	勝ちぬか
とって返す	とって返さ
ねぐ	ねが
みいだせる	みいだせ
掃きだす	掃きださ
切り取る	切り取ら
飛のく	飛のか
かみしだく	かみしだか
詛う	詛わ
片寄る	片寄ら
わき出る	わき出
ぞんじあげる	ぞんじあげ
寄り縋る	寄り縋ら
もとる	もとら
めぐれる	めぐれ
重立つ	重立た
黄ばむ	黄ばま
書き散らす	書き散らさ
刺し通す	刺し通さ
おそれいる	おそれいら
優る	優ら
もてなす	もてなさ
しゃくにさわる	しゃくにさわら
よびあげる	よびあげ
食い合う	食い合わ
いきぬく	いきぬか
鈍る	鈍ら
しげりあう	しげりあわ
話す	話さ
言い損なう	言い損なわ
押しつまる	押しつまら
踏み破る	踏み破ら
請う	請わ
たわむ	たわま
降り積る	降り積ら
打出す	打出さ
響きわたる	響きわたら
もぎ落とす	もぎ落とさ
膨れる	膨れ
借入れる	借入れ
翔る	翔ら
いきまく	いきまか
そっくりかえる	そっくりかえら
となりあう	となりあわ
相する	相し
まぬかれる	まぬかれ
逢う	逢わ
逃れる	逃れ
食いつぶす	食いつぶさ
すわりこめる	すわりこめ
強める	強め
剥ける	剥け
耳慣れる	耳慣れ
よいしれる	よいしれ
荒れ狂う	荒れ狂わ
よみとれる	よみとれ
欲ばる	欲ばら
なげいれる	なげいれ
わすれかける	わすれかけ
てなずける	てなずけ
抱ける	抱け
とりさる	とりさら
課す	課さ
焼き鈍す	焼き鈍さ
うっする	うっし
りょうる	りょうら
わらいこける	わらいこけ
同ずる	同ぜ
運び込む	運び込ま
差向ける	差向け
もぐりこめる	もぐりこめ
安らう	安らわ
紛える	紛え
ほころばせる	ほころばせ
犯せる	犯せ
読み出す	読み出さ
なきぬれる	なきぬれ
祝える	祝え
おもんばかる	おもんばから
たたえる	たたえ
よびよせる	よびよせ
手渡せる	手渡せ
いる	い
結い上げる	結い上げ
かつえる	かつえ
もったいぶる	もったいぶら
こせる	こせ
統べる	統べ
送りこむ	送りこま
差上る	差上ら
引き出す	引き出さ
盗み見る	盗み見
おおせつかる	おおせつから
くるまれる	くるまれ
区切る	区切ら
折り曲げる	折り曲げ
逃げだす	逃げださ
けがす	けがさ
要る	要ら
拗じくれる	拗じくれ
及ぶ	及ば
ねじこむ	ねじこま
ひきおとせる	ひきおとせ
拗くれる	拗くれ
身まかる	身まから
可愛がれる	可愛がれ
泣明かす	泣明かさ
鳴しきる	鳴しきら
すえる	すえ
しばりつける	しばりつけ
にじみでる	にじみで
震わす	震わさ
ぶら下げる	ぶら下げ
恋こがれる	恋こがれ
おもいあがる	おもいあがら
ひきしぼる	ひきしぼら
とりかえす	とりかえさ
つかれる	つかれ
練り合わせる	練り合わせ
所帯染みる	所帯染み
おどろく	おどろか
はばかる	はばから
活かす	活かさ
打据える	打据え
うかがえる	うかがえ
輸する	輸し
察す	察さ
振る舞う	振る舞わ
諂う	諂わ
取り去る	取り去ら
目論む	目論ま
殴り込む	殴り込ま
言い直す	言い直さ
のみつぶれる	のみつぶれ
隣合わす	隣合わさ
おぎなう	おぎなわ
ひねり出す	ひねり出さ
洗い直す	洗い直さ
つかねる	つかね
おいちらす	おいちらさ
うけいれる	うけいれ
かなう	かなわ
知抜く	知抜か
象れる	象れ
受け出す	受け出さ
ゆすぐ	ゆすが
あそびあきる	あそびあき
次ぐ	次が
さぐりあう	さぐりあわ
える	えら
揚る	揚ら
ねそびれる	ねそびれ
すすぐ	すすが
顕れる	顕れ
赤みがかる	赤みがから
嗜める	嗜め
うがつ	うがた
掻き乱す	掻き乱さ
生み付ける	生み付け
綴じ込む	綴じ込ま
あつかう	あつかわ
噛み砕ける	噛み砕け
祟る	祟ら
さんざめく	さんざめか
話せる	話せ
打ちあわせる	打ちあわせ
ぐずる	ぐずら
べんじる	べんじ
携える	携え
請け負う	請け負わ
ながしいれる	ながしいれ
くいさがれる	くいさがれ
たたき落とす	たたき落とさ
飲明かす	飲明かさ
似合う	似合わ
きかせる	きかせ
寄越す	寄越さ
湿す	湿さ
にげのびる	にげのび
まかりでる	まかりで
たちのく	たちのか
つぼまる	つぼまら
よろこばす	よろこばさ
いいつのる	いいつのら
耽ける	耽け
聞き置く	聞き置か
ふりまわせる	ふりまわせ
めとる	めとら
てる	てら
うたがえる	うたがえ
甘んずる	甘んぜ
たちされる	たちされ
おののく	おののか
燃やせる	燃やせ
生ずる	生ぜ
導き出す	導き出さ
嵩む	嵩ま
ふみぬける	ふみぬけ
ひらめる	ひらめ
すれあう	すれあわ
虐める	虐め
うけとる	うけとら
たたきおとす	たたきおとさ
築ける	築け
どく	どか
蠢く	蠢か
たぎる	たぎら
呼び付ける	呼び付け
心掛ける	心掛け
のり出せる	のり出せ
ふりきれる	ふりきれ
汲みあげる	汲みあげ
捻り出す	捻り出さ
はずかしめる	はずかしめ
交える	交え
いいおわる	いいおわら
組込む	組込ま
打ち放す	打ち放さ
拾える	拾え
おもいめぐらす	おもいめぐらさ
つきとおる	つきとおら
みのる	みのら
革まる	革まら
引っ掛ける	引っ掛け
来る	来
抜取る	抜取ら
よわいする	よわいし
抜出す	抜出さ
大殿篭る	大殿篭ら
ちゅうする	ちゅうし
したためる	したため
生ける	生け
ひっくり返せる	ひっくり返せ
あらためる	あらため
腐る	腐ら
鞭打つ	鞭打た
さわがせる	さわがせ
思いめぐらす	思いめぐらさ
はくする	はくし
につまる	につまら
並外れる	並外れ
かがむ	かがま
輝く	輝か
やく	やか
ある	あら
心温まる	心温まら
なぐ	なが
さきにおう	さきにおわ
しみ渡る	しみ渡ら
咲きみだれる	咲きみだれ
うばいあえる	うばいあえ
建てる	建て
頼める	頼め
かり集める	かり集め
ふみたおせる	ふみたおせ
やみほおける	やみほおけ
言習わす	言習わさ
ありあわせる	ありあわせ
吐き出す	吐き出さ
導ける	導け
止まる	止まら
正す	正さ
盛り殺す	盛り殺さ
しまう	しまわ
磨ぐ	磨が
におわす	におわさ
さらえる	さらえ
しわける	しわけ
躱す	躱さ
討ち止める	討ち止め
交ぜる	交ぜ
のける	のけ
といあわせる	といあわせ
嵌める	嵌め
憂ふ	憂へ
ひねりだす	ひねりださ
恐る	恐
居座れる	居座れ
塗り付ける	塗り付け
執り成す	執り成さ
張る	張ら
にえかえる	にえかえら
乗り掛ける	乗り掛け
帯する	帯し
にやける	にやけ
しぶく	しぶか
戦ふ	戦は
てがける	てがけ
でく	でか
くいたおす	くいたおさ
差し伸べる	差し伸べ
いきどおる	いきどおら
張り切る	張り切ら
やめる	やめ
誘き寄せる	誘き寄せ
いきばる	いきばら
たたきだせる	たたきだせ
煎る	煎ら
おうじる	おうじ
遊ばせる	遊ばせ
けしかける	けしかけ
突き出る	突き出
行かす	行かさ
よくなる	よくなら
あがる	あがら
もつ	もた
迫り上げる	迫り上げ
鉗む	鉗ま
たっする	たっし
こえる	こえ
ぬがせる	ぬがせ
かみつく	かみつか
捌く	捌か
聞き流す	聞き流さ
占める	占め
鳴りだす	鳴りださ
赦す	赦さ
見返す	見返さ
威張る	威張ら
罅割れる	罅割れ
みまう	みまわ
きはじめる	きはじめ
飛降りる	飛降り
なぎ倒す	なぎ倒さ
振りまける	振りまけ
とりくむ	とりくま
ひそまる	ひそまら
持ち直す	持ち直さ
意気込む	意気込ま
見つけ出す	見つけ出さ
あきなう	あきなわ
見惚れる	見惚れ
けだす	けださ
占える	占え
持寄る	持寄ら
染入る	染入ら
ゆきあう	ゆきあわ
そそぎ入れる	そそぎ入れ
もぎとれる	もぎとれ
癒す	癒さ
氷る	氷ら
引き続く	引き続か
買占める	買占め
哀れむ	哀れま
叱れる	叱れ
のびあがれる	のびあがれ
茶化す	茶化さ
申し入れる	申し入れ
借り倒す	借り倒さ
押さえ込む	押さえ込ま
乗り合わせる	乗り合わせ
あきらめる	あきらめ
渇する	渇し
見いだす	見いださ
掻く	掻か
話し出す	話し出さ
先だつ	先だた
かっ切る	かっ切ら
打放す	打放さ
わりふる	わりふら
うろ抜く	うろ抜か
授ける	授け
のぞきこめる	のぞきこめ
はぐれる	はぐれ
つれあう	つれあわ
引き絞る	引き絞ら
グレる	グレ
聞き過す	聞き過さ
ただせる	ただせ
それる	それ
見くびる	見くびら
買入れる	買入れ
買い換える	買い換え
抑え込む	抑え込ま
そびえたつ	そびえたた
嗅ぎつける	嗅ぎつけ
ねころぶ	ねころば
える	え
ほのめかす	ほのめかさ
面くらう	面くらわ
こころづく	こころづか
摩り替える	摩り替え
かけ合せる	かけ合せ
言い出せる	言い出せ
詫び入る	詫び入ら
つくす	つくさ
亡くする	亡くし
よみあわす	よみあわさ
懸け離れる	懸け離れ
選び出せる	選び出せ
吐きだす	吐きださ
近付ける	近付け
やれる	やれ
過ぎる	過ぎ
めぐらせる	めぐらせ
まちがえる	まちがえ
ききながせる	ききながせ
扮する	扮し
乗外す	乗外さ
取り結べる	取り結べ
かわせる	かわせ
取り囲める	取り囲め
噴ける	噴け
老込む	老込ま
もうしでる	もうしで
あそばす	あそばさ
儲かる	儲から
つぎ込む	つぎ込ま
ねばる	ねばら
縮こまる	縮こまら
うまれおちる	うまれおち
見つめる	見つめ
添う	添わ
踏み切れる	踏み切れ
よみかける	よみかけ
うける	うけ
乗っ取る	乗っ取ら
始める	始め
とりむすべる	とりむすべ
踏とどまる	踏とどまら
転じる	転じ
積み込む	積み込ま
参る	参ら
つるす	つるさ
はける	はけ
ふきだす	ふきださ
成り上がる	成り上がら
匂う	匂わ
もたせる	もたせ
読取る	読取ら
ひまどる	ひまどら
志す	志さ
けずりたおす	けずりたおさ
だしぬく	だしぬか
聞き取れる	聞き取れ
もたれかかる	もたれかから
はずす	はずさ
おしひらく	おしひらか
まえる	まえ
待ちくたびれる	待ちくたびれ
苛む	苛ま
ふみたおす	ふみたおさ
切り上げる	切り上げ
はち切れる	はち切れ
取り合わす	取り合わさ
借り換える	借り換え
力尽きる	力尽き
みえる	みえ
組み付ける	組み付け
そり返る	そり返ら
作り出す	作り出さ
おしこむ	おしこま
せまれる	せまれ
食つなぐ	食つなが
擦込む	擦込ま
くむ	くま
相まつ	相また
わき起これる	わき起これ
焼ける	焼け
緘する	緘し
貢げる	貢げ
かたづける	かたづけ
まもる	まもら
ふやす	ふやさ
晒す	晒さ
たすけあえる	たすけあえ
粘り抜く	粘り抜か
なげつける	なげつけ
引っこ抜く	引っこ抜か
焙じる	焙じ
舞い降りる	舞い降り
やぶける	やぶけ
ときめく	ときめか
引っ掛る	引っ掛ら
聞き糺す	聞き糺さ
くる	くら
みあらわす	みあらわさ
ひとりごつ	ひとりごた
譲り合う	譲り合わ
ツッパる	ツッパら
策する	策し
気張る	気張ら
しゃちこ張る	しゃちこ張ら
差合う	差合わ
言い及す	言い及さ
伏す	伏さ
病みほおける	病みほおけ
取り返す	取り返さ
消え入る	消え入ら
こがす	こがさ
焼く	焼か
はやし立てる	はやし立て
いきすぎる	いきすぎ
腰かける	腰かけ
かおる	かおら
にがりきる	にがりきら
抱きとる	抱きとら
はじきかえす	はじきかえさ
ぶばる	ぶばら
ながめる	ながめ
潜る	潜ら
惚れ込む	惚れ込ま
掘り下げる	掘り下げ
くばりあるく	くばりあるか
哀しむ	哀しま
向かわる	向かわら
おし黙る	おし黙ら
追払う	追払わ
ざらつく	ざらつか
滾る	滾ら
褒めそやす	褒めそやさ
うばいかえす	うばいかえさ
そめなおせる	そめなおせ
優れる	優れ
弾き返す	弾き返さ
重んずる	重んぜ
見入る	見入ら
とびつく	とびつか
うりさばく	うりさばか
築き上げる	築き上げ
混ずる	混ぜ
突き除ける	突き除け
分合う	分合わ
とりかえる	とりかえ
水漬く	水漬か
考へる	考へ
洗い落とせる	洗い落とせ
とりこぼす	とりこぼさ
かちえる	かちえ
張倒す	張倒さ
にあう	にあわ
はねかえる	はねかえら
とどむる	とどむら
いみづける	いみづけ
つながる	つながら
巻き込める	巻き込め
持て囃す	持て囃さ
引きずり込める	引きずり込め
報せる	報せ
際す	際さ
差しのべる	差しのべ
醸す	醸さ
積み上げる	積み上げ
うらぶれる	うらぶれ
うみだせる	うみだせ
かずける	かずけ
見おろせる	見おろせ
ひんする	ひんし
ひきかえす	ひきかえさ
繰入れる	繰入れ
動機付ける	動機付け
存ずる	存ぜ
取仕切る	取仕切ら
おいやる	おいやら
表する	表し
艷めく	艷めか
喋れる	喋れ
かきけせる	かきけせ
聞きいれる	聞きいれ
飛び出せる	飛び出せ
そよぐ	そよが
おおせる	おおせ
よびかわす	よびかわさ
向かえる	向かえ
振り上げる	振り上げ
慰める	慰め
にくがる	にくがら
言いつける	言いつけ
あびせる	あびせ
誘える	誘え
極め込む	極め込ま
くどきおとす	くどきおとさ
聞き入る	聞き入ら
呼び上げる	呼び上げ
訝る	訝ら
かつぐ	かつが
引掻く	引掻か
擦切れる	擦切れ
属する	属し
せりあげる	せりあげ
泡だつ	泡だた
下廻る	下廻ら
失す	失さ
討ち取る	討ち取ら
仕組める	仕組め
読み合わせる	読み合わせ
掻っ込む	掻っ込ま
攻め込む	攻め込ま
たたきつける	たたきつけ
ささくれる	ささくれ
いいならわす	いいならわさ
売り急ぐ	売り急が
繰りかえる	繰りかえ
ぐする	ぐし
轟かす	轟かさ
おしはかれる	おしはかれ
曵ける	曵け
忍ばせる	忍ばせ
隣合わせる	隣合わせ
取り合せる	取り合せ
ゆきづまる	ゆきづまら
組みかえる	組みかえ
ゆうきづける	ゆうきづけ
描く	描か
伸し上がる	伸し上がら
けおとす	けおとさ
取寄せる	取寄せ
たちあがる	たちあがら
恵む	恵ま
抜け出る	抜け出
引きつける	引きつけ
錆びる	錆び
つらぬく	つらぬか
言いのがれる	言いのがれ
ともなう	ともなわ
繰り上げる	繰り上げ
ねる	ねら
押しやる	押しやら
寝かし付ける	寝かし付け
につける	につけ
ならわす	ならわさ
ぶりかえす	ぶりかえさ
つがう	つがわ
沈める	沈め
ぶんなぐる	ぶんなぐら
待ちあぐむ	待ちあぐま
やけだされる	やけだされ
取り組める	取り組め
おちつきはらう	おちつきはらわ
断る	断ら
いれる	いれ
冷す	冷さ
はねかす	はねかさ
諳んじる	諳んじ
くぐまる	くぐまら
くらむ	くらま
走らす	走らさ
さし当たる	さし当たら
追いこむ	追いこま
引き抜ける	引き抜け
まごつく	まごつか
嚇す	嚇さ
叩き込む	叩き込ま
養える	養え
準じる	準じ
かきけす	かきけさ
可愛がる	可愛がら
軽んずる	軽んぜ
飛び交う	飛び交わ
かく	かか
治める	治め
泣き崩れる	泣き崩れ
充てる	充て
誇る	誇ら
浚う	浚わ
明くらす	明くらさ
とりおとす	とりおとさ
ことわる	ことわら
交す	交さ
拭える	拭え
ひきもどせる	ひきもどせ
むせかえる	むせかえら
ヤジる	ヤジら
飽く	飽か
相変わる	相変わら
呼び寄せる	呼び寄せ
ほほ笑みかける	ほほ笑みかけ
戻る	戻ら
堕する	堕し
飲める	飲め
きりぬく	きりぬか
写す	写さ
むかいあわせる	むかいあわせ
扱きおろす	扱きおろさ
震え上がる	震え上がら
書き落とす	書き落とさ
ふまえる	ふまえ
はむかえる	はむかえ
覚す	覚さ
彫り込む	彫り込ま
聞きすごす	聞きすごさ
空とぼける	空とぼけ
書換える	書換え
ひっぱれる	ひっぱれ
贖う	贖わ
しょする	しょし
塗り潰す	塗り潰さ
はまりこむ	はまりこま
うばいあう	うばいあわ
たどり着く	たどり着か
脱がせる	脱がせ
つけまわす	つけまわさ
入替える	入替え
攻め落とす	攻め落とさ
積み込める	積み込め
歌い上げる	歌い上げ
見掛ける	見掛け
為遂げる	為遂げ
腹ばう	腹ばわ
燃えさかる	燃えさから
へずる	へずら
うちたおせる	うちたおせ
題す	題さ
行ずる	行ぜ
ひょろつく	ひょろつか
精出せる	精出せ
言い尽くす	言い尽くさ
てむかう	てむかわ
詰め込む	詰め込ま
喰らう	喰らわ
射掛ける	射掛け
思い返す	思い返さ
瀕する	瀕し
ちりはてる	ちりはて
武ばる	武ばら
跼る	跼ら
残る	残ら
のばす	のばさ
つき合う	つき合わ
ときふせる	ときふせ
みこむ	みこま
ひたる	ひたら
妨げる	妨げ
忍ぶ	忍ば
唱える	唱え
差し出す	差し出さ
見上ぐ	見上げ
とおる	とおら
ねじむける	ねじむけ
どよめく	どよめか
物語る	物語ら
酔払う	酔払わ
はぶける	はぶけ
まいらす	まいらさ
長ずる	長ぜ
超す	超さ
かしらだつ	かしらだた
かたらう	かたらわ
引つる	引つら
ききほれる	ききほれ
わきかえる	わきかえら
掘り返せる	掘り返せ
知らす	知らさ
果す	果さ
咳きあげる	咳きあげ
燃あがる	燃あがら
見切る	見切ら
気負う	気負わ
息づまる	息づまら
仕出かす	仕出かさ
たいらげる	たいらげ
見棄てる	見棄て
しかめる	しかめ
散る	散ら
とばせる	とばせ
押し戻す	押し戻さ
おしえる	おしえ
陣取る	陣取ら
口説く	口説か
上向ける	上向け
すくえる	すくえ
爪立てる	爪立て
ひっくり返る	ひっくり返ら
引き取れる	引き取れ
蹲う	蹲わ
うずめる	うずめ
見据える	見据え
てなれる	てなれ
ときあるく	ときあるか
取持つ	取持た
横たわる	横たわら
おもんじる	おもんじ
溢れる	溢れ
死に果てる	死に果て
立至る	立至ら
亘る	亘ら
手挟む	手挟ま
書留める	書留め
うりはらう	うりはらわ
覆せる	覆せ
抜けでる	抜けで
すり抜ける	すり抜け
売りまくる	売りまくら
倣う	倣わ
きりさいなむ	きりさいなま
なりさがる	なりさがら
おきわすれる	おきわすれ
折れ合える	折れ合え
禿げる	禿げ
切りそろえる	切りそろえ
立ち合える	立ち合え
居る	居ら
払う	払わ
盛り潰す	盛り潰さ
踏み出せる	踏み出せ
ゆする	ゆし
差引く	差引か
太れる	太れ
まきあげる	まきあげ
弄う	弄わ
乗りきる	乗りきら
汲める	汲め
行く	行か
いむ	いま
撮む	撮ま
わたれる	わたれ
自惚れる	自惚れ
たびだつ	たびだた
伝え聞く	伝え聞か
押し切る	押し切ら
わらいとばせる	わらいとばせ
れいする	れいし
たゆたう	たゆたわ
もだす	もださ
驕る	驕ら
起つ	起た
ゆわえつける	ゆわえつけ
おれまがる	おれまがら
たのみこむ	たのみこま
飛び込む	飛び込ま
うちしおれる	うちしおれ
まかりとおる	まかりとおら
ひび割れる	ひび割れ
なぎふせる	なぎふせ
刳り貫く	刳り貫か
潤む	潤ま
ときはなつ	ときはなた
際だつ	際だた
煮つける	煮つけ
吹き払える	吹き払え
へたばる	へたばら
はばたく	はばたか
切り放す	切り放さ
切抜ける	切抜け
競う	競わ
いいかねる	いいかね
とりはなせる	とりはなせ
見倣す	見倣さ
煽ぐ	煽が
かばう	かばわ
唆す	唆さ
飲干す	飲干さ
すわり込む	すわり込ま
狙う	狙わ
とりかこむ	とりかこま
彫りあげる	彫りあげ
打ち合う	打ち合わ
みうける	みうけ
捕れる	捕れ
のりすごす	のりすごさ
組み敷く	組み敷か
読みかえる	読みかえ
突き当る	突き当ら
背ける	背け
あるきつかれる	あるきつかれ
そそり立つ	そそり立た
出直す	出直さ
震る	震ら
振い落す	振い落さ
舞あがる	舞あがら
置きかえる	置きかえ
務める	務め
とじこもる	とじこもら
脹れる	脹れ
やせ衰える	やせ衰え
瞑る	瞑ら
駆け出す	駆け出さ
賜ぶ	賜ば
聞外す	聞外さ
売り捌く	売り捌か
了する	了し
おきあがる	おきあがら
切り離せる	切り離せ
据えつける	据えつけ
のびゆく	のびゆか
書き下す	書き下さ
司る	司ら
咳きこむ	咳きこま
ひったくる	ひったくら
みる	み
致す	致さ
ごわつく	ごわつか
引っこぬく	引っこぬか
たきあがる	たきあがら
掻き立てる	掻き立て
いろどる	いろどら
蔽う	蔽わ
掻い摘む	掻い摘ま
こじれる	こじれ
聞届ける	聞届け
洗上げる	洗上げ
容態ぶる	容態ぶら
老ける	老け
切り替る	切り替ら
甘やかす	甘やかさ
逐う	逐わ
いいかえる	いいかえ
しょうこだてる	しょうこだて
さしこえる	さしこえ
聞及ぶ	聞及ば
ひきわたせる	ひきわたせ
はなれる	はなれ
いさめる	いさめ
抄く	抄か
かけへだたる	かけへだたら
踏み込む	踏み込ま
くらせる	くらせ
授かる	授から
あじわう	あじわわ
戒める	戒め
みとめる	みとめ
おしつける	おしつけ
凹ます	凹まさ
塞き上げる	塞き上げ
ふすぼる	ふすぼら
かせる	かせ
荒らげる	荒らげ
営む	営ま
考え直す	考え直さ
おくれる	おくれ
駆込む	駆込ま
あらしまわる	あらしまわら
居すくまる	居すくまら
切り開ける	切り開け
払い込む	払い込ま
見つけだす	見つけださ
這い蹲う	這い蹲わ
老いさらばえる	老いさらばえ
閉まる	閉まら
はなす	はなさ
いすわれる	いすわれ
くらわす	くらわさ
へしあう	へしあわ
突きつめる	突きつめ
量り込む	量り込ま
とくする	とくし
取り戻す	取り戻さ
とよむ	とよま
やり込める	やり込め
しゃべる	しゃべら
嗅ぎ当てる	嗅ぎ当て
巻き起す	巻き起さ
ととのえる	ととのえ
噤む	噤ま
調子づく	調子づか
説明かす	説明かさ
暮らせる	暮らせ
於く	於か
研ける	研け
なぐりとばす	なぐりとばさ
語れる	語れ
行悩む	行悩ま
ふんぎれる	ふんぎれ
持掛ける	持掛け
やけしぬ	やけしな
さしくる	さしくら
むしる	むしら
講じる	講じ
張り込む	張り込ま
修まる	修まら
つれだす	つれださ
みとおす	みとおさ
もらえる	もらえ
ふらつく	ふらつか
断わる	断わら
入れ違う	入れ違わ
おりかえす	おりかえさ
当て嵌める	当て嵌め
おちゆく	おちゆか
つくりかえる	つくりかえ
休む	休ま
落ちつける	落ちつけ
つきのめす	つきのめさ
古ぼける	古ぼけ
矯める	矯め
折り重なる	折り重なら
入びたる	入びたら
たてこもれる	たてこもれ
じょうずる	じょうぜ
あきれはてる	あきれはて
かりだす	かりださ
はみだす	はみださ
参じる	参じ
罷り通る	罷り通ら
醸せる	醸せ
入り組む	入り組ま
うれる	うれ
選る	選ら
しる	しら
及ぼせる	及ぼせ
絎ける	絎け
除する	除し
へりくだる	へりくだら
みゃくうつ	みゃくうた
はぐくめる	はぐくめ
打てる	打て
だまし込む	だまし込ま
揺るがす	揺るがさ
買い替える	買い替え
饗する	饗し
汗ばむ	汗ばま
ひきぐする	ひきぐし
刈る	刈ら
走り出る	走り出
賣れる	賣れ
はめこめる	はめこめ
来たす	来たさ
まじわる	まじわら
突当る	突当ら
かさなる	かさなら
つりあがる	つりあがら
はせもどる	はせもどら
刈り込む	刈り込ま
たおす	たおさ
のたうち回る	のたうち回ら
目がける	目がけ
碎ける	碎け
おもいうかべる	おもいうかべ
つっかえせる	つっかえせ
おわる	おわら
押寄せる	押寄せ
いれあわせる	いれあわせ
凍てる	凍て
鋳る	鋳
効く	効か
爪先立つ	爪先立た
おこれる	おこれ
申し伝える	申し伝え
生す	生さ
閉ざす	閉ざさ
焼き付ける	焼き付け
借換える	借換え
坐りこむ	坐りこま
あけわたる	あけわたら
おしかくせる	おしかくせ
育てる	育て
給ぶ	給ば
書き上げる	書き上げ
えむ	えま
配る	配ら
のりこなす	のりこなさ
あゆむ	あゆま
矧げる	矧げ
突っ走る	突っ走ら
さぐりあてる	さぐりあて
飛散る	飛散ら
滅ぼす	滅ぼさ
ふかめる	ふかめ
縛する	縛し
駈る	駈ら
ほりさげる	ほりさげ
もたせかける	もたせかけ
わらえる	わらえ
こじる	こじら
泣腫らす	泣腫らさ
据付ける	据付け
吐出す	吐出さ
焦げる	焦げ
おしつめる	おしつめ
隠れる	隠れ
打倒す	打倒さ
踏み鳴らす	踏み鳴らさ
寄せ付ける	寄せ付け
切り掛る	切り掛ら
在る	在ら
だきこめる	だきこめ
言いたてる	言いたて
組み合せる	組み合せ
いる	いら
入れあげる	入れあげ
ごうする	ごうし
ねいる	ねいら
亡くなす	亡くなさ
暴れる	暴れ
まします	ましまさ
ぬきだす	ぬきださ
なげかける	なげかけ
荒れ果てる	荒れ果て
きこしめす	きこしめさ
噎せる	噎せ
ひきとれる	ひきとれ
あらしめる	あらしめ
うちくだける	うちくだけ
指す	指さ
つどえる	つどえ
変える	変え
どやしつける	どやしつけ
消えうせる	消えうせ
叩き付ける	叩き付け
抜き連ねる	抜き連ね
飛かかる	飛かから
突っころばす	突っころばさ
のこせる	のこせ
表せる	表せ
であるく	であるか
とりにがす	とりにがさ
差入れる	差入れ
とりさばく	とりさばか
取り外せる	取り外せ
まん延する	まん延す
嘶く	嘶か
ぶちかます	ぶちかまさ
なでつける	なでつけ
平らぐ	平らが
吊上げる	吊上げ
いとう	いとわ
吹きかける	吹きかけ
くぎる	くぎら
かい出す	かい出さ
こき使える	こき使え
かこえる	かこえ
とりもどせる	とりもどせ
たたかう	たたかわ
なげすてる	なげすて
刺違える	刺違え
汲み込む	汲み込ま
つぶせる	つぶせ
のぼれる	のぼれ
帰る	帰ら
忌み嫌う	忌み嫌わ
熨す	熨さ
盛り分ける	盛り分け
なじる	なじら
ばっする	ばっし
偏する	偏し
うまれる	うまれ
ぬきとる	ぬきとら
大人びる	大人び
贏ち得える	贏ち得え
差しいれる	差しいれ
かきつける	かきつけ
うけたまわる	うけたまわら
捩じる	捩じら
重ねる	重ね
怖がる	怖がら
いこう	いこわ
あかるむ	あかるま
行着く	行着か
燃え上がる	燃え上がら
乗り後れる	乗り後れ
盛りあがる	盛りあがら
怠る	怠ら
入れ代わる	入れ代わら
売れ残る	売れ残ら
よりきる	よりきら
締付ける	締付け
しみつく	しみつか
取り揃える	取り揃え
のりかえる	のりかえ
ふき清める	ふき清め
言い込める	言い込め
諒する	諒し
寝付ける	寝付け
肥える	肥え
よみあさる	よみあさら
ののしる	ののしら
終る	終ら
わりもどす	わりもどさ
うちのめす	うちのめさ
上り詰めるる	上り詰める
買い漁る	買い漁ら
捨てる	捨て
神さびる	神さび
根ざす	根ざさ
添いとげる	添いとげ
さそいこむ	さそいこま
きこえる	きこえ
連れ立つ	連れ立た
さける	さけ
成りたつ	成りたた
あけはなす	あけはなさ
遊ぶ	遊ば
たちなおれる	たちなおれ
書ける	書け
なぐさめる	なぐさめ
出迎える	出迎え
つくろう	つくろわ
おぎないあう	おぎないあわ
申し送れる	申し送れ
冠す	冠さ
仰せつける	仰せつけ
おいまわす	おいまわさ
にんじる	にんじ
入れ換える	入れ換え
煮あがる	煮あがら
滑り出す	滑り出さ
もてあそぶ	もてあそば
拭く	拭か
息吹く	息吹か
つれそえる	つれそえ
やしなえる	やしなえ
波立つ	波立た
駆けずり回る	駆けずり回ら
撲り飛ばす	撲り飛ばさ
切り替わる	切り替わら
ふさがる	ふさがら
たがやせる	たがやせ
張り付く	張り付か
つぶだつ	つぶだた
奪い取る	奪い取ら
汲み取る	汲み取ら
泣き叫ぶ	泣き叫ば
巣食う	巣食わ
だべる	だべら
嵩ずる	嵩ぜ
できる	でき
わかせる	わかせ
ねぢ伏せる	ねぢ伏せ
問詰める	問詰め
ぶらさがれる	ぶらさがれ
たたきだす	たたきださ
だきすくめる	だきすくめ
打ち崩せる	打ち崩せ
切り換える	切り換え
青ばむ	青ばま
ぬすむ	ぬすま
腹だてる	腹だて
借れる	借れ
きわめつくす	きわめつくさ
ひきうける	ひきうけ
並び立つ	並び立た
たてこめる	たてこめ
窺える	窺え
たわむれる	たわむれ
彌増す	彌増さ
ほっぽる	ほっぽら
はねつける	はねつけ
かさねる	かさね
擬する	擬し
うかび出る	うかび出
濁せる	濁せ
扱ぐ	扱が
報じる	報じ
盗み出せる	盗み出せ
褪せる	褪せ
踏ん張れる	踏ん張れ
ねぎれる	ねぎれ
勝誇る	勝誇ら
間違う	間違わ
ずばぬける	ずばぬけ
とりなおす	とりなおさ
畳みかける	畳みかけ
あまんずる	あまんぜ
しゃっちょこばる	しゃっちょこばら
きれる	きれ
くわせる	くわせ
打ち付ける	打ち付け
書取る	書取ら
いける	いけ
結ぶ	結ば
続く	続か
蒔く	蒔か
浮き立てる	浮き立て
くずれる	くずれ
射る	射
抜け出す	抜け出さ
におわせる	におわせ
切り崩せる	切り崩せ
読み通す	読み通さ
憎まれる	憎まれ
えいずる	えいぜ
預ける	預け
取りしきる	取りしきら
よせつける	よせつけ
わらわせる	わらわせ
うりだす	うりださ
縛る	縛ら
註する	註し
投げ捨てる	投げ捨て
つぐ	つが
のぞむ	のぞま
振り掛ける	振り掛け
上ずる	上ずら
見出せる	見出せ
揚げる	揚げ
くもらす	くもらさ
ゆきかかる	ゆきかから
綴合せる	綴合せ
引去る	引去ら
突き戻せる	突き戻せ
相寄る	相寄ら
誤魔化す	誤魔化さ
益する	益し
あかす	あかさ
つたえる	つたえ
取止める	取止め
悶える	悶え
えんずる	えんぜ
害する	害し
続ける	続け
掠る	掠ら
かいたたける	かいたたけ
思い起こす	思い起こさ
習える	習え
のしあるく	のしあるか
せめおとせる	せめおとせ
目差す	目差さ
編み込む	編み込ま
たけり立つ	たけり立た
かしげる	かしげ
みのがせる	みのがせ
のりくめる	のりくめ
はる	はら
もちいる	もちい
かたむける	かたむけ
読み切る	読み切ら
辞す	辞さ
証拠立てる	証拠立て
屈める	屈め
くみあわす	くみあわさ
凭せ掛ける	凭せ掛け
かこう	かこわ
がる	がら
感じ取る	感じ取ら
ひねる	ひね
出外れる	出外れ
立ち後れる	立ち後れ
うつりかわる	うつりかわら
いいあらわす	いいあらわさ
糾う	糾わ
つもる	つもら
ふんする	ふんし
振りかぶる	振りかぶら
剥がす	剥がさ
そめなおす	そめなおさ
賄える	賄え
寫す	寫さ
事欠く	事欠か
蒸かす	蒸かさ
みのがす	みのがさ
明け放つ	明け放た
持ち運ぶ	持ち運ば
いざる	いざら
組合せる	組合せ
減じる	減じ
投げ出せる	投げ出せ
見透かせる	見透かせ
にらみあわす	にらみあわさ
持ち歩く	持ち歩か
しょびく	しょびか
浮上がる	浮上がら
かたりこめる	かたりこめ
おもいがける	おもいがけ
とりつげる	とりつげ
なだれ込む	なだれ込ま
かぎる	かぎら
舞いあがる	舞いあがら
散らかす	散らかさ
ほりおこす	ほりおこさ
見付ける	見付け
切り落とす	切り落とさ
あかめる	あかめ
生む	生ま
貢ぐ	貢が
おくる	おくら
攣れる	攣れ
挟まる	挟まら
とりまぜる	とりまぜ
あみこむ	あみこま
つたえきく	つたえきか
外す	外さ
交われる	交われ
わきおこす	わきおこさ
煽てる	煽て
きりたつ	きりたた
替わる	替わら
舞い狂う	舞い狂わ
憎がる	憎がら
乗り合わす	乗り合わさ
打落とせる	打落とせ
とびたてる	とびたて
見習う	見習わ
くださる	くださら
ひそむ	ひそま
跳ね除ける	跳ね除け
盗る	盗ら
賑わす	賑わさ
褄取る	褄取ら
削ぎ落す	削ぎ落さ
会す	会さ
踏み抜ける	踏み抜け
仰せつかる	仰せつから
さしたてる	さしたて
出し合う	出し合わ
ちょうする	ちょうし
しぬ	しな
ぽしゃる	ぽしゃら
さしつける	さしつけ
借り入れる	借り入れ
いいだす	いいださ
拗じる	拗じら
こおる	こおら
食わせる	食わせ
哀れがる	哀れがら
煉りあわせる	煉りあわせ
伏拝む	伏拝ま
わかいしあえる	わかいしあえ
問いつめる	問いつめ
浮かれる	浮かれ
わめきたてる	わめきたて
学びとれる	学びとれ
読み下す	読み下さ
首肯く	首肯か
請ける	請け
ぶっこぬく	ぶっこぬか
ぬらす	ぬらさ
えいじる	えいじ
あれる	あれ
くつがえる	くつがえら
飛べる	飛べ
曳く	曳か
躍る	躍ら
無くなる	無くなら
おしすすめる	おしすすめ
ちょうしづく	ちょうしづか
書添える	書添え
法る	法ら
染め直す	染め直さ
仄めかす	仄めかさ
なみだぐむ	なみだぐま
ゆきなやむ	ゆきなやま
兆す	兆さ
わずらいつく	わずらいつか
抱き竦める	抱き竦め
惚れる	惚れ
たえぬく	たえぬか
おしはかる	おしはから
たすけあう	たすけあわ
びびる	びびら
あふれる	あふれ
たちあう	たちあわ
わりこめる	わりこめ
突き破る	突き破ら
ききとがめる	ききとがめ
律す	律さ
きづかう	きづかわ
差違える	差違え
引き降ろす	引き降ろさ
踏み躙る	踏み躙ら
はやり立つ	はやり立た
買い込める	買い込め
差し回せる	差し回せ
やせさらばえる	やせさらばえ
就ける	就け
魅せる	魅せ
売り飛ばす	売り飛ばさ
こげる	こげ
たちふさがる	たちふさがら
くじる	くじら
あいせっする	あいせっし
うつる	うつら
受付ける	受付け
とりしまる	とりしまら
かちぬく	かちぬか
申し受ける	申し受け
つらぬきとおせる	つらぬきとおせ
おとろえる	おとろえ
まぎる	まぎら
かわりはてる	かわりはて
かけちがう	かけちがわ
見回れる	見回れ
捩くれる	捩くれ
費やせる	費やせ
たてまつる	たてまつら
つかう	つかわ
引き去る	引き去ら
推める	推め
引きずり込む	引きずり込ま
乗り越える	乗り越え
指し示せる	指し示せ
ほおえむ	ほおえま
払い込める	払い込め
乾す	乾さ
ねざす	ねざさ
掘りだす	掘りださ
通わす	通わさ
抱き締める	抱き締め
堪へる	堪へ
駆け回る	駆け回ら
攻めかける	攻めかけ
いさみたつ	いさみたた
讚える	讚え
もちかえれる	もちかえれ
響く	響か
引っ担ぐ	引っ担が
待ちあわせる	待ちあわせ
活かる	活から
検める	検め
呑む	呑ま
しだす	しださ
取りさばく	取りさばか
おきなおる	おきなおら
連添う	連添わ
脱ぎ捨てる	脱ぎ捨て
ふきすさぶ	ふきすさば
噛み砕く	噛み砕か
使い慣れる	使い慣れ
とどく	とどか
入れちがう	入れちがわ
ひっくりかえせる	ひっくりかえせ
くみなおせる	くみなおせ
走り出せる	走り出せ
みくだす	みくださ
かけずりまわる	かけずりまわら
噛みしだく	噛みしだか
おくりこめる	おくりこめ
位する	位し
貰える	貰え
意味付ける	意味付け
かくする	かくし
別ける	別け
下りる	下り
引き摺る	引き摺ら
とりきめる	とりきめ
打勝てる	打勝て
なぞる	なぞら
急き立てる	急き立て
逃げ失せる	逃げ失せ
嘗める	嘗め
だまる	だまら
助く	助け
うつれる	うつれ
さししめす	さししめさ
逃げ帰る	逃げ帰ら
そそりたてる	そそりたて
よみこなす	よみこなさ
ちりのこる	ちりのこら
いそぐ	いそが
吊り上げる	吊り上げ
償える	償え
うやまう	うやまわ
あげる	あげ
振り起す	振り起さ
食い詰める	食い詰め
尊べる	尊べ
傭う	傭わ
おりる	おり
乗り捨てる	乗り捨て
書きためる	書きため
見透かす	見透かさ
突刺す	突刺さ
頷ける	頷け
つむ	つま
つかみあげる	つかみあげ
見放す	見放さ
染め出せる	染め出せ
からびる	からび
差し押さえる	差し押さえ
面食らう	面食らわ
締め切る	締め切ら
切れる	切れ
食い散らす	食い散らさ
潤う	潤わ
追いつける	追いつけ
見取る	見取ら
申送る	申送ら
はぎあわせる	はぎあわせ
努める	努め
おおせつける	おおせつけ
向く	向か
乗上げる	乗上げ
足りる	足り
縛める	縛め
歌わす	歌わさ
おもんみる	おもんみ
照る	照ら
覚ます	覚まさ
見ほれる	見ほれ
より抜く	より抜か
駆集める	駆集め
とめおく	とめおか
逞しゅうする	逞しゅうし
とりはずす	とりはずさ
睨みつける	睨みつけ
聞きただせる	聞きただせ
はいずる	はいずら
ゆきかう	ゆきかわ
比する	比し
けちがえる	けちがえ
まさぐる	まさぐら
示し合わす	示し合わさ
植え込む	植え込ま
諮る	諮ら
よじのぼれる	よじのぼれ
預る	預ら
打ちすえる	打ちすえ
はだける	はだけ
写し出せる	写し出せ
ききだす	ききださ
あばきだす	あばきださ
投げ付ける	投げ付け
あまやかす	あまやかさ
譬える	譬え
難ずる	難ぜ
のみくだす	のみくださ
つむぐ	つむが
飛び退く	飛び退か
える	え
ひったてる	ひったて
みがける	みがけ
はさむ	はさま
ほこれる	ほこれ
譲る	譲ら
行き違う	行き違わ
落とし込む	落とし込ま
懸る	懸ら
尋ねあわせる	尋ねあわせ
添い遂げる	添い遂げ
踏み締める	踏み締め
飛下りる	飛下り
落くぼむ	落くぼま
呑みつぶす	呑みつぶさ
立ち回る	立ち回ら
降注ぐ	降注が
とりもつ	とりもた
跳べる	跳べ
乗合せる	乗合せ
呑みつぶれる	呑みつぶれ
遣り返す	遣り返さ
能う	能わ
きりふせる	きりふせ
呑める	呑め
へしおる	へしおら
まいもどる	まいもどら
示す	示さ
とびかかれる	とびかかれ
つまされる	つまされ
統べくくる	統べくくら
積み替える	積み替え
召し上がる	召し上がら
はりさける	はりさけ
起こせる	起こせ
抜かる	抜から
はしらす	はしらさ
へばる	へばら
ふみしめる	ふみしめ
しにおくれる	しにおくれ
和える	和え
巻く	巻か
溶け合う	溶け合わ
墜ちる	墜ち
ふんぎる	ふんぎら
焼切る	焼切ら
駄べる	駄べら
ゆきくらす	ゆきくらさ
収める	収め
道行く	道行か
わび入る	わび入ら
とじこめる	とじこめ
もたれる	もたれ
よなれる	よなれ
ける	けら
解せる	解せ
なだれこむ	なだれこま
讀む	讀ま
とりもてる	とりもて
寝る	寝
ほろぼす	ほろぼさ
臥す	臥さ
すごむ	すごま
威かす	威かさ
見返せる	見返せ
めでる	めで
商う	商わ
まびく	まびか
付き合う	付き合わ
親しむ	親しま
解き明かす	解き明かさ
しいる	しい
切り苛む	切り苛ま
ゆるす	ゆるさ
掘る	掘ら
怖気立つ	怖気立た
はりつく	はりつか
擦れ合う	擦れ合わ
見晴かす	見晴かさ
やとう	やとわ
吹き掛ける	吹き掛け
くりのべる	くりのべ
浮かれ出す	浮かれ出さ
漏らす	漏らさ
支払える	支払え
蹴破る	蹴破ら
せりあう	せりあわ
投捨てる	投捨て
固まる	固まら
届出る	届出
卸す	卸さ
吟じる	吟じ
よたる	よたら
乗りこえる	乗りこえ
憩う	憩わ
しらばくれる	しらばくれ
出合える	出合え
付入る	付入ら
均す	均さ
元気づける	元気づけ
打ち明ける	打ち明け
言いあわせる	言いあわせ
ほどける	ほどけ
浮かび上がれる	浮かび上がれ
つけ廻す	つけ廻さ
どくづく	どくづか
おっしゃれる	おっしゃれ
啀み合う	啀み合わ
押しつぶす	押しつぶさ
ひからす	ひからさ
押し黙る	押し黙ら
ねじ込める	ねじ込め
くりさげる	くりさげ
たちあえる	たちあえ
思し召す	思し召さ
かかわる	かかわら
群だつ	群だた
ありえる	ありえ
かぞえあげる	かぞえあげ
来る	来ら
見合う	見合わ
取巻く	取巻か
切りぬく	切りぬか
いそげる	いそげ
時化る	時化
召し出す	召し出さ
うけひく	うけひか
切りはずせる	切りはずせ
奮いたつ	奮いたた
扼する	扼し
生まれ落ちる	生まれ落ち
かなえる	かなえ
なげる	なげ
あてはめる	あてはめ
冠する	冠し
ゆきすぎる	ゆきすぎ
よりかかる	よりかから
とべる	とべ
取り計らう	取り計らわ
見違える	見違え
立つくす	立つくさ
成る	成ら
ボヤく	ボヤか
持ちかける	持ちかけ
煙たがる	煙たがら
読みこなせる	読みこなせ
書き流す	書き流さ
沁みる	沁み
押しわける	押しわけ
切り崩す	切り崩さ
慣れる	慣れ
学び取れる	学び取れ
かつぎ込める	かつぎ込め
借り切る	借り切ら
とりしきる	とりしきら
起き出す	起き出さ
にらみ合せる	にらみ合せ
せっする	せっし
曲がりくねる	曲がりくねら
ひらつく	ひらつか
みこす	みこさ
暈ける	暈け
編み上げる	編み上げ
かけぬける	かけぬけ
ふるいおとす	ふるいおとさ
かじかむ	かじかま
せがむ	せがま
奥まる	奥まら
ゆみひく	ゆみひか
備付ける	備付け
かかす	かかさ
うつぶす	うつぶさ
はやりたつ	はやりたた
見合わす	見合わさ
染み渡る	染み渡ら
綯う	綯わ
そめだす	そめださ
ふっかける	ふっかけ
埋め合す	埋め合さ
かくしきばる	かくしきばら
押し詰まる	押し詰まら
蹴躓く	蹴躓か
ぬぐいさる	ぬぐいさら
まごう	まごわ
外せる	外せ
承る	承ら
抜き取れる	抜き取れ
のっける	のっけ
どる	どら
出遅れる	出遅れ
たくしこむ	たくしこま
産気づく	産気づか
みとどける	みとどけ
振り回す	振り回さ
例える	例え
すいとれる	すいとれ
脇挟む	脇挟ま
差し支える	差し支え
浮ぶ	浮ば
動ける	動け
吹き払う	吹き払わ
やくす	やくさ
言渡す	言渡さ
ほっとく	ほっとか
仕込む	仕込ま
立ち至る	立ち至ら
折れ合う	折れ合わ
燻べる	燻べ
誘う	誘わ
あらたまる	あらたまら
造り出す	造り出さ
あそびまわる	あそびまわら
計らえる	計らえ
ため込む	ため込ま
きおいたつ	きおいたた
たまう	たまわ
死に損なう	死に損なわ
わるびれる	わるびれ
ひねこびる	ひねこび
よりぬける	よりぬけ
まちぶせる	まちぶせ
銜える	銜え
のぞく	のぞか
うらがえせる	うらがえせ
瘠せる	瘠せ
手懸ける	手懸け
はじめる	はじめ
いとおしむ	いとおしま
奮い起こせる	奮い起こせ
わけあたえる	わけあたえ
取混ぜる	取混ぜ
突き進める	突き進め
生ながらえる	生ながらえ
でしゃばる	でしゃばら
ぞめく	ぞめか
しばたく	しばたか
立て込める	立て込め
かけあえる	かけあえ
ふりみだす	ふりみださ
抱き起こす	抱き起こさ
行き悩む	行き悩ま
咲き匂う	咲き匂わ
おそわる	おそわら
やかす	やかさ
濯う	濯わ
ねりなおせる	ねりなおせ
いいかわす	いいかわさ
隣り合わす	隣り合わさ
飛びつく	飛びつか
泊まる	泊まら
悔やむ	悔やま
探す	探さ
やりなおせる	やりなおせ
おしだせる	おしだせ
閉じる	閉じ
出っぱる	出っぱら
掠れる	掠れ
せく	せか
弾き返せる	弾き返せ
くだせる	くだせ
召しあがる	召しあがら
傳える	傳え
もちよる	もちよら
立向かう	立向かわ
春めく	春めか
ころす	ころさ
嗅ぎ出す	嗅ぎ出さ
培う	培わ
降り掛かる	降り掛から
剽げる	剽げ
造りあげる	造りあげ
ときはなす	ときはなさ
取下げる	取下げ
おもる	おもら
つめる	つめ
ほうむる	ほうむら
刻み込む	刻み込ま
廃する	廃し
遅れる	遅れ
つけあわせる	つけあわせ
撲り付ける	撲り付け
いいおく	いいおか
荒す	荒さ
書き記せる	書き記せ
揃う	揃わ
しのびこむ	しのびこま
投じる	投じ
填め込む	填め込ま
もてる	もて
うりわたす	うりわたさ
銜める	銜め
買い上げる	買い上げ
寝つける	寝つけ
染みつく	染みつか
取り集める	取り集め
すぎゆく	すぎゆか
耳馴れる	耳馴れ
ゆるまる	ゆるまら
練り合せる	練り合せ
途切れる	途切れ
かいすすむ	かいすすま
狂わせる	狂わせ
興せる	興せ
停める	停め
け落とす	け落とさ
燃す	燃さ
のぼる	のぼら
のぼりつめる	のぼりつめ
うれのこる	うれのこら
酔っ払う	酔っ払わ
嘆ずる	嘆ぜ
あけくれる	あけくれ
たちまじる	たちまじら
くりあげる	くりあげ
攻懸ける	攻懸け
言い交す	言い交さ
かぞえたてる	かぞえたて
ふさぎこむ	ふさぎこま
伝へる	伝へ
冲する	冲し
むき出す	むき出さ
きりおとせる	きりおとせ
とじる	とじ
着せる	着せ
怨する	怨し
かいま見る	かいま見
いいふくめる	いいふくめ
けむたがる	けむたがら
紛れる	紛れ
取付ける	取付け
築く	築か
拓ける	拓け
引き離す	引き離さ
凝固まる	凝固まら
焼き付く	焼き付か
痛めつける	痛めつけ
着替える	着替え
かためる	かため
気構える	気構え
突っつく	突っつか
すりあがる	すりあがら
引下がる	引下がら
いこう	いこわ
かぎ出す	かぎ出さ
ぼやかす	ぼやかさ
みつける	みつけ
綾取る	綾取ら
申し出る	申し出
すっぱぬく	すっぱぬか
降らす	降らさ
すっぱ抜く	すっぱ抜か
迂る	迂ら
すき通る	すき通ら
献じる	献じ
ぶっ殺す	ぶっ殺さ
支払う	支払わ
打破れる	打破れ
産み落す	産み落さ
ふりかえる	ふりかえ
出尽くす	出尽くさ
つけいる	つけいら
もてはやす	もてはやさ
含める	含め
困じる	困じ
かりる	かり
救い出す	救い出さ
気に入る	気に入ら
窮する	窮し
ばる	ばら
はしりぬく	はしりぬか
捲く	捲か
てりはえる	てりはえ
おもてだつ	おもてだた
ちかよれる	ちかよれ
零す	零さ
膿む	膿ま
鋤く	鋤か
せおう	せおわ
はりきる	はりきら
入れ忘れる	入れ忘れ
きずきあげる	きずきあげ
決込む	決込ま
落ち行く	落ち行か
危惧す	危惧さ
おいこせる	おいこせ
貸し付ける	貸し付け
連立つ	連立た
むすぼれる	むすぼれ
差越す	差越さ
芽ばえる	芽ばえ
まぜあわせる	まぜあわせ
汲み干す	汲み干さ
執り行う	執り行わ
領する	領し
走り去る	走り去ら
やり合う	やり合わ
見守る	見守ら
取鎮める	取鎮め
りょうする	りょうし
ほる	ほら
条件付ける	条件付け
時めく	時めか
ともなえる	ともなえ
たいおうづける	たいおうづけ
つりだす	つりださ
障る	障ら
ぞうする	ぞうし
投げかける	投げかけ
たれこむ	たれこま
およぎつく	およぎつか
捕らえる	捕らえ
つみこめる	つみこめ
たすけだせる	たすけだせ
待受ける	待受け
おびきよせる	おびきよせ
順序づける	順序づけ
あまったれる	あまったれ
とおす	とおさ
空嘯く	空嘯か
追い抜ける	追い抜け
夏めく	夏めか
乗掛ける	乗掛け
請け負える	請け負え
据える	据え
毀す	毀さ
笑う	笑わ
なみいる	なみい
笑いこける	笑いこけ
差しかかる	差しかから
引っ下げる	引っ下げ
そそる	そそら
殺る	殺ら
おびき出す	おびき出さ
おっぽりだす	おっぽりださ
乗れる	乗れ
延びる	延び
つりあげる	つりあげ
やきつく	やきつか
はにかむ	はにかま
向き合える	向き合え
研く	研か
探しあてる	探しあて
捩じ切る	捩じ切ら
先ばしる	先ばしら
請け合える	請け合え
いかす	いかさ
名乗り出る	名乗り出
混む	混ま
すっぱ抜ける	すっぱ抜け
揉める	揉め
まよいこむ	まよいこま
乱れ飛ぶ	乱れ飛ば
則す	則さ
当たる	当たら
焼け死ぬ	焼け死な
浮足立つ	浮足立た
はずせる	はずせ
死そこなう	死そこなわ
寄り合う	寄り合わ
つつめる	つつめ
取調べる	取調べ
列なる	列なら
題する	題し
はらいのける	はらいのけ
なげとばせる	なげとばせ
えきする	えきし
督する	督し
振り向ける	振り向け
ならす	ならさ
はさみこむ	はさみこま
とりのける	とりのけ
たっとぶ	たっとば
付く	付か
寄り倒せる	寄り倒せ
嫉む	嫉ま
くたばる	くたばら
加わる	加わら
汲み上げる	汲み上げ
乗りはずす	乗りはずさ
はらむ	はらま
絞りあげる	絞りあげ
出食わす	出食わさ
くんずる	くんぜ
済ませる	済ませ
なしとげる	なしとげ
釣る	釣ら
富む	富ま
取計らう	取計らわ
そばだてる	そばだて
ほつす	ほつさ
切り出せる	切り出せ
流れ着ける	流れ着け
言い終わる	言い終わら
駆けつける	駆けつけ
みなせる	みなせ
のく	のか
くぼむ	くぼま
読み取る	読み取ら
うたえる	うたえ
にげまわれる	にげまわれ
類する	類し
立つ	立た
おっしゃる	おっしゃら
弱る	弱ら
サジェストする	サジェストし
写し取る	写し取ら
泣き暮す	泣き暮さ
受け流す	受け流さ
サボる	サボら
張合う	張合わ
絆される	絆され
張り替える	張り替え
引き渡せる	引き渡せ
掻い潜る	掻い潜ら
もれる	もれ
ききあわす	ききあわさ
もらえる	もらえ
差し迫る	差し迫ら
撲る	撲ら
擲つ	擲た
割り振る	割り振ら
鳴りわたる	鳴りわたら
ちがえる	ちがえ
しだれる	しだれ
くるめる	くるめ
いざなう	いざなわ
ごまかせる	ごまかせ
囁く	囁か
ずれる	ずれ
あけのこる	あけのこら
ひきつげる	ひきつげ
すべらす	すべらさ
ぶん殴る	ぶん殴ら
言い古す	言い古さ
ついて行く	ついて行か
立直す	立直さ
まにあう	まにあわ
下がる	下がら
吹かす	吹かさ
住み馴れる	住み馴れ
はじる	はじ
見せ掛ける	見せ掛け
ぶった斬る	ぶった斬ら
こたえる	こたえ
蒸返す	蒸返さ
踏み倒せる	踏み倒せ
鳴き頻る	鳴き頻ら
たどる	たどら
時代掛る	時代掛ら
踊りあかす	踊りあかさ
踏みこむ	踏みこま
吹きこぼれる	吹きこぼれ
頭立つ	頭立た
おびきだす	おびきださ
もの問う	もの問わ
つぎこめる	つぎこめ
そくする	そくし
貯まる	貯まら
すりぬける	すりぬけ
比える	比え
くり貫ける	くり貫け
かすれる	かすれ
格式張る	格式張ら
ふくらす	ふくらさ
なんずる	なんぜ
踏こたえる	踏こたえ
踊れる	踊れ
書き残せる	書き残せ
なきふせる	なきふせ
逃うせる	逃うせ
たせる	たせ
休める	休め
いわう	いわわ
攻寄る	攻寄ら
そびれる	そびれ
ねすごす	ねすごさ
聞き漏らす	聞き漏らさ
溶ける	溶け
うつりすむ	うつりすま
贈る	贈ら
受け引く	受け引か
上回る	上回ら
とびこす	とびこさ
あぐむ	あぐま
もうける	もうけ
ありふれる	ありふれ
はみでる	はみで
起こる	起こら
裏付ける	裏付け
こくする	こくし
とりたてる	とりたて
馴らす	馴らさ
たける	たけら
くみしく	くみしか
隔たる	隔たら
つぎ足す	つぎ足さ
みそれる	みそれ
ちぬる	ちぬら
にせる	にせ
鳴かせる	鳴かせ
裏づける	裏づけ
こぎつける	こぎつけ
絡み合う	絡み合わ
鳴ける	鳴け
賑わわす	賑わわさ
いいあてる	いいあて
解ける	解け
差かかる	差かから
住み荒らす	住み荒らさ
ねしずまる	ねしずまら
染める	染め
打ちきる	打ちきら
とりあつかう	とりあつかわ
先んじる	先んじ
世馴れる	世馴れ
はぶく	はぶか
写し取れる	写し取れ
うえこむ	うえこま
泣き込む	泣き込ま
突っ張る	突っ張ら
すいこむ	すいこま
まぬがれる	まぬがれ
引替える	引替え
とおりぬける	とおりぬけ
適する	適し
打明ける	打明け
思いこむ	思いこま
博する	博し
満ちる	満ち
むけなおす	むけなおさ
白ける	白け
申しつける	申しつけ
すすばむ	すすばま
ゆきつく	ゆきつか
いいくらす	いいくらさ
はい出す	はい出さ
生み出す	生み出さ
たのみいる	たのみいら
まぎれこめる	まぎれこめ
はばたける	はばたけ
差し掛る	差し掛ら
かきあらわせる	かきあらわせ
こめる	こめ
とりだす	とりださ
せめあう	せめあわ
きる	き
こまねく	こまねか
信じる	信じ
込入る	込入ら
ほろぶ	ほろば
論ずる	論ぜ
うちかてる	うちかて
おりかさねる	おりかさね
ぶり返す	ぶり返さ
広まる	広まら
引きちぎる	引きちぎら
突ける	突け
がさつく	がさつか
恋いこがれる	恋いこがれ
ふっきる	ふっきら
頼れる	頼れ
召寄せる	召寄せ
ひえこむ	ひえこま
顰める	顰め
踏みにじれる	踏みにじれ
食いつなぐ	食いつなが
そうけだつ	そうけだた
取り付く	取り付か
たてかける	たてかけ
かきわける	かきわけ
聴き込む	聴き込ま
あやかる	あやから
説きあるく	説きあるか
ふりきる	ふりきら
せめよる	せめよら
蒸れる	蒸れ
あらいおとせる	あらいおとせ
連れ出す	連れ出さ
よりきれる	よりきれ
言いくらす	言いくらさ
のっとる	のっとら
抱える	抱え
へし合う	へし合わ
とりはらう	とりはらわ
冷やかせる	冷やかせ
嘆き明かす	嘆き明かさ
刈取る	刈取ら
ともる	ともら
称する	称し
ほっつく	ほっつか
撃ちまくる	撃ちまくら
ほろびる	ほろび
みまわれる	みまわれ
かさむ	かさま
融ける	融け
申し送る	申し送ら
売り付ける	売り付け
だしぬける	だしぬけ
ひっくりかえる	ひっくりかえら
詰め替える	詰め替え
問える	問え
刻する	刻し
踏みつける	踏みつけ
信じ込む	信じ込ま
照り返す	照り返さ
選り分ける	選り分け
くいる	くい
ゆうする	ゆうし
乗入れる	乗入れ
注する	注し
ゆるぐ	ゆるが
断ち割れる	断ち割れ
受け持てる	受け持て
吹き荒れる	吹き荒れ
見えすく	見えすか
となりあわせる	となりあわせ
あいなる	あいなら
求める	求め
置き換わる	置き換わら
たれる	たれ
うら枯れる	うら枯れ
沸き起こる	沸き起こら
ねぐる	ねぐら
押し広める	押し広め
みすます	みすまさ
樵る	樵ら
寝せる	寝せ
吹き返す	吹き返さ
ささえる	ささえ
染めあげる	染めあげ
とりかえせる	とりかえせ
もりつける	もりつけ
索く	索か
ちぎれる	ちぎれ
脂ぎる	脂ぎら
思い描く	思い描か
ぬかる	ぬから
かいとる	かいとら
かもす	かもさ
くつろげる	くつろげ
そびえる	そびえ
遮る	遮ら
くつろぐ	くつろが
遊び呆ける	遊び呆け
明ける	明け
につく	につか
せき入る	せき入ら
澄み渡る	澄み渡ら
ひきだす	ひきださ
言う	言わ
のさばる	のさばら
みちる	みち
ひらける	ひらけ
鼻白む	鼻白ま
いてる	いて
馴れる	馴れ
なまめく	なまめか
くれる	くれ
おしかぶさる	おしかぶさら
まくし立てる	まくし立て
接ぎ合わせる	接ぎ合わせ
かきおろす	かきおろさ
差止める	差止め
きりかける	きりかけ
絶え入る	絶え入ら
浮き上がれる	浮き上がれ
持ち切る	持ち切ら
拵える	拵え
かみころせる	かみころせ
あきれかえる	あきれかえら
はげ上がる	はげ上がら
とり成す	とり成さ
慨する	慨し
飲み干せる	飲み干せ
揺出る	揺出
付け入る	付け入ら
かぎだせる	かぎだせ
おもねる	おもねら
拐かす	拐かさ
ねむらせる	ねむらせ
しゃべれる	しゃべれ
云う	云わ
さしまわす	さしまわさ
噴く	噴か
呼び交す	呼び交さ
あなどれる	あなどれ
ぶっつかる	ぶっつから
立ち添う	立ち添わ
重る	重ら
くみだせる	くみだせ
すすみでる	すすみで
架する	架し
復す	復さ
ふける	ふけら
嗅ぎ付ける	嗅ぎ付け
事える	事え
希う	希わ
酌み交す	酌み交さ
聞かす	聞かさ
進み出る	進み出
さまよう	さまよわ
敷ける	敷け
吸う	吸わ
みじろぐ	みじろが
もりあわす	もりあわさ
ぶったくる	ぶったくら
ついてる	ついて
ばらまく	ばらまか
かぎあてる	かぎあて
かち取る	かち取ら
つなぐ	つなが
漬込む	漬込ま
引き続ける	引き続け
追使う	追使わ
乗り遅れる	乗り遅れ
放り込む	放り込ま
差し当る	差し当ら
讒する	讒し
見える	見え
見越せる	見越せ
聴き入る	聴き入ら
仕掛る	仕掛
混じえる	混じえ
しぼりとれる	しぼりとれ
ふきとれる	ふきとれ
剃り忘れる	剃り忘れ
こんずる	こんぜ
たわめる	たわめ
創れる	創れ
締める	締め
取りはずす	取りはずさ
談じ込む	談じ込ま
決定づける	決定づけ
出し抜ける	出し抜け
だきおこせる	だきおこせ
言い落す	言い落さ
吹き抜ける	吹き抜け
あざむく	あざむか
言い合う	言い合わ
うぬぼれる	うぬぼれ
浮き出る	浮き出
埋めあわせる	埋めあわせ
かき揚げる	かき揚げ
はぐくむ	はぐくま
取り残す	取り残さ
見澄ます	見澄まさ
うちだせる	うちだせ
ことなる	ことなら
捕える	捕え
空うそぶく	空うそぶか
遠のく	遠のか
先立てる	先立て
練れる	練れ
さとせる	さとせ
いりまじる	いりまじら
留まれる	留まれ
突き破れる	突き破れ
取り逃す	取り逃さ
よじる	よじ
お目にかかる	お目にかから
じゃらす	じゃらさ
濁らす	濁らさ
聞出す	聞出さ
促す	促さ
飲み乾す	飲み乾さ
深ける	深け
うなづく	うなづか
とびあがる	とびあがら
寄添う	寄添わ
拝み倒す	拝み倒さ
とおざかる	とおざから
映し出せる	映し出せ
行暮れる	行暮れ
買い付ける	買い付け
ひきいる	ひきい
くりかえる	くりかえ
ハヤる	ハヤら
呑み潰れる	呑み潰れ
あらいあげる	あらいあげ
焼き捨てる	焼き捨て
しにそこなう	しにそこなわ
伸びる	伸び
乗る	乗ら
睨み付ける	睨み付け
しなだれる	しなだれ
取り込む	取り込ま
引き締る	引き締ら
差換える	差換え
捩じ込む	捩じ込ま
払いのける	払いのけ
煮立つ	煮立た
さそいかける	さそいかけ
被せる	被せ
くつがえせる	くつがえせ
そぼふる	そぼふら
はげあがる	はげあがら
聞く	聞か
あたれる	あたれ
懲らしめる	懲らしめ
そめわける	そめわけ
差掛る	差掛ら
折合う	折合わ
託する	託し
ぬいあげる	ぬいあげ
乗り合せる	乗り合せ
うたいあげる	うたいあげ
なきわめく	なきわめか
書きつける	書きつけ
締出す	締出さ
無くする	無くし
けいする	けいし
にじり寄る	にじり寄ら
辿れる	辿れ
苦りきる	苦りきら
ひやかす	ひやかさ
愚痴る	愚痴ら
毟る	毟ら
打ち倒す	打ち倒さ
てきする	てきし
えがきだせる	えがきだせ
遣り遂げる	遣り遂げ
稔る	稔ら
きりこめる	きりこめ
よみあげる	よみあげ
いつわる	いつわら
たれこめる	たれこめ
飛かける	飛かけら
取り締まる	取り締まら
ずらせる	ずらせ
とりされる	とりされ
買いたたける	買いたたけ
いこぼれる	いこぼれ
くみする	くみし
浮かせる	浮かせ
応える	応え
侵せる	侵せ
そそりたつ	そそりたた
探り出す	探り出さ
言い交わす	言い交わさ
ぬくもる	ぬくもら
持崩す	持崩さ
ちぢみあがる	ちぢみあがら
窄む	窄ま
厭う	厭わ
はやらす	はやらさ
おっぱじめる	おっぱじめ
望める	望め
なりひびく	なりひびか
証する	証し
省ける	省け
たまる	たまら
あらいたてる	あらいたて
逃げ回れる	逃げ回れ
うちころす	うちころさ
張付ける	張付け
すすめる	すすめ
懲らす	懲らさ
涌く	涌か
しょうする	しょうし
はしりだす	はしりださ
しわばむ	しわばま
心がける	心がけ
突抜ける	突抜け
為さる	為さら
擦りむく	擦りむか
売り抜ける	売り抜け
つうがる	つうがら
すみかえる	すみかえ
あらせる	あらせ
さわぎたてる	さわぎたて
得る	さわぎたて
なつける	なつけ
染返す	染返さ
立ち上る	立ち上ら
あわだてる	あわだて
よみながす	よみながさ
下びる	下び
おさめる	おさめ
張り巡らせる	張り巡らせ
ひろがる	ひろがら
ぎむづける	ぎむづけ
かりあつめる	かりあつめ
行き逢う	行き逢わ
闌ける	闌け
溜まる	溜まら
心する	心し
修める	修め
みほれる	みほれ
でっちあげる	でっちあげ
すくいだす	すくいださ
困り果てる	困り果て
受け付ける	受け付け
申し述べる	申し述べ
問い質す	問い質さ
捧ぐ	捧げ
燃え盛る	燃え盛ら
寄せつける	寄せつけ
篭もれる	篭もれ
鳴り響く	鳴り響か
蹴っ飛ばす	蹴っ飛ばさ
いきづく	いきづか
こまりぬく	こまりぬか
沁む	沁ま
うちたおす	うちたおさ
触れ合う	触れ合わ
持ちこたえる	持ちこたえ
馳せる	馳せ
おりこむ	おりこま
ふく	ふか
振回す	振回さ
ねがえる	ねがえら
こづきまわす	こづきまわさ
火取る	火取ら
履違える	履違え
とりもどす	とりもどさ
乗じる	乗じ
切る	切ら
ひろめる	ひろめ
引き出せる	引き出せ
弥立つ	弥立た
かち得る	かち得
啄める	啄め
かきくどく	かきくどか
取り捨てる	取り捨て
めぐらす	めぐらさ
差しかざす	差しかざさ
よる	よら
召抱える	召抱え
ひかえる	ひかえ
きかざる	きかざら
下押す	下押さ
押し下げる	押し下げ
ねとぼける	ねとぼけ
やじれる	やじれ
急く	急か
しかれる	しかれ
いきりたつ	いきりたた
細る	細ら
とろかす	とろかさ
取り計らえる	取り計らえ
刺せる	刺せ
聞きあわせる	聞きあわせ
くずれおちる	くずれおち
はげむ	はげま
ほうこうづける	ほうこうづけ
語り掛ける	語り掛け
埋ける	埋け
這出る	這出
跳あがる	跳あがら
もげる	もげ
アガる	アガら
落ちつく	落ちつか
しぼりあげる	しぼりあげ
込む	込ま
踏込む	踏込ま
めくれる	めくれ
飛付く	飛付か
引渡す	引渡さ
絞まる	絞まら
寝転がる	寝転がら
ぬけあがる	ぬけあがら
示し合わせる	示し合わせ
漬けこむ	漬けこま
実る	実ら
いく	いか
特徴付ける	特徴付け
送りだす	送りださ
住める	住め
縮みあがる	縮みあがら
よみこめる	よみこめ
買い尽くす	買い尽くさ
衝ける	衝け
またがる	またがら
はぜる	はぜ
まなびとる	まなびとら
乗り過ごす	乗り過ごさ
並ぶ	並ば
取り離せる	取り離せ
孕む	孕ま
いりこむ	いりこま
いきごむ	いきごま
よみあわせる	よみあわせ
くらえる	くらえ
吹き出す	吹き出さ
ひきずりこめる	ひきずりこめ
おきだす	おきださ
呈す	呈さ
起き上がる	起き上がら
降り頻る	降り頻ら
さえぎれる	さえぎれ
ためせる	ためせ
委ねる	委ね
引き繕う	引き繕わ
ひびく	ひびか
殖やす	殖やさ
連れ添う	連れ添わ
いばる	いばら
もりあげる	もりあげ
立て替える	立て替え
甘んじる	甘んじ
掃ける	掃け
浮かれ出でる	浮かれ出で
底知る	底知ら
散りばめる	散りばめ
乗切る	乗切ら
ぬいこめる	ぬいこめ
いんする	いんし
鳴く	鳴か
通す	通さ
ひろいあげる	ひろいあげ
稼げる	稼げ
待ち望む	待ち望ま
登る	登ら
超せる	超せ
みむく	みむか
寝つく	寝つか
言合う	言合わ
なずむ	なずま
臨む	臨ま
押し倒す	押し倒さ
飛歩く	飛歩か
駈ける	駈け
引き摺り込む	引き摺り込ま
悄げる	悄げ
でまわる	でまわら
織り成す	織り成さ
つっつく	つっつか
致す	致さ
根付く	根付か
きりかえる	きりかえ
はぎあわす	はぎあわさ
言含める	言含め
うとむ	うとま
寄すがる	寄すがら
謗る	謗ら
閉こもる	閉こもら
みあげる	みあげ
追いたてる	追いたて
うかる	うから
攻立てる	攻立て
抱きすくめる	抱きすくめ
間ぎる	間ぎら
ながれだす	ながれださ
払い出せる	払い出せ
蒸し返す	蒸し返さ
回れる	回れ
みなぎる	みなぎら
曝せる	曝せ
まぜる	まぜ
こぼれ落ちる	こぼれ落ち
頼み込める	頼み込め
まちわびる	まちわび
引止める	引止め
寸たる	寸たら
薦める	薦め
押す	押さ
合わさる	合わさら
歩む	歩ま
如く	如か
鞘走る	鞘走ら
まんずる	まんぜ
こごめる	こごめ
ふらせる	ふらせ
すわれる	すわれ
連込む	連込ま
在す	在さ
みだす	みださ
こわれる	こわれ
磨り潰す	磨り潰さ
あぶる	あぶら
利かす	利かさ
売りとばす	売りとばさ
そんする	そんし
つみかさなる	つみかさなら
仕える	仕え
拗る	拗ら
買受ける	買受け
透く	透か
怒鳴る	怒鳴ら
萎びる	萎び
扱う	扱わ
ながれつく	ながれつか
られる	られ
切込む	切込ま
差し置く	差し置か
見返る	見返ら
まさる	まさら
鎧う	鎧わ
早まる	早まら
隠せる	隠せ
熟む	熟ま
しがみつける	しがみつけ
ついえる	ついえ
かむる	かむら
呵する	呵し
討ちとる	討ちとら
しるせる	しるせ
血塗る	血塗ら
降り敷く	降り敷か
書く	書か
嵩じる	嵩じ
もちあがる	もちあがら
吸う	吸わ
もだえる	もだえ
追い回せる	追い回せ
食わす	食わさ
思す	思さ
書きいれる	書きいれ
ふきとばす	ふきとばさ
感じ取れる	感じ取れ
いいふらす	いいふらさ
散り敷く	散り敷か
奪う	奪わ
ねぎらう	ねぎらわ
働く	働か
競える	競え
たかまる	たかまら
捻れる	捻れ
そだてあげる	そだてあげ
縺れる	縺れ
亙れる	亙れ
よみとる	よみとら
あかじみる	あかじみ
はりたおす	はりたおさ
取揃える	取揃え
くくめる	くくめ
差しかける	差しかけ
とどろかす	とどろかさ
もやす	もやさ
伸す	伸さ
討ち果す	討ち果さ
むかえうつ	むかえうた
もつれこむ	もつれこま
寄付く	寄付か
あげつらう	あげつらわ
しゃする	しゃし
偲べる	偲べ
てらせる	てらせ
移り住む	移り住ま
延す	延さ
そらす	そらさ
惘れる	惘れ
言い替える	言い替え
屈す	屈さ
寿ぐ	寿が
際立つ	際立た
違える	違え
そそのかす	そそのかさ
来す	来さ
並べたてる	並べたて
相せっする	相せっし
盾突く	盾突か
くすべる	くすべ
突っこむ	突っこま
はれわたる	はれわたら
あぶれる	あぶれ
組みいれる	組みいれ
つどう	つどわ
めばえる	めばえ
蓄える	蓄え
いつく	いつか
見渡す	見渡さ
たとえる	たとえ
とけこむ	とけこま
赤茶ける	赤茶け
背負い込める	背負い込め
切掛ける	切掛け
おびく	おびか
漲る	漲ら
背負い込む	背負い込ま
落ち合える	落ち合え
かりたおす	かりたおさ
ふりまける	ふりまけ
とける	とけ
差出る	差出
おいこめる	おいこめ
なめる	なめ
たくれる	たくれ
騒ぎ立てる	騒ぎ立て
繋ぐ	繋が
にこめる	にこめ
おもいおこせる	おもいおこせ
遂せる	遂せ
煮込む	煮込ま
つっかえる	つっかえ
横切る	横切ら
勘ぐる	勘ぐら
遊び回る	遊び回ら
外れる	外れ
切結ぶ	切結ば
かずく	かずか
つけだす	つけださ
あいつづく	あいつづか
守立てる	守立て
のたまう	のたまわ
窮める	窮め
落とす	落とさ
うけとめる	うけとめ
行き交う	行き交わ
降る	降ら
買いかぶる	買いかぶら
思い出す	思い出さ
受かる	受から
はりあわせる	はりあわせ
くみあわせる	くみあわせ
絶やす	絶やさ
齧り付く	齧り付か
おこないすます	おこないすまさ
呑みこむ	呑みこま
具わる	具わら
送り出せる	送り出せ
いっする	いっし
塞く	塞か
仕る	仕ら
突っぷす	突っぷさ
もみけせる	もみけせ
吸える	吸え
つきあう	つきあわ
きざむ	きざま
敬する	敬し
しゃちこばる	しゃちこばら
弾き出せる	弾き出せ
宛てる	宛て
選りすぐる	選りすぐら
思い止まる	思い止まら
ふりあてる	ふりあて
打ち立てる	打ち立て
欲する	欲し
なめす	なめさ
食む	食ま
即ける	即け
駆け抜ける	駆け抜け
染み着く	染み着か
増す	増さ
沸き立つ	沸き立た
駆ける	駆け
すう	すわ
受け取る	受け取ら
たくる	たくら
蒸す	蒸さ
透通る	透通ら
老け込む	老け込ま
見倣う	見倣わ
持出す	持出さ
限る	限ら
しにわかれる	しにわかれ
つっころばす	つっころばさ
図る	図ら
手なれる	手なれ
あるきつめる	あるきつめら
忘れ去る	忘れ去ら
忍べる	忍べ
交わせる	交わせ
取払う	取払わ
くゆらす	くゆらさ
打ち消す	打ち消さ
厭きる	厭き
行きかかる	行きかから
覆う	覆わ
読み比べる	読み比べ
役に立つ	役に立た
滑り降ちる	滑り降ち
おがみたおす	おがみたおさ
盛り合わせる	盛り合わせ
なぐれる	なぐれ
突き戻す	突き戻さ
あり	あら
追抜く	追抜か
ひやす	ひやさ
ひきつづく	ひきつづか
響かす	響かさ
駆り催す	駆り催さ
送り付ける	送り付け
仕組む	仕組ま
磨きあげる	磨きあげ
湿る	湿ら
ぱらつく	ぱらつか
攫む	攫ま
先立つ	先立た
分かる	分から
股がる	股がら
倒れ込む	倒れ込ま
ひるがえる	ひるがえら
見つける	見つけ
褒めちぎる	褒めちぎら
取り払う	取り払わ
駆出す	駆出さ
取り押さえる	取り押さえ
釣り込む	釣り込ま
けしとめる	けしとめ
上廻る	上廻ら
転がれる	転がれ
とりのぞく	とりのぞか
打勝つ	打勝た
寄りかかる	寄りかから
溶けだす	溶けださ
せいだす	せいださ
さそいだす	さそいださ
かきさす	かきささ
飲みこむ	飲みこま
蘇る	蘇ら
掛け合う	掛け合わ
かいだす	かいださ
打ち落す	打ち落さ
穫る	穫ら
妻せる	妻せ
じらす	じらさ
あふる	あふら
ムキになる	ムキになら
食入る	食入ら
言い聞かす	言い聞かさ
聞き咎める	聞き咎め
よみきる	よみきら
取らせる	取らせ
ねむりこける	ねむりこけ
名乗る	名乗ら
過ぎる	過ぎら
とりはなす	とりはなさ
いいそびれる	いいそびれ
ぎんじる	ぎんじ
絞り出す	絞り出さ
乗り越す	乗り越さ
おしたおせる	おしたおせ
かどだてる	かどだて
染直す	染直さ
こしかける	こしかけ
にげこめる	にげこめ
ぬりつぶせる	ぬりつぶせ
よごれる	よごれ
ゆるむ	ゆるま
突き上げる	突き上げ
ふれこめる	ふれこめ
据え置く	据え置か
灯す	灯さ
入り替る	入り替ら
投げ入れる	投げ入れ
居こぼれる	居こぼれ
外らす	外らさ
もりこむ	もりこま
腫らす	腫らさ
繰りかえす	繰りかえさ
誉めそやす	誉めそやさ
ききとどける	ききとどけ
すっぱぬける	すっぱぬけ
ぼやく	ぼやか
掻き合せる	掻き合せ
そがれる	そがれ
食い足りる	食い足り
荒し回る	荒し回ら
解く	解か
ぶれる	ぶれ
つめこむ	つめこま
ちかよる	ちかよら
仕付ける	仕付け
拘る	拘ら
投げ掛ける	投げ掛け
遣り過す	遣り過さ
揺る	揺ら
薙ぎ倒す	薙ぎ倒さ
かき曇る	かき曇ら
うそぶく	うそぶか
せきとめる	せきとめ
浮きでる	浮きで
ひかる	ひから
突きつける	突きつけ
掛かれる	掛かれ
ふり合う	ふり合わ
みつ	みた
換える	換え
とりなす	とりなさ
張切る	張切ら
渋る	渋ら
啓する	啓し
蠢かす	蠢かさ
おしかえせる	おしかえせ
堪える	堪え
遣える	遣え
すみこめる	すみこめ
貸せる	貸せ
飛びのれる	飛びのれ
仰せ付ける	仰せ付け
毳立つ	毳立た
よぎる	よぎら
黙りこくる	黙りこくら
る	黙りこくら
沸き返る	沸き返ら
往ける	往け
張り合わせる	張り合わせ
ぶらさがる	ぶらさがら
すくう	すくわ
狩り出す	狩り出さ
取り掛る	取り掛ら
申渡す	申渡さ
称える	称え
入り込む	入り込ま
すりへる	すりへら
装う	装わ
立てる	立て
おもいあまる	おもいあまら
もやう	もやわ
もちよれる	もちよれ
いいかえせる	いいかえせ
とじ込む	とじ込ま
入り切る	入り切ら
陰る	陰ら
塞き止める	塞き止め
はずむ	はずま
染め付ける	染め付け
ねりなおす	ねりなおさ
取かかる	取かから
ぐらつく	ぐらつか
押分ける	押分け
なごむ	なごま
いのこれる	いのこれ
劣る	劣ら
吹出す	吹出さ
とぼける	とぼけ
とびつける	とびつけ
酌み交わす	酌み交わさ
掻ける	掻け
立返る	立返ら
違う	違わ
ムシる	ムシら
する	すら
おもいつめる	おもいつめ
解き放す	解き放さ
言い切る	言い切ら
参る	参ら
要す	要さ
病ほうける	病ほうけ
かみしずまる	かみしずまら
すわる	すわら
微笑む	微笑ま
刷込む	刷込ま
延ばせる	延ばせ
在り合わせる	在り合わせ
組みあわせる	組みあわせ
挿す	挿さ
探し当てる	探し当て
絶える	絶え
つぶやく	つぶやか
練り合わす	練り合わさ
おぢゃる	おぢゃら
ゆめみる	ゆめみ
みそこなう	みそこなわ
まぜっ返す	まぜっ返さ
つみこむ	つみこま
誦する	誦し
截つ	截た
うめあわせる	うめあわせ
しこなす	しこなさ
織り込む	織り込ま
押え込む	押え込ま
ささやく	ささやか
うつむく	うつむか
積み立てる	積み立て
差繰る	差繰ら
たちよれる	たちよれ
死に別れる	死に別れ
掘り起こす	掘り起こさ
とざす	とざさ
あまる	あまら
合せる	合せ
組敷く	組敷か
接ぎ合わす	接ぎ合わさ
哭する	哭し
待ちわびる	待ちわび
とびおりる	とびおり
斎く	斎か
彫りつける	彫りつけ
なる	なら
とくせいづける	とくせいづけ
張り出せる	張り出せ
課する	課し
持ち替える	持ち替え
むし返す	むし返さ
背負える	背負え
下り立つ	下り立た
みがきこむ	みがきこま
ひっぱたく	ひっぱたか
かり出す	かり出さ
もえでる	もえで
潜り込む	潜り込ま
いれちがう	いれちがわ
浮かされる	浮かされ
べんする	べんし
摺る	摺ら
見送る	見送ら
いいわたす	いいわたさ
尖る	尖ら
おとなう	おとなわ
でっぱる	でっぱら
いけどる	いけどら
打殺す	打殺さ
うつぶせる	うつぶせ
きせる	きせ
昇る	昇ら
突き抜く	突き抜か
たたる	たたら
追い廻す	追い廻さ
黒める	黒め
かじる	かじら
きりたてる	きりたて
蒔ける	蒔け
しめ殺す	しめ殺さ
読みとる	読みとら
定める	定め
抜け出せる	抜け出せ
焚き付ける	焚き付け
うやまえる	うやまえ
といかける	といかけ
切りあげる	切りあげ
準ずる	準ぜ
守れる	守れ
処する	処し
差し控える	差し控え
いやしめる	いやしめ
うばいとれる	うばいとれ
きりかえす	きりかえさ
懐かしむ	懐かしま
凪ぐ	凪が
得	得
撰べる	撰べ
発つ	発た
晦ます	晦まさ
繰りあわせる	繰りあわせ
熬る	熬ら
掴む	掴ま
うしなう	うしなわ
もらう	もらわ
恥じ入る	恥じ入ら
のりいれる	のりいれ
きらわれる	きらわれ
ふかまる	ふかまら
恕する	恕し
悪びれる	悪びれ
聞きかじる	聞きかじら
咲き残る	咲き残ら
言ひ現す	言ひ現さ
そばめる	そばめ
絡みつく	絡みつか
包み込む	包み込ま
うかされる	うかされ
ひっこむ	ひっこま
魅する	魅し
引っ括る	引っ括ら
飛びつける	飛びつけ
差し翳す	差し翳さ
とりむすぶ	とりむすば
朽果てる	朽果て
温まる	温まら
振り出せる	振り出せ
のしあがれる	のしあがれ
たちこめる	たちこめ
掻きむしる	掻きむしら
引継ぐ	引継が
こんがらかる	こんがらから
堪忍ぶ	堪忍ば
建て替える	建て替え
抱着く	抱着か
ぶらつく	ぶらつか
申し渡す	申し渡さ
よろける	よろけ
たたく	たたか
映せる	映せ
まかりまちがう	まかりまちがわ
かせぐ	かせが
冷え込む	冷え込ま
せる	せ
きりだせる	きりだせ
植え付ける	植え付け
舞う	舞わ
染分ける	染分け
分つ	分た
行詰る	行詰ら
嗄らす	嗄らさ
越す	越さ
丸まる	丸まら
書付ける	書付け
いく	いか
請合う	請合わ
ひろえる	ひろえ
脱げる	脱げ
討果す	討果さ
つかいふるす	つかいふるさ
扱き使う	扱き使わ
入浸る	入浸ら
焦らす	焦らさ
覚る	覚ら
ぬる	ぬら
すみつく	すみつか
繰替える	繰替え
きりはずす	きりはずさ
建て込む	建て込ま
騒ぐ	騒が
おしだす	おしださ
おしつまる	おしつまら
まいおりる	まいおり
ガンバる	ガンバら
おどる	おどら
向う	向わ
付けかえる	付けかえ
慶する	慶し
見計らえる	見計らえ
視る	視
引っこめる	引っこめ
こころする	こころし
語りこむ	語りこま
否める	否め
おとなびる	おとなび
ひっ込む	ひっ込ま
くばる	くばら
のりすてる	のりすて
でむける	でむけ
攻め寄せる	攻め寄せ
はめ込む	はめ込ま
聞きそこなう	聞きそこなわ
貪る	貪ら
みこせる	みこせ
許す	許さ
薄める	薄め
抜け落ちる	抜け落ち
届く	届か
狭める	狭め
出掛ける	出掛け
ことよせる	ことよせ
ほっぽらかす	ほっぽらかさ
併せ持つ	併せ持た
投げつける	投げつけ
落籍す	落籍さ
ぱくる	ぱくら
踏み均す	踏み均さ
たぐう	たぐわ
ざわつく	ざわつか
突きあわす	突きあわさ
構う	構わ
ねじあげる	ねじあげ
終わる	終わら
育くむ	育くま
さぐれる	さぐれ
繕える	繕え
諾う	諾わ
切り下げる	切り下げ
みおくれる	みおくれ
生まれる	生まれ
しゃしゃりでる	しゃしゃりで
見守れる	見守れ
ひきたてる	ひきたて
祝う	祝わ
打ち砕ける	打ち砕け
問う	問わ
くみふせる	くみふせ
かいもとめる	かいもとめ
ひしゃげる	ひしゃげ
ふきとぶ	ふきとば
濡らす	濡らさ
踏みならす	踏みならさ
位置づける	位置づけ
ああなる	ああなら
静まりかえる	静まりかえら
迫れる	迫れ
吸い上げる	吸い上げ
呼び出す	呼び出さ
落ち込む	落ち込ま
しゅくする	しゅくし
食延す	食延さ
仕切る	仕切ら
宣う	宣わ
ふりまわす	ふりまわさ
置きかわる	置きかわら
代わる	代わら
すなどる	すなどら
問い合せる	問い合せ
いいおとす	いいおとさ
つっぱしれる	つっぱしれ
ほうりこむ	ほうりこま
参する	参し
労う	労わ
とらえる	とらえ
泡立つ	泡立た
とおのける	とおのけ
まがえる	まがえ
こうじる	こうじ
かき落とす	かき落とさ
やり返す	やり返さ
にたてる	にたて
くすねる	くすね
ないまぜる	ないまぜ
織りあげる	織りあげ
さそえる	さそえ
塗りつける	塗りつけ
弄する	弄し
揮う	揮わ
下げ渡す	下げ渡さ
怒る	怒ら
逃げ惑う	逃げ惑わ
飼える	飼え
騒げる	騒げ
だぶる	だぶら
あたためる	あたため
ものがたる	ものがたら
たのめる	たのめ
伴える	伴え
追い出す	追い出さ
きれこむ	きれこま
ひっこめる	ひっこめ
めいする	めいし
入込む	入込ま
檄する	檄し
貯える	貯え
聞ほれる	聞ほれ
与太る	与太ら
隣る	隣ら
いぶす	いぶさ
ゆずりわたせる	ゆずりわたせ
かみあう	かみあわ
為し遂げる	為し遂げ
突き落とす	突き落とさ
駆る	駆ら
歌いまくる	歌いまくら
積み重なる	積み重なら
うちはらう	うちはらわ
餓える	餓え
染め分ける	染め分け
囲める	囲め
食い切る	食い切ら
気取る	気取ら
わずらわす	わずらわさ
生茂る	生茂ら
有りあわせる	有りあわせ
しいれる	しいれ
とりこわせる	とりこわせ
ながびく	ながびか
こみ上げる	こみ上げ
閉じこもる	閉じこもら
きめる	きめ
おしつぶす	おしつぶさ
刺通す	刺通さ
うばう	うばわ
気ばる	気ばら
勇む	勇ま
謹む	謹ま
でおくれる	でおくれ
まとう	まとわ
ちる	ちら
煩わせる	煩わせ
よみかえる	よみかえ
かきこめる	かきこめ
たきあげる	たきあげ
通り過ぎる	通り過ぎ
なりかわる	なりかわら
偏る	偏ら
振る	振ら
なで上げる	なで上げ
相手取る	相手取ら
まかす	まかさ
裏切れる	裏切れ
刻む	刻ま
梱る	梱ら
こぞる	こぞら
さかだてる	さかだて
見交す	見交さ
降りる	降り
遂げる	遂げ
書き抜ける	書き抜け
鳴かす	鳴かさ
かこめる	かこめ
仕うまつる	仕うまつら
やどす	やどさ
揺らぐ	揺らが
鳴り出す	鳴り出さ
かりもよおす	かりもよおさ
縫い上げる	縫い上げ
さきこぼれる	さきこぼれ
よこぎれる	よこぎれ
向き合う	向き合わ
導き出せる	導き出せ
届け出る	届け出
となえる	となえ
成り代る	成り代ら
削れる	削れ
乾びる	乾び
叫べる	叫べ
なさる	なさら
気張れる	気張れ
べた付く	べた付か
ちぎる	ちぎら
やり過ごす	やり過ごさ
すわりこむ	すわりこま
はこびだす	はこびださ
叩きつける	叩きつけ
ほろぼせる	ほろぼせ
宣る	宣ら
甲ばしる	甲ばしら
便する	便し
通ぶる	通ぶら
眠らせる	眠らせ
くり広げる	くり広げ
醸し出す	醸し出さ
話し合える	話し合え
まかり出る	まかり出
脅しつける	脅しつけ
解す	解さ
いらだつ	いらだた
呼び掛ける	呼び掛け
いいつたえる	いいつたえ
訊ねる	訊ね
聞き澄ます	聞き澄まさ
差し替える	差し替え
窄まる	窄まら
更かす	更かさ
言募る	言募ら
輝かす	輝かさ
いすくまる	いすくまら
生まれつく	生まれつか
威ばる	威ばら
まきかえす	まきかえさ
失せる	失せ
追い越す	追い越さ
染抜く	染抜か
打ち払える	打ち払え
はぎ取れる	はぎ取れ
示せる	示せ
抱取る	抱取ら
ほねおる	ほねおら
当て込む	当て込ま
待ち兼ねる	待ち兼ね
つづれる	つづれ
うちくだく	うちくだか
出直せる	出直せ
取り持てる	取り持て
つられる	つられ
曝す	曝さ
有余る	有余ら
ふけこむ	ふけこま
染め抜く	染め抜か
譲り受ける	譲り受け
罰する	罰し
じぶくる	じぶくら
あらだてる	あらだて
戻す	戻さ
建て直せる	建て直せ
沸あがる	沸あがら
言消す	言消さ
順序付ける	順序付け
凍える	凍え
活気づく	活気づか
ぎする	ぎし
えらぶ	えらば
謝する	謝し
押し進める	押し進め
しずまりかえる	しずまりかえら
はじき飛ばす	はじき飛ばさ
荷なう	荷なわ
感じ入る	感じ入ら
そぼ濡れる	そぼ濡れ
掻き回す	掻き回さ
こまりきる	こまりきら
だましとる	だましとら
はらいきよめる	はらいきよめ
取すます	取すまさ
だきあげる	だきあげ
なぎたおす	なぎたおさ
殴りつける	殴りつけ
備えつける	備えつけ
酔う	酔わ
感じとる	感じとら
とりすてる	とりすて
抽んでる	抽んで
震いつく	震いつか
乗付ける	乗付け
奮い起こす	奮い起こさ
逃げ込む	逃げ込ま
しめる	しめ
おっかける	おっかけ
乗りこむ	乗りこま
評す	評さ
馴染む	馴染ま
まばたく	まばたか
つかまえる	つかまえ
おくらせる	おくらせ
ではらう	ではらわ
垂んとする	垂んとし
そそぎ込む	そそぎ込ま
叢る	叢ら
取りはからう	取りはからわ
深まる	深まら
よみながせる	よみながせ
くださる	くださら
あける	あけ
ねぶる	ねぶら
力つきる	力つき
貶める	貶め
つづり合す	つづり合さ
散ずる	散ぜ
かきおこす	かきおこさ
まつる	まつら
煎じ詰める	煎じ詰め
差上げる	差上げ
取り締る	取り締ら
あんじる	あんじ
ちぢれる	ちぢれ
急げる	急げ
慣わす	慣わさ
任せる	任せ
めだつ	めだた
たっとべる	たっとべ
たてなおせる	たてなおせ
盛れる	盛れ
さわぎだす	さわぎださ
ゆさぶれる	ゆさぶれ
書き落す	書き落さ
謹しむ	謹しま
架る	架ら
吸込む	吸込ま
見飽きる	見飽き
捜しあてる	捜しあて
にらみつける	にらみつけ
伸ばせる	伸ばせ
ききいれる	ききいれ
駆ける	駆けら
揉みほぐす	揉みほぐさ
かかずらう	かかずらわ
逃げのびる	逃げのび
練りあわせる	練りあわせ
つらぬきとおす	つらぬきとおさ
続ける	続け
飛びかかれる	飛びかかれ
匿う	匿わ
つきはなす	つきはなさ
わらう	わらわ
渇く	渇か
才ばしる	才ばしら
とおざける	とおざけ
立行く	立行か
ゆらめく	ゆらめか
ぶっとばす	ぶっとばさ
頬張る	頬張ら
衒う	衒わ
薙ぐ	薙が
念ずる	念ぜ
勘繰る	勘繰ら
逃げ込める	逃げ込め
気づかう	気づかわ
すき返す	すき返さ
ひっ掴む	ひっ掴ま
なみする	なみし
買い切れる	買い切れ
さされる	さされ
結びつける	結びつけ
つっ返す	つっ返さ
火照る	火照ら
沮む	沮ま
解る	解ら
見逸れる	見逸れ
芽吹く	芽吹か
こじ開ける	こじ開け
捏ねくる	捏ねくら
かいあたえる	かいあたえ
乾上がる	乾上がら
もぎ取る	もぎ取ら
描き出せる	描き出せ
詠込む	詠込ま
成り立つ	成り立た
嗣ぐ	嗣が
みあわせる	みあわせ
にげる	にげ
治せる	治せ
乗っかる	乗っから
ほくそ笑む	ほくそ笑ま
煎り付ける	煎り付け
ものいう	ものいわ
出くわす	出くわさ
あらいながせる	あらいながせ
引っかく	引っかか
ふくまる	ふくまら
たちわれる	たちわれ
いいなおす	いいなおさ
思い過ごす	思い過ごさ
つるしあげる	つるしあげ
切り放せる	切り放せ
おもいつく	おもいつか
ゑむ	ゑま
おもむく	おもむか
目だつ	目だた
通り越す	通り越さ
染付く	染付か
とる	とら
打ちだす	打ちださ
だんじこめる	だんじこめ
けっていづける	けっていづけ
とかす	とかさ
うちすてる	うちすて
折り返す	折り返さ
話し合う	話し合わ
老いぼれる	老いぼれ
責めたてる	責めたて
序する	序し
彫りこむ	彫りこま
麾く	麾か
拓く	拓か
書き写す	書き写さ
取抑える	取抑え
貸す	貸さ
切り落す	切り落さ
耳立つ	耳立た
取扱う	取扱わ
関す	関さ
ひっかける	ひっかけ
とうとぶ	とうとば
平らげる	平らげ
振りわける	振りわけ
打ち続く	打ち続か
侘びる	侘び
副える	副え
付け回す	付け回さ
なきじゃくる	なきじゃくら
すさぶ	すさば
いからす	いからさ
切り倒す	切り倒さ
もくろむ	もくろま
くりかえせる	くりかえせ
はなつ	はなた
仕立てる	仕立て
手放す	手放さ
糾す	糾さ
もみ合う	もみ合わ
初める	初め
立通す	立通さ
毀つ	毀た
がっつく	がっつか
みちびける	みちびけ
うけおう	うけおわ
遣る	遣ら
えぐる	えぐら
早める	早め
隣り合わせる	隣り合わせ
差し招く	差し招か
はねかえせる	はねかえせ
遣わす	遣わさ
そげる	そげ
ひん曲げる	ひん曲げ
綴りあわせる	綴りあわせ
取囲む	取囲ま
泳ぎ着ける	泳ぎ着け
撃ち止める	撃ち止め
折り込む	折り込ま
むかいあえる	むかいあえ
かきよせる	かきよせ
噛み殺す	噛み殺さ
取り返せる	取り返せ
睨みあわせる	睨みあわせ
すずむ	すずま
あたいする	あたいし
ほりだせる	ほりだせ
しらげる	しらげ
思い直す	思い直さ
きこなせる	きこなせ
うらむ	うらま
揉み消す	揉み消さ
基く	基か
いいまくる	いいまくら
あとずさる	あとずさら
映ずる	映ぜ
のる	のら
かぞえる	かぞえ
放り出す	放り出さ
のばせる	のばせ
釣りあう	釣りあわ
ねかせる	ねかせ
売れる	売れ
灯る	灯ら
眠れる	眠れ
なやませる	なやませ
かかる	かから
使う	使わ
のりこす	のりこさ
干涸らびる	干涸らび
抜きん出る	抜きん出
踏み入れる	踏み入れ
たてこもる	たてこもら
渇れる	渇れ
訴える	訴え
喜ばす	喜ばさ
突き詰める	突き詰め
いのれる	いのれ
つき抜ける	つき抜け
耕す	耕さ
こじらせる	こじらせ
あざわらう	あざわらわ
ぞくす	ぞくさ
かげる	かげ
響かせる	響かせ
いきのこれる	いきのこれ
まきおこす	まきおこさ
おもえる	おもえ
運び出せる	運び出せ
詠う	詠わ
俯せる	俯せ
染透る	染透ら
見交わす	見交わさ
汗じみる	汗じみ
蒙る	蒙ら
おいたつ	おいたた
持ち出せる	持ち出せ
にえくりかえる	にえくりかえら
湧かす	湧かさ
取り止める	取り止め
叩ける	叩け
接す	接さ
おぶう	おぶわ
被う	被わ
絡む	絡ま
ふう	ふわ
すえおく	すえおか
跳ねる	跳ね
引っ付く	引っ付か
襲う	襲わ
纏わる	纏わら
にらむ	にらま
おぼえる	おぼえ
打ちかえす	打ちかえさ
れっする	れっし
推量る	推量ら
ゆれる	ゆれ
なげこむ	なげこま
濯ぐ	濯が
ひきずりこむ	ひきずりこま
なみはずれる	なみはずれ
負う	負わ
もぎ取れる	もぎ取れ
聞き合わす	聞き合わさ
吸い付ける	吸い付け
感ずる	感ぜ
搾り取る	搾り取ら
おちぶれる	おちぶれ
轟く	轟か
不貞腐る	不貞腐ら
保する	保し
鋏める	鋏め
名づける	名づけ
逸する	逸し
置ける	置け
のりあわせる	のりあわせ
尽きる	尽き
えんづける	えんづけ
差し延べる	差し延べ
かえる	かえら
なす	なさ
うちはらえる	うちはらえ
舞い込む	舞い込ま
おもんぱかる	おもんぱから
ぬぐいされる	ぬぐいされ
行い澄ます	行い澄まさ
うち捨てる	うち捨て
おいまくる	おいまくら
見すえる	見すえ
極まる	極まら
切る	切ら
はねかえす	はねかえさ
すっとぼける	すっとぼけ
きえいる	きえいら
取りかたづける	取りかたづけ
駆けだす	駆けださ
擬す	擬さ
踏外す	踏外さ
争う	争わ
散敷く	散敷か
付出す	付出さ
込める	込め
立て通す	立て通さ
加われる	加われ
引き当てる	引き当て
足掻く	足掻か
纏まる	纏まら
ふれあう	ふれあわ
愛し合う	愛し合わ
ゆえる	ゆえ
形作れる	形作れ
鎖す	鎖さ
盛り返せる	盛り返せ
兼ね備える	兼ね備え
ふりしく	ふりしか
うりきれる	うりきれ
跳ね返せる	跳ね返せ
せり上げる	せり上げ
うちおとせる	うちおとせ
まう	まわ
よそおえる	よそおえ
飼い慣らす	飼い慣らさ
しゅくす	しゅくさ
とくちょうづける	とくちょうづけ
遡る	遡ら
みきれる	みきれ
とりいれる	とりいれ
寄かかる	寄かから
あつかふ	あつかは
跡付ける	跡付け
不貞腐れる	不貞腐れ
遣れる	遣れ
睨める	睨め
だくする	だくし
並居る	並居
こときれる	こときれ
とりかわす	とりかわさ
いいきかす	いいきかさ
ねじれる	ねじれ
怯える	怯え
見比べる	見比べ
おしとおせる	おしとおせ
みまわせる	みまわせ
ちぢまる	ちぢまら
いさみたてる	いさみたて
聞過す	聞過さ
鏤める	鏤め
浮き出す	浮き出さ
うち連れる	うち連れ
納まる	納まら
聞きとがめる	聞きとがめ
言い出す	言い出さ
狎れる	狎れ
詠ずる	詠ぜ
飲みつぶれる	飲みつぶれ
引き付ける	引き付け
ひきはなせる	ひきはなせ
落っこちる	落っこち
戻せる	戻せ
保ち合う	保ち合わ
つみわける	つみわけ
頷く	頷か
捩じ合う	捩じ合わ
積み出す	積み出さ
ちぢくれる	ちぢくれ
押入る	押入ら
つきぬける	つきぬけ
言い聞かせる	言い聞かせ
つみだす	つみださ
うまれでる	うまれで
売り出せる	売り出せ
しこる	しこら
めいずる	めいぜ
かいこめる	かいこめ
つみする	つみし
とりつくろう	とりつくろわ
諦める	諦め
みがまえる	みがまえ
勇み立てる	勇み立て
釈く	釈か
死ぬ	死な
かる	から
廻る	廻ら
繕う	繕わ
祝す	祝さ
つれだつ	つれだた
染め直せる	染め直せ
散り急ぐ	散り急が
干あがる	干あがら
擁する	擁し
はかりこむ	はかりこま
取りしまる	取りしまら
説き伏せる	説き伏せ
みつもれる	みつもれ
かけ隔たる	かけ隔たら
よびつける	よびつけ
突ぱしる	突ぱしら
降り積もる	降り積もら
拭う	拭わ
たたき起す	たたき起さ
若やぐ	若やが
溶かす	溶かさ
まよう	まよわ
とびわたる	とびわたら
うけおえる	うけおえ
芽立つ	芽立た
催す	催さ
降ろす	降ろさ
泣濡れる	泣濡れ
讀める	讀め
たちきれる	たちきれ
失くなる	失くなら
いろあせる	いろあせ
くるむ	くるま
撮る	撮ら
出逢う	出逢わ
恤む	恤ま
吹おろす	吹おろさ
抜きんでる	抜きんで
防ぐ	防が
下さる	下さら
おぼしめす	おぼしめさ
かすめとる	かすめとら
くみあげる	くみあげ
むしり取る	むしり取ら
さしまねく	さしまねか
洗い落とす	洗い落とさ
かけまわれる	かけまわれ
誑かす	誑かさ
つれさる	つれさら
食合う	食合わ
打ちみる	打ちみ
すませる	すませ
踏ん張る	踏ん張ら
燃えつく	燃えつか
もみけす	もみけさ
やりこめる	やりこめ
申す	申さ
しする	しし
りかいしあう	りかいしあわ
ほころびる	ほころび
くだる	くだら
読み合わす	読み合わさ
丸めこむ	丸めこま
言い消す	言い消さ
こき使う	こき使わ
突通る	突通ら
押し詰る	押し詰ら
せおえる	せおえ
うく	うか
献ずる	献ぜ
劈く	劈か
敵する	敵し
始まる	始まら
ひねくる	ひねくら
撫で付ける	撫で付け
洩らす	洩らさ
愛す	愛さ
ひっ被る	ひっ被ら
いらせられる	いらせられ
取り巻ける	取り巻け
照れる	照れ
指し示す	指し示さ
下立つ	下立た
かさねあわす	かさねあわさ
引きちぎれる	引きちぎれ
取り消せる	取り消せ
きれる	きれ
おもいみだれる	おもいみだれ
笑い飛ばせる	笑い飛ばせ
かけ離れる	かけ離れ
さしかける	さしかけ
みみだつ	みみだた
奉ずる	奉ぜ
択ぶ	択ば
こぼす	こぼさ
わかがえる	わかがえら
ふくめる	ふくめ
生け捕る	生け捕ら
署する	署し
組み立る	組み立
ぬくまる	ぬくまら
おろす	おろさ
立入る	立入ら
ひっくり返れる	ひっくり返れ
もりわける	もりわけ
置き換える	置き換え
投げ勝つ	投げ勝た
みづく	みづか
えりすぐる	えりすぐら
威張れる	威張れ
聴こえる	聴こえ
産める	産め
むかう	むかわ
かれる	かれ
ねらいうつ	ねらいうた
ふりかざす	ふりかざさ
酌める	酌め
弾ける	弾け
もよおす	もよおさ
食う	食わ
ブッ殺す	ブッ殺さ
いやがる	いやがら
僭する	僭し
撒く	撒か
持ち帰る	持ち帰ら
きざす	きざさ
おしよせる	おしよせ
おくらす	おくらさ
歩ます	歩まさ
ふうきる	ふうきら
転げる	転げ
かきだす	かきださ
しょげこむ	しょげこま
突き当たる	突き当たら
ほきだす	ほきださ
かりあげる	かりあげ
すごせる	すごせ
こねる	こね
差し出る	差し出
狙い打つ	狙い打た
得る	得
粒だつ	粒だた
きりひらく	きりひらか
揺ぎ出でる	揺ぎ出で
遺る	遺ら
やりなおす	やりなおさ
めんする	めんし
真似る	真似
ちりしく	ちりしか
出盛る	出盛ら
減り込む	減り込ま
いやせる	いやせ
役する	役し
なける	なけ
立ち尽くす	立ち尽くさ
舞い戻る	舞い戻ら
強いる	強い
ぬりつける	ぬりつけ
ひそめる	ひそめ
おもいしる	おもいしら
乗っける	乗っけ
結えつける	結えつけ
おどり出る	おどり出
もうしこむ	もうしこま
惚れこむ	惚れこま
うずまく	うずまか
いのこる	いのこら
異なる	異なら
詣れる	詣れ
積上げる	積上げ
撓る	撓ら
すぼめる	すぼめ
ことほぐ	ことほが
経あがる	経あがら
煮詰める	煮詰め
ひやせる	ひやせ
打沈む	打沈ま
しゃくう	しゃくわ
拡げる	拡げ
撫ぜる	撫ぜ
かたげる	かたげ
轢き殺す	轢き殺さ
だく	だか
差延べる	差延べ
令する	令し
身篭る	身篭ら
あらがう	あらがわ
罷りでる	罷りで
こまぬく	こまぬか
ぬれる	ぬれ
堪り兼ねる	堪り兼ね
釣れる	釣れ
差し障る	差し障ら
すれちがう	すれちがわ
はせ回る	はせ回ら
飛びまわる	飛びまわら
煙る	煙ら
満たす	満たさ
騙る	騙ら
反れる	反れ
呼ばれる	呼ばれ
でなおせる	でなおせ
つけたせる	つけたせ
登り詰める	登り詰め
寝込む	寝込ま
坐する	坐し
とりあわす	とりあわさ
耐え忍ぶ	耐え忍ば
捻じる	捻じら
駆け回れる	駆け回れ
攻上る	攻上ら
打かさなる	打かさなら
いきちがう	いきちがわ
対応付ける	対応付け
踏み分ける	踏み分け
掘出す	掘出さ
止める	止め
断切る	断切ら
在り合せる	在り合せ
盛りかえす	盛りかえさ
たおる	たおら
ひにくる	ひにくら
摩する	摩し
かたりつぐ	かたりつが
おりかさなる	おりかさなら
かいかぶる	かいかぶら
むきかわる	むきかわら
醒ます	醒まさ
打つ	打た
あやめる	あやめ
執る	執ら
つっぱる	つっぱら
組みこめる	組みこめ
とんがる	とんがら
埋まる	埋まら
活きる	活き
ぶちのめす	ぶちのめさ
へきする	へきし
つめかける	つめかけ
言い含める	言い含め
敲く	敲か
ただよう	ただよわ
掛け持つ	掛け持た
いりみだれる	いりみだれ
きたる	きたら
押え付ける	押え付け
賜る	賜ら
並べ換える	並べ換え
ひえる	ひえ
取り次げる	取り次げ
撮み出す	撮み出さ
のめりこむ	のめりこま
あいしあえる	あいしあえ
じみる	じみ
しずまる	しずまら
あやなす	あやなさ
笑いとばす	笑いとばさ
取り合う	取り合わ
なきすがる	なきすがら
ひとはだぬぐ	ひとはだぬが
取って返す	取って返さ
取入れる	取入れ
乳繰る	乳繰ら
煮染める	煮染め
なぎはらう	なぎはらわ
たく	たか
ふうする	ふうし
果たせる	果たせ
刈入れる	刈入れ
まかる	まから
突っぱなす	突っぱなさ
全うする	全うし
書きぬく	書きぬか
起きあがる	起きあがら
書き添える	書き添え
ふるわす	ふるわさ
であるける	であるけ
飛び付く	飛び付か
さしはさむ	さしはさま
撞く	撞か
掛離れる	掛離れ
とびこえる	とびこえ
達する	達し
みる	み
謀る	謀ら
食詰める	食詰め
探し回る	探し回ら
かわいがれる	かわいがれ
とまれる	とまれ
立ち入る	立ち入ら
転ける	転け
当てこする	当てこすら
こする	こすら
抜き出せる	抜き出せ
とびあがれる	とびあがれ
そそける	そそけ
頂く	頂か
おちあえる	おちあえ
おちこぼれる	おちこぼれ
皮肉る	皮肉ら
言いきる	言いきら
乗り換える	乗り換え
さしもどす	さしもどさ
つくりなす	つくりなさ
搾り上げる	搾り上げ
急ぐ	急が
立ち尽す	立ち尽さ
住み込める	住み込め
おろせる	おろせ
震える	震え
ぞくする	ぞくし
飛びこむ	飛びこま
見いだせる	見いだせ
蔓延る	蔓延ら
かき出す	かき出さ
すごす	すごさ
わずらう	わずらわ
合わせる	合わせ
踏切る	踏切ら
かわかす	かわかさ
背負う	背負わ
拭ける	拭け
手向かえる	手向かえ
付廻す	付廻さ
くちはてる	くちはて
果せる	果せ
あおざめる	あおざめ
遅なわる	遅なわら
ごてつく	ごてつか
だきしめる	だきしめ
詠む	詠ま
あめる	あめ
罷り出でる	罷り出で
相つぐ	相つが
ねらえる	ねらえ
かりいれる	かりいれ
そねむ	そねま
きりひらける	きりひらけ
触る	触ら
つのる	つのら
まきこめる	まきこめ
つれこむ	つれこま
寝転ぶ	寝転ば
亡くなる	亡くなら
ばら蒔く	ばら蒔か
あかしくらす	あかしくらさ
もえさかる	もえさから
くわえる	くわえ
借り出す	借り出さ
くちすすぐ	くちすすが
もたつく	もたつか
でんぐりがえる	でんぐりがえら
弄る	弄ら
もちきる	もちきら
額づく	額づか
盛込む	盛込ま
巻上げる	巻上げ
殴り付ける	殴り付け
若返る	若返ら
行き渡る	行き渡ら
搾る	搾ら
ほりおこせる	ほりおこせ
魅入る	魅入ら
売り込める	売り込め
秘める	秘め
潜り込める	潜り込め
引き下ろす	引き下ろさ
よりぬく	よりぬか
ひき込む	ひき込ま
たじろぐ	たじろが
弾き出す	弾き出さ
映す	映さ
さだめる	さだめ
せかす	せかさ
よごす	よごさ
わびいる	わびいら
くえる	くえ
いなかびる	いなかび
見廻る	見廻ら
いかれる	いかれ
敗れる	敗れ
苔むす	苔むさ
ぬけだせる	ぬけだせ
いいまるめる	いいまるめ
なびく	なびか
落着き払う	落着き払わ
とばす	とばさ
議する	議し
靡かす	靡かさ
たためる	たため
振り切る	振り切ら
積む	積ま
いえる	いえ
みはるかす	みはるかさ
のし歩く	のし歩か
刃向かう	刃向かわ
薄まる	薄まら
薄れる	薄れ
引留める	引留め
暴き出す	暴き出さ
抱え込む	抱え込ま
わななく	わななか
改む	改め
すてる	すて
なげだす	なげださ
踏付ける	踏付け
設える	設え
看做す	看做さ
ひきこむ	ひきこま
くりぬく	くりぬか
売込む	売込ま
つうじる	つうじ
ふるびる	ふるび
ぬりつぶす	ぬりつぶさ
踏み込める	踏み込め
ばれる	ばれ
もりつぶす	もりつぶさ
のみほせる	のみほせ
反り返る	反り返ら
毛羽立つ	毛羽立た
どくする	どくし
あふれでる	あふれで
反す	反さ
やりすごせる	やりすごせ
游ぐ	游が
うちたてる	うちたて
遭う	遭わ
どよもす	どよもさ
塞ぐ	塞が
引き合える	引き合え
貫き通す	貫き通さ
かしきる	かしきら
打消す	打消さ
ねぎる	ねぎら
ふりかぶる	ふりかぶら
いきがる	いきがら
更す	更さ
呼戻す	呼戻さ
教える	教え
ほりかえせる	ほりかえせ
映る	映ら
疲らせる	疲らせ
さかえる	さかえ
貫ける	貫け
流れ落ちる	流れ落ち
呼び覚ます	呼び覚まさ
揺ぐ	揺が
張りとばす	張りとばさ
ふみこむ	ふみこま
咲かす	咲かさ
とむらう	とむらわ
刺立つ	刺立た
聞こえる	聞こえ
とまる	とまら
変じる	変じ
罰す	罰さ
降り出す	降り出さ
磨りつぶす	磨りつぶさ
掻い繰る	掻い繰ら
そなわる	そなわら
泣く	泣か
浸る	浸ら
交ぜかえす	交ぜかえさ
留まる	留まら
暴れまくる	暴れまくら
まちのぞむ	まちのぞま
引入れる	引入れ
誓う	誓わ
取り零す	取り零さ
こがれる	こがれ
組める	組め
たけりたつ	たけりたた
まぎらせる	まぎらせ
そめぬく	そめぬか
愛でる	愛で
さとす	さとさ
侵す	侵さ
濁らせる	濁らせ
吸い出す	吸い出さ
擦る	擦ら
歌える	歌え
張上げる	張上げ
掛け合わす	掛け合わさ
書記す	書記さ
ぶら下がれる	ぶら下がれ
入まじる	入まじら
止す	止さ
引き払う	引き払わ
回る	回ら
探り出せる	探り出せ
振りかける	振りかけ
磨れる	磨れ
かんずる	かんぜ
立並ぶ	立並ば
朽ち果てる	朽ち果て
こやす	こやさ
卜する	卜し
寄り添う	寄り添わ
誘い出せる	誘い出せ
あやまれる	あやまれ
ひっ括る	ひっ括ら
掻き込む	掻き込ま
受持つ	受持た
落ちる	落ち
移る	移ら
ハリたおす	ハリたおさ
奮い起つ	奮い起た
ほす	ほさ
茂り合う	茂り合わ
転げ込む	転げ込ま
体する	体し
晴らす	晴らさ
心付く	心付か
革める	革め
むせぶ	むせば
窘める	窘め
はらいだす	はらいださ
いい表す	いい表さ
殴りとばす	殴りとばさ
よびさけぶ	よびさけば
澄切る	澄切ら
立後れる	立後れ
とりしきれる	とりしきれ
かたまりあう	かたまりあわ
係る	係ら
おとし入れる	おとし入れ
立こもる	立こもら
かよわす	かよわさ
あわさる	あわさら
飛ばす	飛ばさ
ふしくれだつ	ふしくれだた
刷り上がる	刷り上がら
ひしめき合う	ひしめき合わ
かんがえだせる	かんがえだせ
立退く	立退か
善がる	善がら
はじき出せる	はじき出せ
働かせる	働かせ
すみつける	すみつけ
れる	れ
あう	あわ
にぎりつぶす	にぎりつぶさ
待ち構える	待ち構え
忍び寄る	忍び寄ら
かなしむ	かなしま
振り立てる	振り立て
もうしたてる	もうしたて
言付ける	言付け
打ち砕く	打ち砕か
みかける	みかけ
うつ	うた
買い叩く	買い叩か
刺し殺せる	刺し殺せ
さぐりだす	さぐりださ
敬う	敬わ
うわずる	うわずら
摺り抜ける	摺り抜け
繰寄せる	繰寄せ
結わえ付ける	結わえ付け
彫り上げる	彫り上げ
とらわれる	とらわれ
さわる	さわら
歓ぶ	歓ば
みつもる	みつもら
つづける	つづけ
すれ違う	すれ違わ
なすりつける	なすりつけ
吃る	吃ら
追詰める	追詰め
出来る	出来
振るう	振るわ
しこむ	しこま
うめたてる	うめたて
やらす	やらさ
立ちすくむ	立ちすくま
かたす	かたさ
とりつける	とりつけ
ほほ笑む	ほほ笑ま
魘される	魘され
打ちまくる	打ちまくら
書きさす	書きささ
しまる	しまら
塗立てる	塗立て
みずぎわだつ	みずぎわだた
受け取れる	受け取れ
そこねる	そこね
放下す	放下さ
ぶす	ぶさ
こうむる	こうむら
じょうじる	じょうじ
けみする	けみし
込合う	込合わ
通じる	通じ
病める	病め
ひきとめる	ひきとめ
和らぐ	和らが
くみほす	くみほさ
あんずる	あんぜ
たちむかえる	たちむかえ
かさ張る	かさ張ら
あづかる	あづから
ふみとどまれる	ふみとどまれ
ひきいれる	ひきいれ
照らす	照らさ
いぶる	いぶら
しさる	しさら
捩れる	捩れ
出揃う	出揃わ
とびちる	とびちら
くいあらためる	くいあらため
こむ	こま
のりこせる	のりこせ
はげます	はげまさ
絞り込む	絞り込ま
決す	決さ
捨置く	捨置か
逸る	逸ら
ひかされる	ひかされ
盛り込む	盛り込ま
抜けあがる	抜けあがら
詰め掛ける	詰め掛け
結える	結え
戯ける	戯け
恋する	恋し
ふるう	ふるわ
割引く	割引か
挾む	挾ま
おれあえる	おれあえ
踏みとどまれる	踏みとどまれ
着く	着か
かまう	かまわ
泊る	泊ら
捨て置く	捨て置か
ぬすみだす	ぬすみださ
戸惑う	戸惑わ
はぐらかす	はぐらかさ
踏み切る	踏み切ら
釣込む	釣込ま
奮たつ	奮たた
凌げる	凌げ
目立つ	目立た
曇らせる	曇らせ
わりもどせる	わりもどせ
黒ずむ	黒ずま
する	し
掛り合う	掛り合わ
言返す	言返さ
きりあう	きりあわ
ゆき帰る	ゆき帰ら
取り交す	取り交さ
保ち合える	保ち合え
出過ぎる	出過ぎ
仮す	仮さ
張り裂ける	張り裂け
すみあらす	すみあらさ
いいなす	いいなさ
もりこめる	もりこめ
たびかさなる	たびかさなら
ききとる	ききとら
増さる	増さら
媚びる	媚び
あたたまる	あたたまら
卑しめる	卑しめ
寝違える	寝違え
なぐる	なぐら
うちけせる	うちけせ
問いかける	問いかけ
うちころせる	うちころせ
向かう	向かわ
運ぶ	運ば
復する	復し
つけねらう	つけねらわ
体裁振る	体裁振ら
騒ぎだす	騒ぎださ
かきあわせる	かきあわせ
竦み上がる	竦み上がら
はりだせる	はりだせ
焚く	焚か
刷れる	刷れ
躍り掛る	躍り掛ら
してやる	してやら
精出す	精出さ
到れる	到れ
看る	看
くりあわせる	くりあわせ
売り飛ばせる	売り飛ばせ
降しきる	降しきら
引締める	引締め
おいだせる	おいだせ
とびのる	とびのら
垂れ下がる	垂れ下がら
うえる	うえ
解かす	解かさ
ふてくさる	ふてくさら
そいとげる	そいとげ
いわえる	いわえ
おきかえる	おきかえ
はぎ取る	はぎ取ら
わきでる	わきで
拡がる	拡がら
着込む	着込ま
掘り出せる	掘り出せ
錆びつく	錆びつか
うきでる	うきで
ふれこむ	ふれこま
変りはてる	変りはて
のりかける	のりかけ
凝らす	凝らさ
こねくる	こねくら
とけ込める	とけ込め
吹き込む	吹き込ま
ばたつく	ばたつか
立ち働く	立ち働か
庶幾う	庶幾わ
きりわすれる	きりわすれ
はじきだす	はじきださ
草する	草し
凍む	凍ま
はいまつわる	はいまつわら
掻き暗す	掻き暗さ
與える	與え
うつしとれる	うつしとれ
かんじとれる	かんじとれ
化ける	化け
掘りさげる	掘りさげ
ふんぞりかえる	ふんぞりかえら
切り倒せる	切り倒せ
締め付ける	締め付け
こね返す	こね返さ
北叟笑む	北叟笑ま
食下がる	食下がら
引きさく	引きさか
算する	算し
言いつのる	言いつのら
ひっこ抜く	ひっこ抜か
触れ込める	触れ込め
言い尽す	言い尽さ
あからむ	あからま
説伏せる	説伏せ
擽る	擽ら
掛かり合う	掛かり合わ
たぐまる	たぐまら
指さす	指ささ
追い込める	追い込め
浮あがる	浮あがら
うらづける	うらづけ
食い下がる	食い下がら
のりだせる	のりだせ
ふためく	ふためか
詠める	詠め
ひるがえす	ひるがえさ
手つだう	手つだわ
芽ぐむ	芽ぐま
補える	補え
取り越す	取り越さ
滅びる	滅び
絡ます	絡まさ
損じる	損じ
きんずる	きんぜ
つきだせる	つきだせ
なくなす	なくなさ
請けあう	請けあわ
取り交わす	取り交わさ
張りつける	張りつけ
読み流せる	読み流せ
かもし出す	かもし出さ
ちからづける	ちからづけ
あずける	あずけ
払い出す	払い出さ
象る	象ら
そなえつける	そなえつけ
溜る	溜ら
入れ直す	入れ直さ
かかる	かから
引っ繰り返る	引っ繰り返ら
しめす	しめさ
うろつく	うろつか
もす	もさ
たける	たけ
くばりあるける	くばりあるけ
折重ねる	折重ね
とりのぞける	とりのぞけ
吹分ける	吹分け
やける	やけ
たびだてる	たびだて
騙しこむ	騙しこま
踏みにじる	踏みにじら
かたどる	かたどら
しょぼくれる	しょぼくれ
挿せる	挿せ
たきつける	たきつけ
こぼつ	こぼた
織る	織ら
切崩す	切崩さ
起き出せる	起き出せ
探せる	探せ
掘下げる	掘下げ
引き下げる	引き下げ
持切る	持切ら
食べる	食べ
おちこむ	おちこま
湿気る	湿気
煩わす	煩わさ
かっする	かっし
ながれおちる	ながれおち
振り放け見みる	振り放け見み
持ち越す	持ち越さ
割り切る	割り切ら
食らいつく	食らいつか
牽ける	牽け
天下る	天下ら
買込む	買込ま
あいまつ	あいまた
えりぬく	えりぬか
塗りつぶせる	塗りつぶせ
放く	放か
推す	推さ
とく	とか
馬鹿げる	馬鹿げ
興る	興ら
おもいすごす	おもいすごさ
ひびきわたる	ひびきわたら
あこがれる	あこがれ
おじけだつ	おじけだた
憎める	憎め
書きなぐる	書きなぐら
従える	従え
決る	決ら
漕ぎ着ける	漕ぎ着け
つむる	つむら
襲われる	襲われ
棹さす	棹ささ
泣すがる	泣すがら
打取る	打取ら
引き伸ばす	引き伸ばさ
きばむ	きばま
突き飛ばせる	突き飛ばせ
ことづける	ことづけ
ずっこける	ずっこけ
使い分ける	使い分け
あぶりだす	あぶりださ
はらいもどせる	はらいもどせ
払いもどす	払いもどさ
あぶらじみる	あぶらじみ
明け渡る	明け渡ら
伏せる	伏せ
もえ出る	もえ出
育てあげる	育てあげ
曵く	曵か
煮込める	煮込め
気圧される	気圧され
あそぶ	あそば
よせかける	よせかけ
ぬかせる	ぬかせ
受け合う	受け合わ
やり遂げる	やり遂げ
おそいかかる	おそいかから
畏れる	畏れ
よばなれる	よばなれ
うろぬく	うろぬか
かちこす	かちこさ
みたす	みたさ
痩せこける	痩せこけ
巡れる	巡れ
とりひろげる	とりひろげ
ふうじる	ふうじ
引っ返す	引っ返さ
とがめる	とがめ
老い耄れる	老い耄れ
追いこす	追いこさ
踏み入る	踏み入ら
書流す	書流さ
わき起こる	わき起こら
あおる	あおら
くいいる	くいいら
囚われる	囚われ
なごめる	なごめ
飲回す	飲回さ
歯する	歯し
うちだす	うちださ
速まる	速まら
化かせる	化かせ
たどりつける	たどりつけ
聞き入れる	聞き入れ
つとめる	つとめ
飛ぶ	飛ば
担える	担え
このむ	このま
おどしつける	おどしつけ
ふくらませる	ふくらませ
立寄る	立寄ら
みおくる	みおくら
ふみわける	ふみわけ
憂う	憂わ
託ける	託け
うせる	うせ
掻払う	掻払わ
しっする	しっし
出払う	出払わ
きこむ	きこま
じす	じさ
追い回す	追い回さ
繰りまわす	繰りまわさ
繰り越す	繰り越さ
よみやぶる	よみやぶら
切組む	切組ま
悪たれる	悪たれ
撃ち殺せる	撃ち殺せ
しきる	しきら
執成す	執成さ
もぎれる	もぎれ
ほしころす	ほしころさ
いでたつ	いでたた
たゆむ	たゆま
傷つく	傷つか
突き刺す	突き刺さ
さしさわる	さしさわら
報いる	報い
なおす	なおさ
とどける	とどけ
使い果たす	使い果たさ
てりかえす	てりかえさ
ふっきれる	ふっきれ
送り出す	送り出さ
きづく	きづか
過ごす	過ごさ
かきあげる	かきあげ
飛び回れる	飛び回れ
焦げつく	焦げつか
あおげる	あおげ
画す	画さ
しめる	しめ
くい込む	くい込ま
いならぶ	いならば
漬け込む	漬け込ま
這い出でる	這い出で
聞澄ます	聞澄まさ
ねそべる	ねそべら
現れる	現れ
親しめる	親しめ
はいいる	はいいら
進み出す	進み出さ
貸し越す	貸し越さ
はじいる	はじいら
封じ込む	封じ込ま
炒る	炒ら
取りもてる	取りもて
かなぐり捨てる	かなぐり捨て
盛る	盛ら
とばしる	とばしら
ふきおろす	ふきおろさ
ふれあえる	ふれあえ
申し越す	申し越さ
残す	残さ
きわ立つ	きわ立た
あしらう	あしらわ
鬱する	鬱し
かたまれる	かたまれ
引っ込める	引っ込め
かんがえだす	かんがえださ
囲む	囲ま
繰りあげる	繰りあげ
思い当たる	思い当たら
事切れる	事切れ
切り回せる	切り回せ
げびる	げび
縋れる	縋れ
でかす	でかさ
やくする	やくし
むす	むさ
つっぱなす	つっぱなさ
まどろむ	まどろま
動かす	動かさ
いづ	いで
取組む	取組ま
しおおせる	しおおせ
めくるめく	めくるめか
預け入れる	預け入れ
引き攣れる	引き攣れ
聞き合せる	聞き合せ
はれあがる	はれあがら
振り回せる	振り回せ
似通う	似通わ
せんじつめる	せんじつめ
高まる	高まら
彫り込める	彫り込め
乗り上げる	乗り上げ
取り合える	取り合え
まいこむ	まいこま
たちのける	たちのけ
ほとばしる	ほとばしら
ひかれる	ひかれ
世づく	世づか
やぶれる	やぶれ
書き送る	書き送ら
やってくる	やってこ
送る	送ら
打直せる	打直せ
いきる	いき
かしだす	かしださ
ふらす	ふらさ
旅だつ	旅だた
上がる	上がら
煮詰る	煮詰ら
かわいがる	かわいがら
つぼめる	つぼめ
ふりわける	ふりわけ
つきやぶれる	つきやぶれ
かけつける	かけつけ
あきれる	あきれ
取りあげる	取りあげ
いのる	いのら
うまれあわす	うまれあわさ
折かさなる	折かさなら
のっかる	のっから
食い止める	食い止め
なでおろす	なでおろさ
ほりかえす	ほりかえさ
うりあげる	うりあげ
ひきあげる	ひきあげ
わける	わけ
着こなす	着こなさ
取り運べる	取り運べ
湯引く	湯引か
たまりかねる	たまりかね
たちはたらく	たちはたらか
見立てる	見立て
てづまる	てづまら
生まれ合わす	生まれ合わさ
押しかぶさる	押しかぶさら
犯す	犯さ
いいあやまる	いいあやまら
くらいする	くらいし
振出す	振出さ
出そろう	出そろわ
すくみ上がる	すくみ上がら
高じる	高じ
惟みる	惟み
績む	績ま
渡りあう	渡りあわ
くどける	くどけ
ひきつぐ	ひきつが
芽差す	芽差さ
からます	からまさ
祓う	祓わ
付き合える	付き合え
仰る	仰ら
省く	省か
追い求める	追い求め
せめよせる	せめよせ
放れる	放れ
うちこわす	うちこわさ
生れ落ちる	生れ落ち
慎む	慎ま
打ちくだく	打ちくだか
なげかつ	なげかた
沸き起る	沸き起ら
腐らす	腐らさ
枕する	枕し
せっつく	せっつか
伺える	伺え
挺する	挺し
絶てる	絶て
つかまつる	つかまつら
くみつく	くみつか
せおいこめる	せおいこめ
あけはなれる	あけはなれ
取結ぶ	取結ば
ちぢこまる	ちぢこまら
みぬける	みぬけ
濡れる	濡れ
泣ける	泣け
励ませる	励ませ
入れ替える	入れ替え
ほおける	ほおけ
嫁ぐ	嫁が
照らせる	照らせ
ひきさく	ひきさか
ふむ	ふま
発く	発か
駆け込む	駆け込ま
さがしだす	さがしださ
ねじ向ける	ねじ向け
えらびだせる	えらびだせ
借倒す	借倒さ
とびかける	とびかけら
悔改める	悔改め
準える	準え
さえ渡る	さえ渡ら
息せききる	息せききら
逃げ回る	逃げ回ら
いいなおせる	いいなおせ
呑み込める	呑み込め
有り合せる	有り合せ
さとれる	さとれ
たばねる	たばね
入組む	入組ま
打込む	打込ま
突止める	突止め
焼け落ちる	焼け落ち
取る	取ら
齎す	齎さ
敷き詰める	敷き詰め
よじ登る	よじ登ら
色褪せる	色褪せ
なのる	なのら
うちとける	うちとけ
古る	古ら
喩える	喩え
しゃがみこむ	しゃがみこま
吠える	吠え
明らめる	明らめ
にくむ	にくま
打ち切れる	打ち切れ
調える	調え
編める	編め
しりぬく	しりぬか
しょぼ濡れる	しょぼ濡れ
居竦まる	居竦まら
たがやす	たがやさ
へめぐる	へめぐら
写し出す	写し出さ
つめる	つめら
捜し当てる	捜し当て
ひきさる	ひきさら
爪弾く	爪弾か
あざむける	あざむけ
数え切れる	数え切れ
降り込む	降り込ま
はなやぐ	はなやが
抛つつ	抛つた
紛れ込める	紛れ込め
闘える	闘え
方向付ける	方向付け
略す	略さ
跪く	跪か
刻み付ける	刻み付け
言い渡せる	言い渡せ
潰す	潰さ
開け放す	開け放さ
捲し上げる	捲し上げ
はみ出す	はみ出さ
いきながらえる	いきながらえ
あきめく	あきめか
適える	適え
賭する	賭し
とおりすぎる	とおりすぎ
取り締まれる	取り締まれ
さぼる	さぼら
付する	付し
踏み越す	踏み越さ
乗越える	乗越え
勢いづく	勢いづか
入り乱れる	入り乱れ
組伏せる	組伏せ
うちきれる	うちきれ
ききだせる	ききだせ
破く	破か
さそう	さそわ
食する	食し
よろこびあえる	よろこびあえ
積重ねる	積重ね
捩る	捩ら
しわがれる	しわがれ
しょくする	しょくし
はきだせる	はきだせ
練り直す	練り直さ
下種張る	下種張ら
みはからえる	みはからえ
使い果す	使い果さ
捲る	捲ら
記せる	記せ
つれもどす	つれもどさ
おっしゃる	おっしゃら
振り払える	振り払え
かりこむ	かりこま
差うつむく	差うつむか
乾かす	乾かさ
恐れ入る	恐れ入ら
なきくらす	なきくらさ
ばくする	ばくし
詠じる	詠じ
抓る	抓ら
ちかづく	ちかづか
誤らす	誤らさ
たかなる	たかなら
横たえる	横たえ
はりまわす	はりまわさ
拝む	拝ま
ゆるがす	ゆるがさ
ひきずりまわせる	ひきずりまわせ
はらいもどす	はらいもどさ
ゆびく	ゆびか
斬る	斬ら
もつれあう	もつれあわ
せめおとす	せめおとさ
うちはたす	うちはたさ
どよむ	どよま
ついていける	ついていけ
交じる	交じら
脅える	脅え
うちけす	うちけさ
轢く	轢か
うけながせる	うけながせ
降やむ	降やま
うなる	うなら
さしつかえる	さしつかえ
見あたる	見あたら
取り扱う	取り扱わ
脱する	脱し
でむかえる	でむかえ
けばだつ	けばだた
生みだす	生みださ
踏抜く	踏抜か
飲む	飲ま
立ち込める	立ち込め
肯んずる	肯んぜ
割出す	割出さ
かきなおす	かきなおさ
組み上げる	組み上げ
けせる	けせ
弁ずる	弁ぜ
乗あわせる	乗あわせ
統べ括る	統べ括ら
泣き明かす	泣き明かさ
産み付ける	産み付け
釣り合う	釣り合わ
枝垂れる	枝垂れ
なかせる	なかせ
めしよせる	めしよせ
宣する	宣し
とびかかる	とびかから
奮い起す	奮い起さ
思い上がる	思い上がら
さずかる	さずから
いれなおす	いれなおさ
やぶく	やぶか
さがす	さがさ
つみかさねる	つみかさね
おもいなおす	おもいなおさ
慣す	慣さ
澄ます	澄まさ
占う	占わ
心得える	心得え
きばる	きばら
ぬいあわす	ぬいあわさ
飛び出す	飛び出さ
絵取る	絵取ら
打ち勝つ	打ち勝た
節榑立つ	節榑立た
私する	私し
取り違える	取り違え
おひゃらかす	おひゃらかさ
むちうつ	むちうた
落延びる	落延び
枯れる	枯れ
つまだてる	つまだて
おちょくる	おちょくら
取りこぼす	取りこぼさ
揺らす	揺らさ
払いこむ	払いこま
取り極める	取り極め
吹き上げる	吹き上げ
凋む	凋ま
清まる	清まら
近寄る	近寄ら
いとなむ	いとなま
かかわれる	かかわれ
たくしあげる	たくしあげ
たてつく	たてつか
怖気付く	怖気付か
繰り返す	繰り返さ
そよふく	そよふか
壊れる	壊れ
恐がる	恐がら
壊せる	壊せ
通り抜ける	通り抜け
ひきだせる	ひきだせ
泳ぐ	泳が
冴える	冴え
握りつぶす	握りつぶさ
手がける	手がけ
やきつける	やきつけ
顧みる	顧み
しあげる	しあげ
たたきつぶす	たたきつぶさ
敵す	敵さ
わかつ	わかた
つからす	つからさ
書き記す	書き記さ
吹きだす	吹きださ
混ぜっかえす	混ぜっかえさ
せりだす	せりださ
折り返せる	折り返せ
ゆるめる	ゆるめ
引き裂ける	引き裂け
えがく	えがか
振りかざす	振りかざさ
入り交じる	入り交じら
たいらぐ	たいらが
わきおこせる	わきおこせ
撫でつける	撫でつけ
嫌がる	嫌がら
打ち込める	打ち込め
こかす	こかさ
変ずる	変ぜ
托する	托し
もちかえる	もちかえら
跨げる	跨げ
点る	点ら
切り離す	切り離さ
かさなりあう	かさなりあわ
切れる	切れ
わかす	わかさ
打ちあう	打ちあわ
かもせる	かもせ
けんじる	けんじ
辷らす	辷らさ
還る	還ら
待ち設ける	待ち設け
住みつべる	住みつべ
こねかえす	こねかえさ
さしむける	さしむけ
弁える	弁え
かち合う	かち合わ
つくせる	つくせ
すりつける	すりつけ
取すがる	取すがら
貸し出す	貸し出さ
組みなおす	組みなおさ
はやす	はやさ
死に絶える	死に絶え
あがく	あがか
じれこむ	じれこま
ぬかずく	ぬかずか
切り忘れる	切り忘れ
乗りまわす	乗りまわさ
疲れる	疲れ
いいあらそえる	いいあらそえ
引き落とせる	引き落とせ
突合す	突合さ
弾ずる	弾ぜ
かればむ	かればま
抱えこむ	抱えこま
とりまわす	とりまわさ
便る	便ら
あけわたす	あけわたさ
しょいこむ	しょいこま
あぐねる	あぐね
投げこむ	投げこま
ふるいおとせる	ふるいおとせ
たべる	たべ
読み返せる	読み返せ
流れ歩く	流れ歩か
拗ねる	拗ね
こく	こか
生きかえる	生きかえら
書分ける	書分け
さししめせる	さししめせ
気づく	気づか
でき上がる	でき上がら
照りつける	照りつけ
なくなる	なくなら
ゆだねる	ゆだね
ずれこめる	ずれこめ
はせ参じる	はせ参じ
浮立つ	浮立た
眠りこける	眠りこけ
はいつくばう	はいつくばわ
封じ込める	封じ込め
ゆでる	ゆで
蒸ける	蒸け
探る	探ら
耐え抜く	耐え抜か
いぬ	いな
うめあわす	うめあわさ
つめよる	つめよら
はつる	はつら
来る	来
切り替える	切り替え
しょぼつく	しょぼつか
むずかる	むずから
差置く	差置か
奪い合える	奪い合え
くもらせる	くもらせ
見まがう	見まがわ
言い付かる	言い付から
いいもらす	いいもらさ
みまもる	みまもら
かかりあう	かかりあわ
のみこむ	のみこま
突きあたる	突きあたら
持つ	持た
とりまとめる	とりまとめ
もちこめる	もちこめ
供する	供し
ふるいわける	ふるいわけ
落す	落さ
ひろげる	ひろげ
載せる	載せ
動ずる	動ぜ
組みあう	組みあわ
こすれる	こすれ
縋る	縋ら
祓い清める	祓い清め
とけあえる	とけあえ
ほくそえむ	ほくそえま
向かいあう	向かいあわ
引張る	引張ら
繰り回す	繰り回さ
おどかす	おどかさ
いかける	いかけ
擦切る	擦切ら
窮まる	窮まら
消せる	消せ
打ち出せる	打ち出せ
退ける	退け
しつくす	しつくさ
架ける	架け
持ち帰れる	持ち帰れ
はかす	はかさ
聞き惚れる	聞き惚れ
あばれまくる	あばれまくら
かっ込む	かっ込ま
とりつく	とりつか
下回る	下回ら
いらだてる	いらだて
吊せる	吊せ
がんばる	がんばら
肯く	肯か
さやばしる	さやばしら
戦ぐ	戦が
いとう	いとわ
はりかえる	はりかえ
きりさげる	きりさげ
買わす	買わさ
服せる	服せ
寄る	寄ら
崩す	崩さ
ききおく	ききおか
釣合う	釣合わ
浮び上る	浮び上ら
澄渡る	澄渡ら
舞いこむ	舞いこま
言祝ぐ	言祝が
差越える	差越え
走り抜ける	走り抜け
蹴立てる	蹴立て
老ぼれる	老ぼれ
繰り返せる	繰り返せ
問い掛ける	問い掛け
奪い取れる	奪い取れ
わき返る	わき返ら
貰う	貰わ
繰る	繰ら
駆け寄る	駆け寄ら
抜き取る	抜き取ら
すりこむ	すりこま
しけこむ	しけこま
逝く	逝か
かけだす	かけださ
競り合う	競り合わ
ねっする	ねっし
突出す	突出さ
ふんばる	ふんばら
乾反る	乾反ら
回り込める	回り込め
うまる	うまら
しける	しけ
言い淀む	言い淀ま
はやしたてる	はやしたて
見計らう	見計らわ
奉じる	奉じ
末枯れる	末枯れ
はせ戻る	はせ戻ら
波だつ	波だた
聞ける	聞け
きりいる	きりいら
取集める	取集め
祭る	祭ら
悔いる	悔い
恥入る	恥入ら
はいだす	はいださ
誑し込む	誑し込ま
とれる	とれ
がいする	がいし
噎ぶ	噎ば
就く	就か
踏ん切れる	踏ん切れ
言い渡す	言い渡さ
抜ける	抜け
あきる	あき
成し遂げる	成し遂げ
呼びつける	呼びつけ
たす	たさ
もりかえす	もりかえさ
がえんずる	がえんぜ
こぐ	こが
おもいまどえる	おもいまどえ
掻き口説く	掻き口説か
鼓する	鼓し
窶れる	窶れ
被る	被ら
撥ねる	撥ね
操れる	操れ
興じる	興じ
掘り返す	掘り返さ
ひきずりまわす	ひきずりまわさ
色あせる	色あせ
去る	去ら
生える	生え
ほめちぎる	ほめちぎら
守り立てる	守り立て
かこつ	かこた
さしかためる	さしかため
慣わせる	慣わせ
落ち合う	落ち合わ
差し繰る	差し繰ら
はねかかる	はねかから
訓ずる	訓ぜ
並べる	並べ
蹴飛ばす	蹴飛ばさ
添わる	添わら
ふるいおこせる	ふるいおこせ
もれ聞く	もれ聞か
つり上がる	つり上がら
うなされる	うなされ
割る	割ら
すける	すけ
ついばめる	ついばめ
ほうり込む	ほうり込ま
掻き鳴す	掻き鳴さ
蒔き直せる	蒔き直せ
みなおせる	みなおせ
やけおちる	やけおち
治す	治さ
侍する	侍し
馴す	馴さ
立かかる	立かから
ゆずりうける	ゆずりうけ
召し具す	召し具さ
そびえ立つ	そびえ立た
立ち戻る	立ち戻ら
練歩く	練歩か
およぐ	およが
あざ笑う	あざ笑わ
かちとる	かちとら
寄りすがる	寄りすがら
かぎれる	かぎれ
まちかねる	まちかね
狼狽える	狼狽え
掘れる	掘れ
さしひく	さしひか
秘する	秘し
猛り立つ	猛り立た
とりはからう	とりはからわ
幽する	幽し
ろうする	ろうし
咲そろう	咲そろわ
きしめく	きしめか
げんずる	げんぜ
みすかす	みすかさ
うちはなす	うちはなさ
とっつかまる	とっつかまら
身罷る	身罷ら
煉り合せる	煉り合せ
触れ込む	触れ込ま
喰う	喰わ
ほめあげる	ほめあげ
連れ戻す	連れ戻さ
増やす	増やさ
仕上げる	仕上げ
昏れる	昏れ
老い込む	老い込ま
間に合う	間に合わ
さする	さすら
吹っとぶ	吹っとば
ひっかく	ひっかか
だきあう	だきあわ
居着く	居着か
牽く	牽か
伸ばす	伸ばさ
のりすすめる	のりすすめ
はいりこめる	はいりこめ
草臥れる	草臥れ
縁づく	縁づか
這える	這え
追い掛ける	追い掛け
ふきあげる	ふきあげ
つつみこめる	つつみこめ
食い込める	食い込め
打ち解ける	打ち解け
黙す	黙さ
言損なう	言損なわ
いいあわせる	いいあわせ
聳やかす	聳やかさ
うべなう	うべなわ
差押える	差押え
せり落す	せり落さ
いとめる	いとめ
手向かう	手向かわ
あてこむ	あてこま
細める	細め
きぐす	きぐさ
ぼやける	ぼやけ
企てる	企て
測れる	測れ
振る舞える	振る舞え
翔ける	翔け
分ける	分け
佩く	佩か
躍り込む	躍り込ま
まなびとれる	まなびとれ
服する	服し
打ち直せる	打ち直せ
いけどれる	いけどれ
冒せる	冒せ
かけよれる	かけよれ
開け放せる	開け放せ
冴え返る	冴え返ら
かつぎ上げる	かつぎ上げ
打って出る	打って出
きりくずせる	きりくずせ
ふくす	ふくさ
ツクる	ツクら
見回せる	見回せ
すすみだす	すすみださ
のたくる	のたくら
遊べる	遊べ
興がる	興がら
ねばりぬける	ねばりぬけ
押し通す	押し通さ
付け込む	付け込ま
詠える	詠え
呼び立てる	呼び立て
負ける	負け
たちすくむ	たちすくま
担ぎ出す	担ぎ出さ
出向く	出向か
いわす	いわさ
くみなおす	くみなおさ
聳える	聳え
ひける	ひけ
ゆさぶる	ゆさぶら
さしのぼる	さしのぼら
劃する	劃し
殺げる	殺げ
染め出す	染め出さ
勇気づける	勇気づけ
覗く	覗か
ほうり出す	ほうり出さ
折りかさなる	折りかさなら
潜める	潜め
見透せる	見透せ
さし迫る	さし迫ら
炊き込む	炊き込ま
ほりだす	ほりださ
せめこむ	せめこま
うみだす	うみださ
まきなおせる	まきなおせ
割りほぐす	割りほぐさ
あばける	あばけ
言いそびれる	言いそびれ
かみさびる	かみさび
積もる	積もら
放せる	放せ
追いつめる	追いつめ
迎え入れる	迎え入れ
折りかさねる	折りかさね
引き継げる	引き継げ
作り成す	作り成さ
みぬく	みぬか
持ち合わす	持ち合わさ
言いつかる	言いつから
選りわける	選りわけ
うちくつろぐ	うちくつろが
儚む	儚ま
語り合える	語り合え
飛び上がれる	飛び上がれ
かき集める	かき集め
うちほろぼす	うちほろぼさ
ふうずる	ふうぜ
酔っぱらう	酔っぱらわ
ふりくらす	ふりくらさ
引っくくる	引っくくら
ずれ込める	ずれ込め
ゆずりあう	ゆずりあわ
もちあわす	もちあわさ
おもいおこす	おもいおこさ
挟める	挟め
さきばしる	さきばしら
褒める	褒め
買える	買え
うりつける	うりつけ
噛み合わす	噛み合わさ
すだつ	すだた
そんじる	そんじ
めかしこむ	めかしこま
たすけだす	たすけださ
走り抜く	走り抜か
てれる	てれ
関する	関し
巣立つ	巣立た
らっする	らっし
つくり出す	つくり出さ
救う	救わ
溜めこむ	溜めこま
振放す	振放さ
叱る	叱ら
しげる	しげら
帰せる	帰せ
屠る	屠ら
言いまくる	言いまくら
頼る	頼ら
乗り切る	乗り切ら
にかよう	にかよわ
さがせる	さがせ
書き損じる	書き損じ
囁やく	囁やか
立て篭る	立て篭ら
ふみならす	ふみならさ
願い下げる	願い下げ
吹きでる	吹きで
反りくり返る	反りくり返ら
こらす	こらさ
払わす	払わさ
生きぬく	生きぬか
いすわる	いすわら
猛る	猛ら
差し出せる	差し出せ
眠りこむ	眠りこま
兼ねる	兼ね
明かす	明かさ
有難がる	有難がら
折り重ねる	折り重ね
落ち着き払う	落ち着き払わ
補する	補し
じゅんじょづける	じゅんじょづけ
そこねる	そこね
育める	育め
摘める	摘め
まちがふ	まちがは
思いなおす	思いなおさ
噛み合う	噛み合わ
つきあえる	つきあえ
取合せる	取合せ
射つ	射た
しめころす	しめころさ
覗ける	覗け
踏破る	踏破ら
寄こす	寄こさ
きえはてる	きえはて
ききもらす	ききもらさ
まちつける	まちつけ
近づく	近づか
まがる	まがら
たちはだかる	たちはだから
繰合せる	繰合せ
借り上げる	借り上げ
たたき上げる	たたき上げ
売付ける	売付け
やり直す	やり直さ
考え込む	考え込ま
卷ける	卷け
読み直す	読み直さ
聾する	聾し
握りつぶせる	握りつぶせ
よびだす	よびださ
はめ込める	はめ込め
手渡す	手渡さ
めあわす	めあわさ
押しのける	押しのけ
みあわす	みあわさ
どうじる	どうじ
取り入る	取り入ら
読み替える	読み替え
うみおとせる	うみおとせ
問う	問わ
押し込める	押し込め
とちる	とちら
なつめく	なつめか
しのびこめる	しのびこめ
彫れる	彫れ
にぎれる	にぎれ
飛び散る	飛び散ら
払込む	払込ま
くみ上げる	くみ上げ
ふりかかる	ふりかから
降り篭める	降り篭め
こうる	こうら
ねむらす	ねむらさ
呼びかける	呼びかけ
くみこむ	くみこま
買い控える	買い控え
したたる	したたら
おびえる	おびえ
いいつくす	いいつくさ
吸い込める	吸い込め
差招く	差招か
ふみとどまる	ふみとどまら
焼き払う	焼き払わ
見逃せる	見逃せ
集まる	集まら
撥ね付ける	撥ね付け
掠める	掠め
切り廻す	切り廻さ
引き入れる	引き入れ
禿びる	禿び
まかせる	まかせ
切捨てる	切捨て
いれかわれる	いれかわれ
まぜかえせる	まぜかえせ
うきたつ	うきたた
なきはらす	なきはらさ
ためこむ	ためこま
すぎる	すぎ
うちつづく	うちつづか
払い除ける	払い除け
かきなぐる	かきなぐら
さかせる	さかせ
掘り起こせる	掘り起こせ
ねちがえる	ねちがえ
寄せかける	寄せかけ
ひらく	ひらか
付け狙う	付け狙わ
くだされる	くだされ
観する	観し
錬る	錬ら
ねばつく	ねばつか
とぶ	とば
引っつかむ	引っつかま
かき鳴す	かき鳴さ
ころばす	ころばさ
いきたつ	いきたた
差しだす	差しださ
世帯染みる	世帯染み
積立てる	積立て
ふせげる	ふせげ
詠み込む	詠み込ま
捕まえる	捕まえ
打ち倒せる	打ち倒せ
あい変わる	あい変わら
なめずる	なめずら
連れこむ	連れこま
聞きわける	聞きわけ
思い及ぶ	思い及ば
すり減らす	すり減らさ
揺れ動く	揺れ動か
崩れる	崩れ
凝る	凝ら
警める	警め
にしめる	にしめ
受け継げる	受け継げ
聞きとどける	聞きとどけ
思い直せる	思い直せ
触れあう	触れあわ
けむにまく	けむにまか
飛び立つ	飛び立た
解け合える	解け合え
できあがる	できあがら
しなる	しなら
そびれる	そびれ
おいたてる	おいたて
踏みとどまる	踏みとどまら
凹む	凹ま
たちならぶ	たちならば
ねんずる	ねんぜ
喜べる	喜べ
停る	停ら
しいたげる	しいたげ
しかくばる	しかくばら
およろこびもうしあげる	およろこびもうしあげ
きりはなす	きりはなさ
たきこむ	たきこま
にげかえる	にげかえら
踏みしだく	踏みしだか
乗っ取れる	乗っ取れ
盛り上げる	盛り上げ
そわつく	そわつか
とけあう	とけあわ
じだいがかる	じだいがから
決まる	決まら
割り振れる	割り振れ
みわける	みわけ
議す	議さ
取交す	取交さ
滅入る	滅入ら
ふきかける	ふきかけ
埋め合わす	埋め合わさ
見定める	見定め
かけずる	かけずら
恙む	恙ま
燻ぼる	燻ぼら
通り掛る	通り掛ら
消し止める	消し止め
しゃくる	しゃくら
飛び立てる	飛び立て
掃き出す	掃き出さ
かしだせる	かしだせ
みくびる	みくびら
願出る	願出
来はじめる	来はじめ
つなぎ止める	つなぎ止め
決め込む	決め込ま
さっする	さっし
しわむ	しわま
つり上げる	つり上げ
揚がる	揚がら
徴する	徴し
ちまう	ちまわ
もの申す	もの申さ
ねころがる	ねころがら
おぼめかす	おぼめかさ
はがれる	はがれ
やどる	やどら
割りきれる	割りきれ
読める	読め
とりしずめる	とりしずめ
濁す	濁さ
謝る	謝ら
燻す	燻さ
因われる	因われ
配す	配さ
おとずれる	おとずれ
こそげる	こそげ
変わり果てる	変わり果て
言い丸める	言い丸め
切り込む	切り込ま
まじえる	まじえ
きょうがる	きょうがら
つねる	つねら
拝する	拝し
縫い合わせる	縫い合わせ
探し出す	探し出さ
当てはまる	当てはまら
縫上げる	縫上げ
うちぬく	うちぬか
まき散らす	まき散らさ
引き攣る	引き攣ら
ふるい分ける	ふるい分け
祈る	祈ら
群れる	群れ
帰れる	帰れ
叩く	叩か
突っ張れる	突っ張れ
結び付ける	結び付け
唱う	唱わ
はげませる	はげませ
盛返す	盛返さ
ふうじこめる	ふうじこめ
かしこす	かしこさ
にぎわせる	にぎわせ
買い求める	買い求め
つのだつ	つのだた
もくする	もくし
さくする	さくし
祭れる	祭れ
身構える	身構え
そらとぼける	そらとぼけ
巻き返す	巻き返さ
譲れる	譲れ
飛び起きる	飛び起き
乗り外す	乗り外さ
向かい合える	向かい合え
とめる	とめ
ひらきなおる	ひらきなおら
絶入る	絶入ら
聞き及ぶ	聞き及ば
腹立つ	腹立た
賊する	賊し
すがり付く	すがり付か
渇かす	渇かさ
減せる	減せ
気色ばむ	気色ばま
振り放す	振り放さ
はだかる	はだから
みわたせる	みわたせ
へぐ	へが
問いあわせる	問いあわせ
すりよる	すりよら
ききただせる	ききただせ
のりきる	のりきら
伝う	伝わ
ねる	ね
限れる	限れ
いきづまる	いきづまら
こせつく	こせつか
泣きわめく	泣きわめか
学べる	学べ
取り寄せる	取り寄せ
緩まる	緩まら
粘る	粘ら
手控える	手控え
まじなう	まじなわ
張り回す	張り回さ
和解し合える	和解し合え
突っ込む	突っ込ま
行合う	行合わ
おおえる	おおえ
よびさます	よびさまさ
許せる	許せ
治まる	治まら
括る	括ら
はじきかえせる	はじきかえせ
困り抜く	困り抜か
継げる	継げ
しめくくる	しめくくら
戦う	戦わ
かえりざける	かえりざけ
ひっぱがす	ひっぱがさ
ひらきなおれる	ひらきなおれ
飛違う	飛違わ
いたみいる	いたみいら
きずける	きずけ
解き放つ	解き放た
凍てつく	凍てつか
つきつめる	つきつめ
いれあげる	いれあげ
すりへらす	すりへらさ
おこる	おこら
すり潰す	すり潰さ
責め苛む	責め苛ま
ひきはらう	ひきはらわ
荒だつ	荒だた
言い習わす	言い習わさ
おう	おわ
くりこむ	くりこま
あいいれる	あいいれ
ふくらむ	ふくらま
入る	入ら
ゆだる	ゆだら
つまぐる	つまぐら
臭わせる	臭わせ
寝入る	寝入ら
召し抱える	召し抱え
茂る	茂ら
いじくる	いじくら
見張れる	見張れ
ねじこめる	ねじこめ
聞き返す	聞き返さ
咲きほこる	咲きほこら
買う	買わ
いいのがれる	いいのがれ
磨ける	磨け
のこす	のこさ
滅ぼせる	滅ぼせ
騙す	騙さ
こみあう	こみあわ
逸す	逸さ
滑り込む	滑り込ま
答える	答え
ひきしまる	ひきしまら
座り込む	座り込ま
ひきたつ	ひきたた
低める	低め
つまみ出す	つまみ出さ
盛り付ける	盛り付け
くい止める	くい止め
はらう	はらわ
なりすます	なりすまさ
おきかわる	おきかわら
埋める	埋め
怖じる	怖じ
きそくだつ	きそくだた
溜める	溜め
締めくくる	締めくくら
居溢れる	居溢れ
なう	なわ
もたす	もたさ
消え果てる	消え果て
行きあう	行きあわ
おしいる	おしいら
打合せる	打合せ
滑り落ちる	滑り落ち
年取る	年取ら
めぶく	めぶか
うちなおせる	うちなおせ
おどろきいる	おどろきいら
いがむ	いがま
物申す	物申さ
はらばう	はらばわ
売りきれる	売りきれ
平める	平め
射す	射さ
抱き合わせる	抱き合わせ
すべりだせる	すべりだせ
ことたりる	ことたり
てきす	てきさ
たたずむ	たたずま
せりおとす	せりおとさ
追いつく	追いつか
飲み干す	飲み干さ
こける	こけ
しとめる	しとめ
やけつく	やけつか
呑み潰す	呑み潰さ
たれ込む	たれ込ま
たちまよう	たちまよわ
もえたつ	もえたた
行過ぎる	行過ぎ
滑り降りる	滑り降り
明く	明か
禁じる	禁じ
出来す	出来さ
上擦る	上擦ら
跳ねかす	跳ねかさ
責め落とせる	責め落とせ
洗い上げる	洗い上げ
つつみかくす	つつみかくさ
生き返れる	生き返れ
押し倒せる	押し倒せ
追い返せる	追い返せ
追出す	追出さ
うち群れる	うち群れ
組付ける	組付け
消し飛ぶ	消し飛ば
こばめる	こばめ
遊ばす	遊ばさ
間違える	間違え
粘着く	粘着か
思いわずらう	思いわずらわ
おしせまる	おしせまら
逸らせる	逸らせ
揺らめく	揺らめか
使いこむ	使いこま
免れる	免れ
やせる	やせ
はやらせる	はやらせ
ざす	ざさ
もうしきける	もうしきけ
一旗揚げる	一旗揚げ
ちょうずる	ちょうぜ
逃延びる	逃延び
おい付く	おい付か
選り抜く	選り抜か
酌む	酌ま
終わる	終わら
にげだせる	にげだせ
うらなえる	うらなえ
住まわせる	住まわせ
はじく	はじか
吊りあげる	吊りあげ
申し合わせる	申し合わせ
ます	まさ
睨みあう	睨みあわ
てんじる	てんじ
噛み締める	噛み締め
切りかえる	切りかえ
取りこめる	取りこめ
はりめぐらす	はりめぐらさ
酔つぶれる	酔つぶれ
つけかえる	つけかえ
騙し込む	騙し込ま
降り立つ	降り立た
攻め寄る	攻め寄ら
和める	和め
にぎる	にぎら
とどめる	とどめ
はらいさげる	はらいさげ
組みあわす	組みあわさ
拗らす	拗らさ
読流す	読流さ
おしまくる	おしまくら
積み分ける	積み分け
薙ぎ伏せる	薙ぎ伏せ
たやせる	たやせ
けずりたおせる	けずりたおせ
分け合う	分け合わ
むせ返る	むせ返ら
たどりつく	たどりつか
従う	従わ
釣出す	釣出さ
焼き上げる	焼き上げ
巻き起こせる	巻き起こせ
固まり合う	固まり合わ
ゆびさす	ゆびささ
駆り立てる	駆り立て
列ぶ	列ば
奮う	奮わ
付加える	付加え
照り付ける	照り付け
争える	争え
追い払える	追い払え
ならびたつ	ならびたた
うちかつ	うちかた
いいはる	いいはら
のがせる	のがせ
打切る	打切ら
あじる	あじら
染込む	染込ま
閉める	閉め
あおぐ	あおが
離す	離さ
あやまる	あやまら
えみわれる	えみわれ
つけ加わる	つけ加わら
言い暮す	言い暮さ
目掛ける	目掛け
染め上がる	染め上がら
食込む	食込ま
繰り込む	繰り込ま
つく	つか
負わす	負わさ
望む	望ま
慣れ親しむ	慣れ親しま
組上げる	組上げ
障む	障ま
きざめる	きざめ
ゆわえる	ゆわえ
漏る	漏ら
うつ伏せる	うつ伏せ
約する	約し
ひるがえせる	ひるがえせ
割り出す	割り出さ
代える	代え
こごえる	こごえ
持ち上がる	持ち上がら
節する	節し
抱きこむ	抱きこま
回る	回ら
かきおとす	かきおとさ
息詰る	息詰ら
まてる	まて
むつむ	むつま
洗い出す	洗い出さ
滑る	滑ら
ゆるせる	ゆるせ
倒れる	倒れ
ふりこめる	ふりこめ
別れる	別れ
てこずる	てこずら
あいかわる	あいかわら
打破る	打破ら
申しあわせる	申しあわせ
のりこむ	のりこま
なりだす	なりださ
生きのびる	生きのび
おいだす	おいださ
うすらぐ	うすらが
組入れる	組入れ
すまわす	すまわさ
ゆいあげる	ゆいあげ
飲み潰れる	飲み潰れ
よりたおす	よりたおさ
付込む	付込ま
こと足る	こと足ら
埋かる	埋から
つかいはたす	つかいはたさ
熟れる	熟れ
乗出す	乗出さ
濯げる	濯げ
ほうむれる	ほうむれ
孵る	孵ら
なで下ろす	なで下ろさ
附す	附さ
廻れる	廻れ
読み上げる	読み上げ
追ひ廻す	追ひ廻さ
射通す	射通さ
濾す	濾さ
行渡る	行渡ら
聞き届ける	聞き届け
えがきだす	えがきださ
込む	込ま
えり抜く	えり抜か
打直す	打直さ
困る	困ら
花開く	花開か
諾する	諾し
かねそなえる	かねそなえ
ねらわれる	ねらわれ
手が込む	手が込ま
ぬぐえる	ぬぐえ
乗りだす	乗りださ
ききそこなう	ききそこなわ
すりかえる	すりかえ
きりあげる	きりあげ
怖じ気付く	怖じ気付か
照らし合せる	照らし合せ
割れる	割れ
てらしあわせる	てらしあわせ
もやせる	もやせ
えばる	えばら
おじる	おじ
煩いつく	煩いつか
慣らす	慣らさ
あせる	あせら
うらぎれる	うらぎれ
切立つ	切立た
わずらわせる	わずらわせ
吹っきれる	吹っきれ
つくりだす	つくりださ
応じる	応じ
けずりとれる	けずりとれ
たのむ	たのま
そめあげる	そめあげ
はたらく	はたらか
説きつける	説きつけ
おしこめる	おしこめ
張りめぐらせる	張りめぐらせ
みえすく	みえすか
飛出す	飛出さ
ていさいぶる	ていさいぶら
ふれまわる	ふれまわら
護る	護ら
いっす	いっさ
離せる	離せ
掘りおこす	掘りおこさ
思い合わせる	思い合わせ
描き出す	描き出さ
集まれる	集まれ
たたみこめる	たたみこめ
まくしあげる	まくしあげ
ほぐれる	ほぐれ
打ち破る	打ち破ら
いいよれる	いいよれ
繰返す	繰返さ
にぎわす	にぎわさ
読み返す	読み返さ
はたらかせる	はたらかせ
低まる	低まら
降敷く	降敷か
取り合わせる	取り合わせ
選び取れる	選び取れ
賎しめる	賎しめ
ぶちまける	ぶちまけ
おもいきる	おもいきら
わきおこる	わきおこら
引返す	引返さ
そうろう	そうろわ
編みだす	編みださ
語る	語ら
追掛ける	追掛け
しぼめる	しぼめ
みすかせる	みすかせ
むせび泣く	むせび泣か
うちあける	うちあけ
まいらせる	まいらせ
詰寄る	詰寄ら
やりあう	やりあわ
やわらぐ	やわらが
打ちあげる	打ちあげ
ふるまえる	ふるまえ
ろうたける	ろうたけ
滑り出せる	滑り出せ
染上げる	染上げ
寄れる	寄れ
洗う	洗わ
聞きもらす	聞きもらさ
蝕する	蝕し
およぎつける	およぎつけ
澄む	澄ま
つれかえる	つれかえら
乗換える	乗換え
当てこむ	当てこま
飲下す	飲下さ
降り懸かる	降り懸から
訪う	訪わ
剥せる	剥せ
ちぢめる	ちぢめ
酔っぱらえる	酔っぱらえ
辿る	辿ら
闘う	闘わ
震わせる	震わせ
つまだつ	つまだた
綴る	綴ら
見開く	見開か
踊る	踊ら
話し掛ける	話し掛け
取り下げる	取り下げ
履ける	履け
果たす	果たさ
こばむ	こばま
摩る	摩ら
閃く	閃か
進める	進め
うずもれる	うずもれ
とりわける	とりわけ
吹き替える	吹き替え
立たす	立たさ
強まる	強まら
かたぶける	かたぶけ
つける	つけ
取り換える	取り換え
重ね合わす	重ね合わさ
取捨てる	取捨て
書きとめる	書きとめ
謡える	謡え
つなげる	つなげ
跳ね返す	跳ね返さ
ききすごす	ききすごさ
走れる	走れ
ある	あら
付け替える	付け替え
吹っかける	吹っかけ
ハネ出す	ハネ出さ
点す	点さ
引っかける	引っかけ
若く	若か
挽く	挽か
話しかける	話しかけ
切り込める	切り込め
抱き留める	抱き留め
助かる	助から
飛びかかる	飛びかから
立ち行く	立ち行か
刈り取れる	刈り取れ
結く	結か
恋い慕う	恋い慕わ
はがす	はがさ
惚気ける	惚気け
勝越す	勝越さ
銘じる	銘じ
たらしこむ	たらしこま
取り篭める	取り篭め
打ち殺す	打ち殺さ
言う	言わ
さげすむ	さげすま
割く	割か
出す	出さ
すがる	すがら
ぬく	ぬか
申し込む	申し込ま
発する	発し
みする	みし
押さえ付ける	押さえ付け
打ち合わせる	打ち合わせ
負け越す	負け越さ
げきする	げきし
主立つ	主立た
しはらう	しはらわ
うちなおす	うちなおさ
うちかえせる	うちかえせ
だきとめる	だきとめ
横切れる	横切れ
言いよどむ	言いよどま
きりくずす	きりくずさ
へる	へら
へらす	へらさ
手向ける	手向け
ひっつかむ	ひっつかま
見舞う	見舞わ
はめる	はめ
飛立つ	飛立た
撃ち破る	撃ち破ら
にじりよる	にじりよら
つけくわえる	つけくわえ
落ちこぼれる	落ちこぼれ
あくたれる	あくたれ
こんぐらかる	こんぐらから
経巡る	経巡ら
窄める	窄め
食いしばる	食いしばら
よいつぶれる	よいつぶれ
みあたる	みあたら
ちぢかむ	ちぢかま
皺める	皺め
聞き込める	聞き込め
いがみ合う	いがみ合わ
勝てる	勝て
あけはらう	あけはらわ
唸る	唸ら
盛り合わす	盛り合わさ
まねぶ	まねば
絞める	絞め
むきあう	むきあわ
よそえる	よそえ
うすまる	うすまら
立遅れる	立遅れ
なざす	なざさ
どける	どけ
上り詰める	上り詰め
たたきあげる	たたきあげ
うけだす	うけださ
炙る	炙ら
つぐなえる	つぐなえ
引き上げる	引き上げ
むかえる	むかえ
堪え忍べる	堪え忍べ
ひからびる	ひからび
はれる	はれ
据え付ける	据え付け
つきでる	つきで
はしりこむ	はしりこま
縮まる	縮まら
談じ込める	談じ込め
付す	付さ
さきそろう	さきそろわ
突っかえす	突っかえさ
もちはこぶ	もちはこば
スる	スら
言寄る	言寄ら
蔑する	蔑し
あゆみはじめる	あゆみはじめ
つかさどる	つかさどら
諳んずる	諳んぜ
吹っ掛ける	吹っ掛け
たてなおす	たてなおさ
冷かす	冷かさ
おもいとどまれる	おもいとどまれ
切りはずす	切りはずさ
にふくめる	にふくめ
引きずり出せる	引きずり出せ
織成す	織成さ
梳る	梳ら
うちかえす	うちかえさ
めなれる	めなれ
突き出せる	突き出せ
ふりむく	ふりむか
掘り進む	掘り進ま
買い占める	買い占め
いぶく	いぶか
もぎる	もぎら
充てがう	充てがわ
いやす	いやさ
跨ぐ	跨が
纏める	纏め
うかがう	うかがわ
差し止める	差し止め
型どれる	型どれ
おとしいれる	おとしいれ
ベタつく	ベタつか
よべる	よべ
掴み合う	掴み合わ
ずりおちる	ずりおち
貯め込む	貯め込ま
のみまわす	のみまわさ
喘ぐ	喘が
裏返す	裏返さ
引きしめる	引きしめ
ほじる	ほじら
おおう	おおわ
見て取れる	見て取れ
相続く	相続か
ねりあわせる	ねりあわせ
取り掛かる	取り掛から
過ぎる	過ぎ
阿る	阿ら
降こめる	降こめ
にじみ出る	にじみ出
准ずる	准ぜ
巻き上げる	巻き上げ
継ぎ足す	継ぎ足さ
生まれ変われる	生まれ変われ
おこなえる	おこなえ
取り交わせる	取り交わせ
たもてる	たもて
繋る	繋ら
かみしめる	かみしめ
ずれこむ	ずれこま
たつ	たた
嘯く	嘯か
壊す	壊さ
よみくらべる	よみくらべ
救える	救え
はせさんじる	はせさんじ
脹らます	脹らまさ
咳く	咳か
泳がせる	泳がせ
のりはずす	のりはずさ
泣きつく	泣きつか
かえれる	かえれ
言い回す	言い回さ
蕩ける	蕩け
乗り出せる	乗り出せ
調う	調わ
こなす	こなさ
ふみだせる	ふみだせ
霞む	霞ま
換わる	換わら
没す	没さ
浴びる	浴び
食らわす	食らわさ
臨める	臨め
くりひろげる	くりひろげ
かんばしる	かんばしら
施す	施さ
あらいだす	あらいださ
りかいしあえる	りかいしあえ
およる	およら
かざす	かざさ
おさまる	おさまら
削り取る	削り取ら
屈する	屈し
併せる	併せ
しのぐ	しのが
ねづく	ねづか
く	か
入れ替わる	入れ替わら
見すかす	見すかさ
言い做す	言い做さ
ちりばめる	ちりばめ
問いただせる	問いただせ
降りしきる	降りしきら
打ち上げる	打ち上げ
おりかえせる	おりかえせ
頌する	頌し
読ふける	読ふけら
迎え撃つ	迎え撃た
まがう	まがわ
付き纏う	付き纏わ
縮める	縮め
ころせる	ころせ
おもいまどう	おもいまどわ
浚える	浚え
狂れる	狂れ
婀娜めく	婀娜めか
突っ掛る	突っ掛ら
もとむ	もとま
真面目くさる	真面目くさら
売りつける	売りつけ
はかる	はから
したおす	したおさ
におう	におわ
たらす	たらさ
推し量れる	推し量れ
おしやる	おしやら
もうしいれる	もうしいれ
暴れ出す	暴れ出さ
憤る	憤ら
責付ける	責付け
飲ます	飲まさ
按ずる	按ぜ
持ち上げる	持ち上げ
ひきさける	ひきさけ
しばる	しばら
駆け寄れる	駆け寄れ
端折れる	端折れ
佇む	佇ま
怯む	怯ま
ほごす	ほごさ
つくろえる	つくろえ
打ち沈む	打ち沈ま
構える	構え
撲りとばす	撲りとばさ
座り込める	座り込め
きよまる	きよまら
たちさる	たちさら
取合う	取合わ
かき込む	かき込ま
備える	備え
ふとれる	ふとれ
じゃう	じゃわ
折れる	折れ
いきかう	いきかわ
解きあかす	解きあかさ
付き随う	付き随わ
おもだつ	おもだた
人なれる	人なれ
めぐりあえる	めぐりあえ
せき上げる	せき上げ
合える	合え
のみ込む	のみ込ま
量る	量ら
切り出す	切り出さ
しつらえる	しつらえ
おっこちる	おっこち
まきつける	まきつけ
つよめる	つよめ
ことかく	ことかか
もぐ	もが
握りしめる	握りしめ
固める	固め
食い込む	食い込ま
いたわりあう	いたわりあわ
触合う	触合わ
差出す	差出さ
そしる	そしら
おしあげる	おしあげ
よろう	よろわ
抜あがる	抜あがら
さしうつむく	さしうつむか
漂う	漂わ
のりこなせる	のりこなせ
宥める	宥め
打あぐむ	打あぐま
おこす	おこさ
取り鎮める	取り鎮め
傷める	傷め
ひきおろせる	ひきおろせ
ふん縛る	ふん縛ら
ひきおとす	ひきおとさ
おそなわる	おそなわら
受け出せる	受け出せ
聴ける	聴け
うきたてる	うきたて
おちいる	おちいら
のりあげる	のりあげ
突きのめす	突きのめさ
馴染める	馴染め
もうしのべる	もうしのべ
煮やす	煮やさ
歩みよる	歩みよら
沸おこる	沸おこら
はからう	はからわ
集う	集わ
いろづく	いろづか
組み合わす	組み合わさ
かいつける	かいつけ
勝抜く	勝抜か
揉む	揉ま
しきつめる	しきつめ
外らせる	外らせ
怠ける	怠け
なげうつ	なげうた
追い出せる	追い出せ
かいあがる	かいあがら
会える	会え
申し合わす	申し合わさ
すまわせる	すまわせ
澄み切る	澄み切ら
きわまる	きわまら
よろこべる	よろこべ
もらす	もらさ
上向く	上向か
思いがける	思いがけ
のびなやむ	のびなやま
てりかがやく	てりかがやか
挟み切る	挟み切ら
ぼっする	ぼっし
擦り切れる	擦り切れ
黴びる	黴び
もちあわせる	もちあわせ
ふるぼける	ふるぼけ
蠕く	蠕か
打ちこむ	打ちこま
おもいだす	おもいださ
つっぱれる	つっぱれ
きりたおす	きりたおさ
やわらげる	やわらげ
差し戻す	差し戻さ
届けでる	届けで
群がる	群がら
振り込む	振り込ま
わかれる	わかれ
しのびよる	しのびよら
惑わす	惑わさ
居合わせる	居合わせ
つまさきだつ	つまさきだた
せしめる	せしめ
宿れる	宿れ
成れる	成れ
盈ちる	盈ち
通ずる	通ぜ
かいとれる	かいとれ
はるめく	はるめか
切り取れる	切り取れ
聞きただす	聞きたださ
遡れる	遡れ
耽る	耽ら
ちなむ	ちなま
さずける	さずけ
とう	とわ
とびだす	とびださ
跳ね出す	跳ね出さ
盛上がる	盛上がら
学び取る	学び取ら
こじつける	こじつけ
くわえもつ	くわえもた
あいなかばする	あいなかばし
よりあつまる	よりあつまら
雪ぐ	雪が
見合わせる	見合わせ
たのしめる	たのしめ
およぼせる	およぼせ
けとばす	けとばさ
ぬきつらねる	ぬきつらね
くみとる	くみとら
かんけいづける	かんけいづけ
噴き出す	噴き出さ
ひきちぎる	ひきちぎら
買いしめる	買いしめ
さす	ささ
赤らめる	赤らめ
打ち抜く	打ち抜か
付あがる	付あがら
ねじくれる	ねじくれ
ふきとばせる	ふきとばせ
だす	ださ
かきいれる	かきいれ
みつけだせる	みつけだせ
当はまる	当はまら
くぼまる	くぼまら
ぬぎすてる	ぬぎすて
取りくむ	取りくま
言立てる	言立て
掬する	掬し
焼かす	焼かさ
おいぬく	おいぬか
ひきあえる	ひきあえ
呑明かす	呑明かさ
洗い流せる	洗い流せ
甲走る	甲走ら
差支える	差支え
割る	割
生じる	生じ
呼込む	呼込ま
止まれる	止まれ
紛らわせる	紛らわせ
切換える	切換え
しみったれる	しみったれ
ふすぶる	ふすぶら
立て込む	立て込ま
居残れる	居残れ
掻き鳴らす	掻き鳴らさ
のろう	のろわ
まじろぐ	まじろが
じらせる	じらせ
痛みいる	痛みいら
乾し殺す	乾し殺さ
勝つ	勝た
飽きる	飽き
契る	契ら
磨き込む	磨き込ま
設ける	設け
秘す	秘さ
言い捨てる	言い捨て
差し出でる	差し出で
仕入れる	仕入れ
取っ組む	取っ組ま
従く	従か
数え立てる	数え立て
ひっ提げる	ひっ提げ
おくりとどける	おくりとどけ
遅らせる	遅らせ
だます	だまさ
比べる	比べ
僻む	僻ま
引きずり出す	引きずり出さ
罷り間違う	罷り間違わ
たおれる	たおれ
つけあがる	つけあがら
滴る	滴ら
見向く	見向か
絞め殺す	絞め殺さ
懲りる	懲り
知恵づく	知恵づか
遣り合う	遣り合わ
搾り取れる	搾り取れ
量りこむ	量りこま
煮えたぎる	煮えたぎら
言いふらす	言いふらさ
見顕す	見顕さ
名付ける	名付け
ちらばる	ちらばら
承ける	承け
かいならす	かいならさ
楽しむ	楽しま
切れ上がる	切れ上がら
勘づく	勘づか
見なせる	見なせ
判ずる	判ぜ
書送る	書送ら
のぼせ上がる	のぼせ上がら
もみ消せる	もみ消せ
おかけいたす	おかけいたさ
引き込める	引き込め
あやつれる	あやつれ
這いつくばう	這いつくばわ
ぶちこむ	ぶちこま
案じる	案じ
語り継ぐ	語り継が
落着ける	落着け
くぐりぬける	くぐりぬけ
造り上げる	造り上げ
引き分ける	引き分け
精げる	精げ
朽ちる	朽ち
つまみあげる	つまみあげ
しばりあげる	しばりあげ
問返す	問返さ
おしきれる	おしきれ
なする	なすら
なおせる	なおせ
撰ぶ	撰ば
つかす	つかさ
ふるい落とす	ふるい落とさ
ぶん投げる	ぶん投げ
関連づける	関連づけ
ひどる	ひどら
すくいあげる	すくいあげ
とりのこす	とりのこさ
つきそう	つきそわ
おびきだせる	おびきだせ
拉する	拉し
とびあるく	とびあるか
みまがう	みまがわ
つぎ込める	つぎ込め
浴びせかける	浴びせかけ
静まり返る	静まり返ら
悩み抜く	悩み抜か
空かす	空かさ
ふるいつく	ふるいつか
くぐもる	くぐもら
おりこめる	おりこめ
萌える	萌え
そぐ	そが
禦ぐ	禦が
見逃す	見逃さ
繁る	繁ら
下せる	下せ
めりこむ	めりこま
つよまる	つよまら
めいうつ	めいうた
言い兼ねる	言い兼ね
取り上せる	取り上せ
借り受ける	借り受け
差響く	差響か
やくせる	やくせ
飛び出る	飛び出
しめしあわす	しめしあわさ
あせじみる	あせじみ
おいつかう	おいつかわ
すりきる	すりきら
斥ける	斥け
できる	でき
うすめる	うすめ
ひんまげる	ひんまげ
隙取る	隙取ら
のめり込む	のめり込ま
頂く	頂か
塗れる	塗れ
気付かす	気付かさ
まっとうする	まっとうし
殺す	殺さ
ぶっ続ける	ぶっ続け
はこびこめる	はこびこめ
とびたつ	とびたた
避ける	避け
としよる	としよら
合う	合わ
泊める	泊め
渡り合える	渡り合え
釣り上がる	釣り上がら
期する	期し
いばれる	いばれ
切廻す	切廻さ
よっぱらう	よっぱらわ
さぐる	さぐら
誘きよせる	誘きよせ
犒う	犒わ
打ち出す	打ち出さ
すさる	すさら
冷ます	冷まさ
注げる	注げ
まちこがれる	まちこがれ
つっぱねる	つっぱね
割り戻す	割り戻さ
ねじあう	ねじあわ
震えあがる	震えあがら
漏れ聞く	漏れ聞か
しめ切る	しめ切ら
ひきころす	ひきころさ
よわまる	よわまら
どもる	どもら
ひする	ひし
はする	はし
しまう	しまわ
交う	交わ
シャレる	シャレ
ふりだせる	ふりだせ
息せき切る	息せき切ら
栄える	栄え
ひりだす	ひりださ
おる	おら
かさばる	かさばら
突っ突く	突っ突か
冴えわたる	冴えわたら
打ちはらう	打ちはらわ
まいもどれる	まいもどれ
掃く	掃か
たよる	たよら
見過ごせる	見過ごせ
出あう	出あわ
なきあかす	なきあかさ
四角張る	四角張ら
からかう	からかわ
荒ぶ	荒ば
にくまれる	にくまれ
倒す	倒さ
どなる	どなら
踏分ける	踏分け
勢い込む	勢い込ま
よみかえせる	よみかえせ
口ずさむ	口ずさま
尽す	尽さ
討ち滅ぼす	討ち滅ぼさ
嗅ぐ	嗅が
探り当てる	探り当て
息衝く	息衝か
上る	上ら
買いこむ	買いこま
買戻す	買戻さ
ぬくめる	ぬくめ
接げる	接げ
連れ戻せる	連れ戻せ
やくだてる	やくだて
懸け隔てる	懸け隔て
たちつくす	たちつくさ
しょうずる	しょうぜ
奮い立つ	奮い立た
ろんじる	ろんじ
掴まえる	掴まえ
あがめる	あがめ
興醒める	興醒め
巡り合う	巡り合わ
そそぐ	そそが
萎える	萎え
かこむ	かこま
朝する	朝し
もたれ掛かる	もたれ掛から
着付ける	着付け
よどむ	よどま
そる	そら
こぎる	こぎら
量れる	量れ
うりいそぐ	うりいそが
なぞらえる	なぞらえ
灼く	灼か
せつく	せつか
煎りつける	煎りつけ
おりまげる	おりまげ
よびいれる	よびいれ
差し向ける	差し向け
当てつける	当てつけ
好きこのむ	好きこのま
頌える	頌え
むくいる	むくい
かきとる	かきとら
遊び歩く	遊び歩か
付け合わせる	付け合わせ
かきくらす	かきくらさ
のむ	のま
持ちかえる	持ちかえら
育つ	育た
あいうつ	あいうた
炊あがる	炊あがら
没する	没し
のめる	のめら
はこべる	はこべ
解れる	解れ
すげる	すげ
落つ	落た
綻ぶ	綻ば
刻みつける	刻みつけ
迫る	迫ら
赤らむ	赤らま
見限る	見限ら
巣篭る	巣篭ら
ぬかるむ	ぬかるま
読みこなす	読みこなさ
ひきこめる	ひきこめ
くらべる	くらべ
食いつく	食いつか
衝く	衝か
かざりつける	かざりつけ
あだめく	あだめか
言逃れる	言逃れ
責めつける	責めつけ
投げる	投げ
持ち歩ける	持ち歩け
煩う	煩わ
学ぶ	学ば
もちはこべる	もちはこべ
ほれこむ	ほれこま
買い戻す	買い戻さ
かけあわせる	かけあわせ
点じる	点じ
間にあう	間にあわ
蒔き直す	蒔き直さ
おいまわせる	おいまわせ
かえせる	かえせ
閉込める	閉込め
買い戻せる	買い戻せ
拭き取れる	拭き取れ
黙り込む	黙り込ま
点頭く	点頭か
ひきおこす	ひきおこさ
見込む	見込ま
巡り会える	巡り会え
行き暮れる	行き暮れ
かぶれる	かぶれ
こきおろす	こきおろさ
じょする	じょし
抜き放つ	抜き放た
ねわすれる	ねわすれ
聞置く	聞置か
剥す	剥さ
疎む	疎ま
偽る	偽ら
垂さがる	垂さがら
ころべる	ころべ
のぞきこむ	のぞきこま
想う	想わ
奢る	奢ら
引っ掻く	引っ掻か
死す	死さ
もりころす	もりころさ
死に後れる	死に後れ
寄り切る	寄り切ら
ざする	ざし
ぱちつかせる	ぱちつかせ
突っかかる	突っかから
つらなる	つらなら
包める	包め
にがす	にがさ
せんする	せんし
みわたす	みわたさ
沸かす	沸かさ
むさぼる	むさぼら
励ます	励まさ
助け出せる	助け出せ
かみ殺せる	かみ殺せ
きりこまざく	きりこまざか
しごく	しごか
抜き合せる	抜き合せ
突き返す	突き返さ
すりあげる	すりあげ
付随う	付随わ
ゆわく	ゆわか
遇する	遇し
当て込める	当て込め
見上げる	見上げ
賑わう	賑わわ
費やす	費やさ
掃出す	掃出さ
差立てる	差立て
つまめる	つまめ
思い込む	思い込ま
増える	増え
擂り潰す	擂り潰さ
がする	がし
よみわける	よみわけ
信じ込める	信じ込め
せきあげる	せきあげ
現ずる	現ぜ
なぜる	なぜ
ひっくりかえれる	ひっくりかえれ
たるむ	たるま
誑す	誑さ
あまがける	あまがけら
はたらける	はたらけ
悄気返る	悄気返ら
切羽詰まる	切羽詰まら
求む	求ま
だきあえる	だきあえ
食切る	食切ら
産み落とす	産み落とさ
留置く	留置か
給う	給わ
廃れる	廃れ
のしあがる	のしあがら
見とがめる	見とがめ
叶う	叶わ
吊るす	吊るさ
注す	注さ
つたわる	つたわら
あやどる	あやどら
抱きとめる	抱きとめ
なくする	なくし
なでる	なで
読みさす	読みささ
ころがれる	ころがれ
憂える	憂え
追い返す	追い返さ
過ごせる	過ごせ
みがく	みがか
さしせまる	さしせまら
寄り切れる	寄り切れ
追い使う	追い使わ
流行る	流行ら
働きかける	働きかけ
信じ合える	信じ合え
まくらする	まくらし
とりいる	とりいら
切り掛ける	切り掛け
そなえる	そなえ
呆れる	呆れ
浸かる	浸から
はげ落ちる	はげ落ち
きずつく	きずつか
おくまる	おくまら
とりそろう	とりそろわ
突き通せる	突き通せ
きょうじる	きょうじ
駆付ける	駆付け
結わえる	結わえ
蟠る	蟠ら
泣き濡れる	泣き濡れ
見透す	見透さ
盗める	盗め
引っ込む	引っ込ま
峙つ	峙た
ながれこむ	ながれこま
どんする	どんし
流行らす	流行らさ
みなおす	みなおさ
忘する	忘し
詰める	詰め
引き裂く	引き裂か
興す	興さ
いぶかる	いぶから
映し出す	映し出さ
しぼる	しぼら
ふみこす	ふみこさ
計れる	計れ
ひくめる	ひくめ
仕向ける	仕向け
抱く	抱か
立ち寄る	立ち寄ら
ぱくつく	ぱくつか
似る	似
忍び込む	忍び込ま
塗りたくる	塗りたくら
練り上げる	練り上げ
やむをえる	やむをえ
投げ出す	投げ出さ
入れ替る	入れ替ら
粘り抜ける	粘り抜け
ほれる	ほれ
引きかえす	引きかえさ
売る	売ら
悼む	悼ま
叩き上げる	叩き上げ
乗り掛かる	乗り掛から
ゆずりわたす	ゆずりわたさ
すげ替える	すげ替え
たくわえる	たくわえ
売切れる	売切れ
雇える	雇え
かきかえる	かきかえ
羞じらう	羞じらわ
泣付く	泣付か
みあう	みあわ
出張る	出張ら
寝かす	寝かさ
くいつぶす	くいつぶさ
かきまわす	かきまわさ
畳み掛ける	畳み掛け
すまう	すまわ
干枯らびる	干枯らび
取りまく	取りまか
はてる	はて
撃ち落とせる	撃ち落とせ
沸き上がる	沸き上がら
飲みつぶす	飲みつぶさ
いいあらわせる	いいあらわせ
歩き回る	歩き回ら
だける	だけ
決する	決し
ぬぐう	ぬぐわ
もうしあわす	もうしあわさ
血走る	血走ら
顕す	顕さ
煉る	煉ら
ぐうする	ぐうし
書残す	書残さ
取りだす	取りださ
目盛る	目盛ら
敗ける	敗け
洗い立てる	洗い立て
しのぶ	しのば
書き換える	書き換え
死にそこなう	死にそこなわ
やる	やら
おもいなやむ	おもいなやま
飛び掛る	飛び掛ら
変り果てる	変り果て
でくわす	でくわさ
いいあらそう	いいあらそわ
たよれる	たよれ
ふぶく	ふぶか
越せる	越せ
すべくくる	すべくくら
掴みあう	掴みあわ
持ち崩す	持ち崩さ
ふみつぶす	ふみつぶさ
堪る	堪ら
呆れ返る	呆れ返ら
片す	片さ
はりあえる	はりあえ
なりたつ	なりたた
走り込める	走り込め
しゃしゃり出る	しゃしゃり出
醒ませる	醒ませ
ゆく	ゆか
縛れる	縛れ
ねりあげる	ねりあげ
存する	存し
かしずく	かしずか
覆える	覆え
くいあらす	くいあらさ
起き直れる	起き直れ
思いあたる	思いあたら
あやつる	あやつら
責め合う	責め合わ
おわらす	おわらさ
通せる	通せ
とりひしぐ	とりひしが
ひきぬく	ひきぬか
せめさいなむ	せめさいなま
あからめる	あからめ
差し越える	差し越え
進ずる	進ぜ
巡り会う	巡り会わ
げんじる	げんじ
覚ませる	覚ませ
ひっかぶる	ひっかぶら
かなでる	かなで
そりおとせる	そりおとせ
いためつける	いためつけ
害す	害さ
聞す	聞さ
よなげる	よなげ
すいする	すいし
見下せる	見下せ
手放せる	手放せ
ゆうきづく	ゆうきづか
やられる	やられ
そむける	そむけ
疑う	疑わ
唄う	唄わ
掴まる	掴まら
なりあがる	なりあがら
そそげる	そそげ
弱まる	弱まら
取り縋る	取り縋ら
持ち越せる	持ち越せ
取り除く	取り除か
収まる	収まら
ひとはたあげる	ひとはたあげ
切り分ける	切り分け
亙る	亙ら
すべる	すべら
がなる	がなら
見遣る	見遣ら
かけめぐる	かけめぐら
滑らす	滑らさ
産み落とせる	産み落とせ
作りかえる	作りかえ
さきはじめる	さきはじめ
つっかかる	つっかから
捩じこむ	捩じこま
まきなおす	まきなおさ
負ぶさる	負ぶさら
はさめる	はさめ
つのぐむ	つのぐま
聞き取る	聞き取ら
表立つ	表立た
見張る	見張ら
差昇る	差昇ら
およぼす	およぼさ
尊ぶ	尊ば
考える	考え
賀する	賀し
鎮める	鎮め
あだする	あだし
切り払える	切り払え
盗み出す	盗み出さ
ききこめる	ききこめ
追返す	追返さ
窪む	窪ま
言切る	言切ら
出で立つ	出で立た
ぶつかる	ぶつから
笑いころげる	笑いころげ
取り入れる	取り入れ
うかびあがれる	うかびあがれ
切らす	切らさ
反返る	反返ら
ふせる	ふせら
逆らう	逆らわ
閉め切る	閉め切ら
夢みる	夢み
ゆき届く	ゆき届か
はく	はか
逃す	逃さ
患う	患わ
義務付ける	義務付け
漁る	漁ら
いらう	いらわ
嗜む	嗜ま
まぎらわせる	まぎらわせ
梳かす	梳かさ
書き直す	書き直さ
立ち上がれる	立ち上がれ
あるく	あるか
押える	押え
のりこめる	のりこめ
こむ	こま
買い入れる	買い入れ
通りかかる	通りかから
気にいる	気にいら
送り返す	送り返さ
取替える	取替え
もうしこす	もうしこさ
ふみならせる	ふみならせ
おくりかえせる	おくりかえせ
臭わす	臭わさ
しなう	しなわ
取り廻す	取り廻さ
とりそろえる	とりそろえ
おいつける	おいつけ
申し合せる	申し合せ
とびぬける	とびぬけ
興ざめる	興ざめ
語り込める	語り込め
押さえる	押さえ
現われる	現われ
くずせる	くずせ
おどれる	おどれ
押つまる	押つまら
先がける	先がけ
さいばしる	さいばしら
振放つ	振放た
ねつける	ねつけ
深める	深め
こじあける	こじあけ
請出す	請出さ
鄙びる	鄙び
散らす	散らさ
払い戻す	払い戻さ
揺すぶる	揺すぶら
すさむ	すさま
たちかわれる	たちかわれ
かよう	かよわ
附ける	附け
あせばむ	あせばま
あまてらす	あまてらさ
造りだす	造りださ
うけもつ	うけもた
渡る	渡ら
かいつまむ	かいつまま
殖える	殖え
打寄せる	打寄せ
ばかげる	ばかげ
おちのびる	おちのび
はいりこむ	はいりこま
敷く	敷か
さきほこる	さきほこら
丸める	丸め
引き立つ	引き立た
妬ける	妬け
じゃくする	じゃくし
はねとばす	はねとばさ
煮え繰り返る	煮え繰り返ら
乗り回す	乗り回さ
きりはずせる	きりはずせ
着こなせる	着こなせ
召し捕る	召し捕ら
しぼれる	しぼれ
けしきばむ	けしきばま
くるしむ	くるしま
号する	号し
噴き上げる	噴き上げ
気おされる	気おされ
くわだてる	くわだて
通る	通ら
狂う	狂わ
決めこむ	決めこま
図れる	図れ
とりあげる	とりあげ
住まう	住まわ
ひんす	ひんさ
ふれる	ふれ
言わす	言わさ
行く	行か
及ぼす	及ぼさ
引払う	引払わ
埋め込める	埋め込め
目くるめく	目くるめか
抜く	抜か
ねり合せる	ねり合せ
纏える	纏え
につめる	につめ
返る	返ら
くりかえす	くりかえさ
はらいこめる	はらいこめ
説付ける	説付け
選び出す	選び出さ
はやる	はやら
聞きあきる	聞きあき
おいやれる	おいやれ
切開く	切開か
踞る	踞ら
棄てる	棄て
撓む	撓ま
染あがる	染あがら
埋めたてる	埋めたて
同じる	同じ
あばれだす	あばれださ
なおす	なおさ
呼び起こす	呼び起こさ
連れる	連れ
ふりおとせる	ふりおとせ
みだれる	みだれ
誘い合わす	誘い合わさ
たちもどる	たちもどら
眇める	眇め
ねびる	ねび
漉き返す	漉き返さ
克つ	克た
極め付ける	極め付け
こそぎ落とす	こそぎ落とさ
まちくたびれる	まちくたびれ
追廻す	追廻さ
願い出でる	願い出で
奏する	奏し
咳き入る	咳き入ら
取り続ける	取り続け
さます	さまさ
いためる	いため
ふかす	ふかさ
断れる	断れ
ひきとる	ひきとら
突っ走れる	突っ走れ
くみこめる	くみこめ
うてる	うて
のがす	のがさ
磨く	磨か
いきぬける	いきぬけ
盛りつける	盛りつけ
継足す	継足さ
弾く	弾か
痴れる	痴れ
くり上げる	くり上げ
ふみだす	ふみださ
たちこむ	たちこま
綻びる	綻び
食倒す	食倒さ
炊ぐ	炊が
咲きこぼれる	咲きこぼれ
言い換える	言い換え
静まる	静まら
悔い改める	悔い改め
隣合う	隣合わ
居坐る	居坐ら
助ける	助け
奏でる	奏で
報う	報わ
まもれる	まもれ
はさみきる	はさみきら
治る	治ら
のりとおす	のりとおさ
といただせる	といただせ
そばだつ	そばだた
いろどれる	いろどれ
きり組む	きり組ま
産みおとす	産みおとさ
寄せる	寄せ
埋め立てる	埋め立て
くわす	くわさ
紐解く	紐解か
さしいれる	さしいれ
辷り込む	辷り込ま
傾ぐ	傾が
売り払える	売り払え
むく	むか
うちこめる	うちこめ
やせこける	やせこけ
まつわる	まつわら
煮え滾る	煮え滾ら
翳る	翳ら
一肌脱ぐ	一肌脱が
くめる	くめ
わかやぐ	わかやが
つっぱしる	つっぱしら
裁ける	裁け
はっする	はっし
述べる	述べ
押返す	押返さ
まわりこめる	まわりこめ
力付ける	力付け
切り立てる	切り立て
かどだつ	かどだた
せめかける	せめかけ
きしる	きしら
引き戻せる	引き戻せ
うもれる	うもれ
辞する	辞し
編む	編ま
取広げる	取広げ
止む	止ま
有触れる	有触れ
ねらい打てる	ねらい打て
立てこもる	立てこもら
除く	除か
甜める	甜め
聞損なう	聞損なわ
聞き捨てる	聞き捨て
ふみしだく	ふみしだか
読み耽る	読み耽ら
挟み込む	挟み込ま
絡める	絡め
走り回れる	走り回れ
ただれる	ただれ
滾つ	滾た
なすり付ける	なすり付け
あつめる	あつめ
カエる	カエら
手伝える	手伝え
はりあわす	はりあわさ
熱る	熱ら
しょい込む	しょい込ま
くみつける	くみつけ
たずさわる	たずさわら
練り直せる	練り直せ
たたきおこす	たたきおこさ
とりざたす	とりざたさ
育む	育ま
きなさる	きなさら
寝かせる	寝かせ
なつく	なつか
かぎ出せる	かぎ出せ
飛び離れる	飛び離れ
たれさがる	たれさがら
とりちがえる	とりちがえ
言い放す	言い放さ
配り歩ける	配り歩け
吹きまくる	吹きまくら
へし折る	へし折ら
受止める	受止め
啜り泣く	啜り泣か
張り合う	張り合わ
あか抜ける	あか抜け
知らせる	知らせ
帯びる	帯び
むすぶ	むすば
打ち見る	打ち見
行届く	行届か
華やぐ	華やが
おそれる	おそれ
たずねる	たずね
あるける	あるけ
突っ伏す	突っ伏さ
つちかえる	つちかえ
住み替る	住み替ら
いや増す	いや増さ
ぶち当てる	ぶち当て
つきすすめる	つきすすめ
おさえこむ	おさえこま
舞戻る	舞戻ら
撮れる	撮れ
あばく	あばか
しれる	しれ
整う	整わ
かきくれる	かきくれ
踏み付ける	踏み付け
呵る	呵ら
持込む	持込ま
だまりこくる	だまりこくら
ほてる	ほてら
染みる	染み
連れ回す	連れ回さ
暗む	暗ま
待ち付ける	待ち付け
買切る	買切ら
勝ち越せる	勝ち越せ
着ぶくれる	着ぶくれ
おどす	おどさ
間引ける	間引け
たやす	たやさ
うめこめる	うめこめ
すめる	すめ
見抜ける	見抜け
嫌われる	嫌われ
盛あがる	盛あがら
息む	息ま
創り出す	創り出さ
ぶつ	ぶた
ふきあれる	ふきあれ
振り払う	振り払わ
みきる	みきら
ごてる	ごて
しんじこむ	しんじこま
差伸べる	差伸べ
さしぐむ	さしぐま
飛び廻る	飛び廻ら
取違える	取違え
かんじいる	かんじいら
辞む	辞ま
のりかかる	のりかから
とむ	とま
ひる	ひ
色づく	色づか
とうじる	とうじ
討止める	討止め
しもがかる	しもがから
落合う	落合わ
ふみぬく	ふみぬか
しみわたる	しみわたら
捕る	捕ら
もえつく	もえつか
並べ立てる	並べ立て
かたれる	かたれ
撃てる	撃て
さまよう	さまよわ
ほえる	ほえ
引つれる	引つれ
思い悩む	思い悩ま
組み直す	組み直さ
投出す	投出さ
血ばしる	血ばしら
折れ込む	折れ込ま
扱き下ろす	扱き下ろさ
まとえる	まとえ
喫する	喫し
よこぎる	よこぎら
乗り付ける	乗り付け
けんずる	けんぜ
刈り入れる	刈り入れ
倒せる	倒せ
さしかかる	さしかから
閉す	閉さ
かしこまる	かしこまら
あららげる	あららげ
擦れる	擦れ
ありがたがる	ありがたがら
抱きしめる	抱きしめ
みちびきだせる	みちびきだせ
ひっとらえる	ひっとらえ
おしかける	おしかけ
どなりこむ	どなりこま
やらかす	やらかさ
くるう	くるわ
明け渡す	明け渡さ
渡り合う	渡り合わ
手間取る	手間取ら
貸し出せる	貸し出せ
相いれる	相いれ
えどる	えどら
掻き出す	掻き出さ
しいする	しいし
取乱す	取乱さ
なりわたる	なりわたら
熟する	熟し
やきすてる	やきすて
張り巡らす	張り巡らさ
駆り集める	駆り集め
潮垂れる	潮垂れ
冷やかす	冷やかさ
貯める	貯め
引き渡す	引き渡さ
たかめる	たかめ
ちぢむ	ちぢま
いらっしゃる	いらっしゃら
塗付ける	塗付け
縢る	縢ら
詠み込める	詠み込め
伸びゆく	伸びゆか
埋め合せる	埋め合せ
はせさんずる	はせさんぜ
蔑む	蔑ま
待てる	待て
鎮まる	鎮まら
あそべる	あそべ
たてる	たて
こしらえる	こしらえ
うっちゃる	うっちゃら
開ける	開け
谷まる	谷まら
なベかえる	なベかえ
あずけいれる	あずけいれ
追いかける	追いかけ
よみとおす	よみとおさ
行き詰まる	行き詰まら
騒がす	騒がさ
見え透く	見え透か
おそわれる	おそわれ
巣だつ	巣だた
落ち着く	落ち着か
追い縋る	追い縋ら
きえのこる	きえのこら
おく	おか
いける	いけ
産む	産ま
つたう	つたわ
ときつける	ときつけ
歩き回れる	歩き回れ
突あたる	突あたら
約す	約さ
はいす	はいさ
うわつく	うわつか
下ろす	下ろさ
すすみだせる	すすみだせ
競る	競ら
こりかたまる	こりかたまら
遣い込む	遣い込ま
悖る	悖ら
踏みしめる	踏みしめ
ほほえむ	ほほえま
誘い掛ける	誘い掛け
読みつぐ	読みつが
信ずる	信ぜ
ゆき悩む	ゆき悩ま
薫る	薫ら
とりこむ	とりこま
攫う	攫わ
突っぱねる	突っぱね
かねあう	かねあわ
はまる	はまら
揺さぶる	揺さぶら
受けつける	受けつけ
もどせる	もどせ
繰り入れる	繰り入れ
生まれ変わる	生まれ変わら
持たす	持たさ
降り続く	降り続か
縫いつける	縫いつけ
とびはなれる	とびはなれ
にぶる	にぶら
浮つく	浮つか
夾む	夾ま
よわめる	よわめ
変る	変ら
さけぶ	さけば
くぼめる	くぼめ
でそろう	でそろわ
散りはてる	散りはて
のりおくれる	のりおくれ
つかうまつる	つかうまつら
引っ捕える	引っ捕え
取戻す	取戻さ
うすれる	うすれ
もりあがる	もりあがら
称す	称さ
暴ける	暴け
ひきのける	ひきのけ
しぼり上げる	しぼり上げ
さがしだせる	さがしだせ
いきり立つ	いきり立た
抜く	抜か
取りまとめる	取りまとめ
ふっ切れる	ふっ切れ
絶えはてる	絶えはて
えんじる	えんじ
行く	行か
転がす	転がさ
うちやぶる	うちやぶら
捜せる	捜せ
引こもる	引こもら
組み合す	組み合さ
思い起こせる	思い起こせ
絞る	絞ら
なつかしむ	なつかしま
ふきこめる	ふきこめ
泳ぎ着く	泳ぎ着か
成り下がれる	成り下がれ
たすける	たすけ
そそり立てる	そそり立て
たたき出す	たたき出さ
取り消す	取り消さ
繰り出せる	繰り出せ
染め返す	染め返さ
とびこむ	とびこま
ひしげる	ひしげ
吹き飛ぶ	吹き飛ば
盛り込める	盛り込め
手こずる	手こずら
むかいあう	むかいあわ
掴める	掴め
引攣れる	引攣れ
楯突く	楯突か
ひきさがる	ひきさがら
肖る	肖ら
便ずる	便ぜ
摘み取る	摘み取ら
せいだせる	せいだせ
断てる	断て
りゃくす	りゃくさ
降りかかる	降りかから
うえこめる	うえこめ
酔しれる	酔しれ
はぐらかせる	はぐらかせ
しあがる	しあがら
取壊す	取壊さ
吹きすさぶ	吹きすさば
ゆがめる	ゆがめ
生かる	生から
とり殺す	とり殺さ
かきくもる	かきくもら
乱れる	乱れ
さがしまわる	さがしまわら
庇う	庇わ
ついてまわる	ついてまわら
かいつくろう	かいつくろわ
ふける	ふけ
飛びたつ	飛びたた
採り上げる	採り上げ
くみす	くみさ
明け離れる	明け離れ
取りつく	取りつか
買い被る	買い被ら
むらだつ	むらだた
浮きたつ	浮きたた
持て扱う	持て扱わ
おさえる	おさえ
翻る	翻ら
飲み下す	飲み下さ
著す	著さ
わびる	わび
とげだつ	とげだた
賜う	賜わ
いする	いし
のけぞる	のけぞら
勇気づく	勇気づか
勢いづける	勢いづけ
突く	突か
ふんじばる	ふんじばら
待ち伏せる	待ち伏せ
さいなむ	さいなま
たてとおす	たてとおさ
詣る	詣ら
うる	詣ら
謳う	謳わ
すいあげる	すいあげ
逃せる	逃せ
まちもうける	まちもうけ
当こする	当こすら
行き合う	行き合わ
折りたたむ	折りたたま
うちあぐむ	うちあぐま
下がかる	下がから
縮み上がる	縮み上がら
飛び上がる	飛び上がら
取り付ける	取り付け
ゆきあたる	ゆきあたら
零落れる	零落れ
かまける	かまけ
蒸らす	蒸らさ
合う	合わ
縮む	縮ま
経上がる	経上がら
立ち上がる	立ち上がら
ぬきだせる	ぬきだせ
告ぐ	告が
だす	ださ
突き出す	突き出さ
取りやめる	取りやめ
つきかえす	つきかえさ
ざんねんがる	ざんねんがら
付け加える	付け加え
やりとげる	やりとげ
ふりまく	ふりまか
屯する	屯し
はりあう	はりあわ
召し上げる	召し上げ
解けあう	解けあわ
切り開く	切り開か
見直す	見直さ
打ちあわす	打ちあわさ
窺う	窺わ
貶む	貶ま
捏ねかえす	捏ねかえさ
呼び叫ぶ	呼び叫ば
たちいたる	たちいたら
たまげる	たまげ
受継ぐ	受継が
消え残る	消え残ら
さしひかえる	さしひかえ
追い越せる	追い越せ
じゅんずる	じゅんぜ
建つ	建た
終わらせる	終わらせ
もみあう	もみあわ
差し付ける	差し付け
むきあえる	むきあえ
寝そびれる	寝そびれ
立回る	立回ら
舞い戻れる	舞い戻れ
言い当てる	言い当て
すっ飛ぶ	すっ飛ば
生れおちる	生れおち
乗り組める	乗り組め
いらっしゃる	いらっしゃら
切上げる	切上げ
貢ずる	貢ぜ
さしだせる	さしだせ
わたりあう	わたりあわ
守り抜く	守り抜か
うずもる	うずもら
保てる	保て
みひらく	みひらか
引き合わす	引き合わさ
過ぎ行く	過ぎ行か
因む	因ま
いちゃつく	いちゃつか
糶る	糶ら
捲き揚げる	捲き揚げ
ひきずりだす	ひきずりださ
取り壊せる	取り壊せ
攻めたてる	攻めたて
為す	為さ
澄みわたる	澄みわたら
填る	填ら
周章てる	周章て
感づく	感づか
たちなおる	たちなおら
跳ねあがる	跳ねあがら
値する	値し
ぐずつく	ぐずつか
かき寄せる	かき寄せ
奨める	奨め
折畳む	折畳ま
馴れ合う	馴れ合わ
作り出せる	作り出せ
守る	守ら
かりとれる	かりとれ
思い知らす	思い知らさ
とおれる	とおれ
巻きこむ	巻きこま
並みいる	並みい
めんじる	めんじ
陳べる	陳べ
たちそう	たちそわ
さしとめる	さしとめ
調べる	調べ
惚ける	惚け
ゆるぎ出る	ゆるぎ出
べと付く	べと付か
まちあわす	まちあわさ
煮含める	煮含め
べとつく	べとつか
かりたてる	かりたて
かりきる	かりきら
つからせる	つからせ
捜し求める	捜し求め
撫す	撫さ
くみとれる	くみとれ
かっ飛ばす	かっ飛ばさ
かき鳴らす	かき鳴らさ
ふるわせる	ふるわせ
鋳潰す	鋳潰さ
食違う	食違わ
打ち合せる	打ち合せ
せせくる	せせくら
気付く	気付か
触回る	触回ら
走り回る	走り回ら
とぐ	とが
いいこめる	いいこめ
かこつける	かこつけ
振り当てる	振り当て
にぎわう	にぎわわ
こわばる	こわばら
長引く	長引か
みきわめる	みきわめ
押通す	押通さ
かたづく	かたづか
すいとる	すいとら
おきあがれる	おきあがれ
航る	航ら
浮べる	浮べ
引きたてる	引きたて
さしこす	さしこさ
掘り出す	掘り出さ
染めかえす	染めかえさ
泣込む	泣込ま
とりまぎれる	とりまぎれ
かけまわる	かけまわら
見なれる	見なれ
思い止る	思い止ら
老いる	老い
すすむ	すすま
くりだす	くりださ
廻す	廻さ
寝惚ける	寝惚け
凝り固まる	凝り固まら
向き直る	向き直ら
塞がる	塞がら
ふちどる	ふちどら
脹らむ	脹らま
たぶらかす	たぶらかさ
年老いる	年老い
買い込む	買い込ま
征する	征し
届ける	届け
勝ち越す	勝ち越さ
にぎわわす	にぎわわさ
ゆける	ゆけ
捌かす	捌かさ
縛り上げる	縛り上げ
はしょれる	はしょれ
だまくらかす	だまくらかさ
捺す	捺さ
問いただす	問いたださ
相伴う	相伴わ
かがやかす	かがやかさ
売り払う	売り払わ
のりする	のりし
滑り込める	滑り込め
吸い取る	吸い取ら
重んじる	重んじ
もどる	もどら
恨む	恨ま
はやめる	はやめ
錆び付く	錆び付か
つめきる	つめきら
怒鳴り込む	怒鳴り込ま
観ずる	観ぜ
引当てる	引当て
押し薦める	押し薦め
あてがう	あてがわ
つやめく	つやめか
取次ぐ	取次が
捨て去る	捨て去ら
さぐりだせる	さぐりだせ
仕上る	仕上ら
乗ずる	乗ぜ
にえる	にえ
留め置く	留め置か
敷きつめる	敷きつめ
交ぜっかえす	交ぜっかえさ
かき消す	かき消さ
切り裂く	切り裂か
烟る	烟ら
ききつける	ききつけ
煮る	煮
みにつける	みにつけ
ぐれる	ぐれ
ねりあわす	ねりあわさ
つきとおす	つきとおさ
座りこむ	座りこま
臥せる	臥せら
立ち去る	立ち去ら
降す	降さ
おじける	おじけ
かすむ	かすま
ねらい打つ	ねらい打た
織れる	織れ
はびこる	はびこら
見直せる	見直せ
仰向く	仰向か
満ち足りる	満ち足り
つぎたせる	つぎたせ
乗りかける	乗りかけ
さらけだす	さらけださ
なげかてる	なげかて
則る	則ら
ころぶ	ころば
しぶる	しぶら
こびり着く	こびり着か
みみなれる	みみなれ
拉ぐ	拉が
憂ふ	憂ひ
分け与える	分け与え
位置付ける	位置付け
おもいきれる	おもいきれ
弄ぶ	弄ば
飛び乗れる	飛び乗れ
売りさばく	売りさばか
おもいこむ	おもいこま
握る	握ら
考え出す	考え出さ
係わる	係わら
塗り替える	塗り替え
堪りかねる	堪りかね
きつける	きつけ
しゃぶる	しゃぶら
降かかる	降かから
吹き出る	吹き出
叱り付ける	叱り付け
物言う	物言わ
とびかう	とびかわ
適う	適わ
弘める	弘め
服す	服さ
おしきる	おしきら
乱す	乱さ
助け合う	助け合わ
もめる	もめ
追える	追え
寵する	寵し
繰り合せる	繰り合せ
にごらす	にごらさ
改まる	改まら
伐つ	伐た
ひれふす	ひれふさ
打取れる	打取れ
しのべる	しのべ
きえうせる	きえうせ
かい摘む	かい摘ま
為出かす	為出かさ
酔う	酔わ
うけつける	うけつけ
取り扱える	取り扱え
這い出す	這い出さ
入りまじる	入りまじら
打壊す	打壊さ
見積る	見積ら
恥じる	恥じ
襲かかる	襲かから
張飛ばす	張飛ばさ
亡くす	亡くさ
降らせる	降らせ
培える	培え
宿す	宿さ
捻じくれる	捻じくれ
かしつける	かしつけ
言い寄る	言い寄ら
込上げる	込上げ
こと足りる	こと足り
誂える	誂え
消え失せる	消え失せ
使える	使え
さきわう	さきわわ
くたびれる	くたびれ
張り詰める	張り詰め
張裂ける	張裂け
取り崩せる	取り崩せ
逆巻く	逆巻か
切りかかる	切りかから
思いあわせる	思いあわせ
つまびく	つまびか
しばたたく	しばたたか
あげつらる	あげつらら
付回す	付回さ
呑み明かす	呑み明かさ
おいかえす	おいかえさ
思い乱れる	思い乱れ
呼び入れる	呼び入れ
賑やかす	賑やかさ
骨ばる	骨ばら
誘いまくる	誘いまくら
割ける	割け
光り輝く	光り輝か
絶やせる	絶やせ
容れる	容れ
則する	則し
餌付く	餌付か
読み誤る	読み誤ら
ふきとる	ふきとら
涸れる	涸れ
おどける	おどけ
ためらう	ためらわ
おもいわずらう	おもいわずらわ
埋め合わせる	埋め合わせ
徹る	徹ら
へす	へさ
たたき込める	たたき込め
ととのえなおす	ととのえなおさ
しずめる	しずめ
書き込める	書き込め
じゃらつく	じゃらつか
笑む	笑ま
たえる	たえ
飽き飽きする	飽き飽きし
ゆるぎでる	ゆるぎで
かいくる	かいくら
おぶる	おぶら
買い与える	買い与え
こき下ろす	こき下ろさ
たちのぼる	たちのぼら
刈り上げる	刈り上げ
ちょんぎる	ちょんぎら
いいはなす	いいはなさ
召しあげる	召しあげ
きりつける	きりつけ
いびり出す	いびり出さ
付け上がる	付け上がら
形づくる	形づくら
つうぶる	つうぶら
うれえる	うれえ
逆立てる	逆立て
舞い上がる	舞い上がら
はこびだせる	はこびだせ
覚える	覚え
晒せる	晒せ
といあわす	といあわさ
きり入る	きり入ら
毒づく	毒づか
急かせる	急かせ
逝く	逝か
腰掛ける	腰掛け
いる	い
切りかける	切りかけ
先走る	先走ら
ふきはらう	ふきはらわ
あかぬける	あかぬけ
おうずる	おうぜ
起あがる	起あがら
咲き誇る	咲き誇ら
めしあがれる	めしあがれ
ふみにじる	ふみにじら
かたりこむ	かたりこま
震い付く	震い付か
削り取れる	削り取れ
浮び上がる	浮び上がら
娶す	娶さ
思いつめる	思いつめ
つめかえる	つめかえ
すべりおりる	すべりおり
かぐ	かが
打倒せる	打倒せ
より抜ける	より抜け
嗄れる	嗄れ
渡す	渡さ
悟る	悟ら
ふれ合う	ふれ合わ
引込む	引込ま
赤める	赤め
差し押える	差し押え
こんじる	こんじ
折りこむ	折りこま
疲らす	疲らさ
いきかえる	いきかえら
きる	きら
刈込む	刈込ま
片寄せる	片寄せ
つくねる	つくね
振りはらう	振りはらわ
ひけらかす	ひけらかさ
せばまる	せばまら
打ち落とせる	打ち落とせ
しくじる	しくじら
ねかす	ねかさ
にえたぎる	にえたぎら
こうずる	こうぜ
おどりはじめる	おどりはじめ
寫せる	寫せ
勤しむ	勤しま
永らえる	永らえ
忘れる	忘れ
ふてくされる	ふてくされ
当たり散らす	当たり散らさ
論じる	論じ
描ける	描け
めいる	めいら
渦まく	渦まか
照りはえる	照りはえ
くすむ	くすま
見きわめる	見きわめ
牛耳る	牛耳ら
はい出る	はい出
持ち運べる	持ち運べ
きしむ	きしま
振り込める	振り込め
聞きほれる	聞きほれ
義務づける	義務づけ
損ねる	損ね
おこせる	おこせ
うけもてる	うけもて
くりまわす	くりまわさ
つきとばせる	つきとばせ
貴ぶ	貴ば
おりたたむ	おりたたま
割り出せる	割り出せ
とどこおる	とどこおら
さびつく	さびつか
咲乱れる	咲乱れ
存じる	存じ
きえさる	きえさら
這入る	這入ら
思いたつ	思いたた
ひとかわむく	ひとかわむか
ききおとす	ききおとさ
ただす	たださ
たえはてる	たえはて
持て成す	持て成さ
現せる	現せ
わらわれる	わらわれ
おれこむ	おれこま
頭抜ける	頭抜け
匂わす	匂わさ
関わる	関わら
ひきつける	ひきつけ
鳴る	鳴ら
見のがす	見のがさ
印する	印し
慴れる	慴れ
気が付く	気が付か
ふりむける	ふりむけ
あるきまわる	あるきまわら
乗り移る	乗り移ら
咲きでる	咲きで
こぼれる	こぼれ
採り入れる	採り入れ
着膨れる	着膨れ
弛れる	弛れ
手伝う	手伝わ
せいす	せいさ
撲りつける	撲りつけ
飛回る	飛回ら
くずれさる	くずれさら
有す	有さ
手繰る	手繰ら
彩る	彩ら
くいちがう	くいちがわ
放る	放ら
賑わせる	賑わせ
遠退ける	遠退け
亡ぼす	亡ぼさ
廻せる	廻せ
こもれる	こもれ
乗せる	乗せ
殺せる	殺せ
擧げる	擧げ
まよう	まよわ
まじわれる	まじわれ
ぼける	ぼけ
叩きあげる	叩きあげ
はむ	はま
ききわける	ききわけ
組織だつ	組織だた
滑れる	滑れ
居合せる	居合せ
食止める	食止め
冴え渡る	冴え渡ら
あいつぐ	あいつが
ちゃう	ちゃわ
あらそえる	あらそえ
さしあたる	さしあたら
酔える	酔え
まとまる	まとまら
ひきこもる	ひきこもら
くぎれる	くぎれ
ちがう	ちがわ
辞める	辞め
追いやる	追いやら
潰える	潰え
すずめる	すずめ
くれる	くれ
鍛える	鍛え
もちだす	もちださ
引っ掴む	引っ掴ま
稼ぐ	稼が
対する	対し
列する	列し
はさみこめる	はさみこめ
繁り合う	繁り合わ
喫す	喫さ
処す	処さ
取り分ける	取り分け
つづりあわせる	つづりあわせ
てらす	てらさ
つかむ	つかま
てがこむ	てがこま
組み立てる	組み立て
貶す	貶さ
ダブつく	ダブつか
おぶさる	おぶさら
捌ける	捌け
印象づける	印象づけ
詰込む	詰込ま
たしなむ	たしなま
看取れる	看取れ
目する	目し
いいすてる	いいすて
ばいする	ばいし
降りそそぐ	降りそそが
堰く	堰か
護れる	護れ
くだく	くだか
吊上がる	吊上がら
肥す	肥さ
せせらわらえる	せせらわらえ
和らげる	和らげ
臭う	臭わ
直す	直さ
照り輝く	照り輝か
かききえる	かききえ
打ち取れる	打ち取れ
煮えくりかえる	煮えくりかえら
動かせる	動かせ
へつらう	へつらわ
ひねる	ひねら
ほりすすむ	ほりすすま
あるきつづける	あるきつづけ
曇る	曇ら
説く	説か
しのばす	しのばさ
ぶったぎる	ぶったぎら
擂り込む	擂り込ま
附く	附か
航れる	航れ
付け加わる	付け加わら
傾ける	傾け
よみきれる	よみきれ
切りこまざく	切りこまざか
切り刻む	切り刻ま
生け捕れる	生け捕れ
てらう	てらわ
てばなす	てばなさ
まけこす	まけこさ
あげる	あげ
さっぴく	さっぴか
這い纏る	這い纏ら
とおのく	とおのか
交ざる	交ざら
売り渡す	売り渡さ
鳴きしきる	鳴きしきら
うばいとる	うばいとら
詠みこむ	詠みこま
いいふるす	いいふるさ
つつむ	つつま
捜す	捜さ
歎ずる	歎ぜ
埋もれる	埋もれ
かくまう	かくまわ
でつくす	でつくさ
飛乗る	飛乗ら
腐す	腐さ
取り殺す	取り殺さ
ひきのばせる	ひきのばせ
つまみだせる	つまみだせ
きかかる	きかから
とく	とか
こんがらがる	こんがらがら
おりあえる	おりあえ
こぼせる	こぼせ
はりこむ	はりこま
ふりはらえる	ふりはらえ
出切る	出切ら
たたきこむ	たたきこま
教わる	教わら
花やぐ	花やが
責めさいなむ	責めさいなま
噛みしめる	噛みしめ
狂わす	狂わさ
装える	装え
さしのべる	さしのべ
つきとおせる	つきとおせ
さばく	さばか
滞る	滞ら
ふりはなつ	ふりはなた
振りまく	振りまか
特性づける	特性づけ
問い返す	問い返さ
ねたむ	ねたま
ねころべる	ねころべ
待設ける	待設け
拾い上げる	拾い上げ
舞込む	舞込ま
飛び回る	飛び回ら
感じとれる	感じとれ
走る	走ら
かむ	かま
たたき起こす	たたき起こさ
突き刺せる	突き刺せ
寄り掛かる	寄り掛から
ふやける	ふやけ
よがる	よがら
たたかえる	たたかえ
乗り進める	乗り進め
しわぶく	しわぶか
穢れる	穢れ
さすらう	さすらわ
当り散らす	当り散らさ
ぼくする	ぼくし
掻い出す	掻い出さ
繰り延べる	繰り延べ
たいする	たいし
いりくむ	いりくま
対す	対さ
一花咲かせる	一花咲かせ
振込む	振込ま
ゆりおこす	ゆりおこさ
送り返せる	送り返せ
よりわける	よりわけ
近づける	近づけ
くろずむ	くろずま
踏み出す	踏み出さ
座りこめる	座りこめ
きゅうする	きゅうし
若がえる	若がえら
ひっかえす	ひっかえさ
言触らす	言触らさ
推し量る	推し量ら
知りぬく	知りぬか
擁す	擁さ
見積もれる	見積もれ
ひきもどす	ひきもどさ
填める	填め
つっ伏す	つっ伏さ
ためす	ためさ
広がる	広がら
油染みる	油染み
まどわす	まどわさ
まとわりつく	まとわりつか
聞き付ける	聞き付け
さかのぼれる	さかのぼれ
手づまる	手づまら
立ち向かう	立ち向かわ
ふりそそぐ	ふりそそが
いいよどむ	いいよどま
へしゃげる	へしゃげ
かきぬく	かきぬか
愛せる	愛せ
焦れる	焦れ
浸す	浸さ
嘲る	嘲ら
かっきる	かっきら
謝れる	謝れ
取り留める	取り留め
きざみこむ	きざみこま
縫い込める	縫い込め
因る	因ら
おちゃらかす	おちゃらかさ
付け出す	付け出さ
ならべたてる	ならべたて
みてとれる	みてとれ
膨らす	膨らさ
のりうつる	のりうつら
言いすてる	言いすて
はたく	はたか
あてつける	あてつけ
手懐ける	手懐け
きこなす	きこなさ
流し込む	流し込ま
くさむす	くさむさ
買い上がる	買い上がら
重なり合う	重なり合わ
ぬぐいとる	ぬぐいとら
娶せる	娶せ
しんずる	しんぜ
うとんずる	うとんぜ
歯向かう	歯向かわ
撓う	撓わ
立ち会う	立ち会わ
とりあえる	とりあえ
抜合せる	抜合せ
替われる	替われ
撃ち抜く	撃ち抜か
緩める	緩め
産まれる	産まれ
さっ引く	さっ引か
めんくらう	めんくらわ
剃り落とす	剃り落とさ
飛出る	飛出
うりとばせる	うりとばせ
色付く	色付か
むしばむ	むしばま
へんずる	へんぜ
みおろす	みおろさ
おもう	おもわ
戻れる	戻れ
塗り立てる	塗り立て
続く	続か
脱がす	脱がさ
差しあげる	差しあげ
志ざす	志ざさ
組み合わせる	組み合わせ
跳ね上がる	跳ね上がら
取り巻く	取り巻か
捩じ向ける	捩じ向け
高ぶる	高ぶら
しらむ	しらま
書き捨てる	書き捨て
列べる	列べ
きそえる	きそえ
問い合わす	問い合わさ
つづく	つづか
攀じる	攀じ
ぬすみだせる	ぬすみだせ
つぶす	つぶさ
追っかける	追っかけ
咳込む	咳込ま
聞きかえす	聞きかえさ
とかせる	とかせ
あらう	あらわ
みつげる	みつげ
すりこめる	すりこめ
かたりあかす	かたりあかさ
取りあう	取りあわ
とりおこなう	とりおこなわ
押せる	押せ
絡み付く	絡み付か
取返す	取返さ
すじばる	すじばら
ならべる	ならべ
飾りたてる	飾りたて
あゆみよれる	あゆみよれ
熱す	熱さ
かねる	かね
たちまわる	たちまわら
アジる	アジら
さびれる	さびれ
ころがせる	ころがせ
さび付く	さび付か
かき暗す	かき暗さ
さわぐ	さわが
たたきこめる	たたきこめ
とどろかせる	とどろかせ
引きずりこむ	引きずりこま
差し挟む	差し挟ま
知ろしめす	知ろしめさ
てむかえる	てむかえ
じまう	じまわ
投付ける	投付け
呑み込む	呑み込ま
ぶる	ぶら
わりびける	わりびけ
ホレる	ホレ
ねこむ	ねこま
さしおさえる	さしおさえ
なおる	なおら
跳ね返る	跳ね返ら
もちくずす	もちくずさ
連なる	連なら
見れる	見れ
干る	干
さしとおす	さしとおさ
たむろする	たむろし
みうしなう	みうしなわ
戴ける	戴け
言いこめる	言いこめ
みなす	みなさ
おきる	おき
かたちづくる	かたちづくら
茹だる	茹だら
すわり込める	すわり込め
眠る	眠ら
はき違える	はき違え
乗取る	乗取ら
とだえる	とだえ
面す	面さ
ささげる	ささげ
まかれる	まかれ
わたす	わたさ
傾げる	傾げ
耐忍ぶ	耐忍ば
おちあう	おちあわ
ふりたてる	ふりたて
ふくする	ふくし
超える	超え
立ち代わる	立ち代わら
見そこなう	見そこなわ
かもしだす	かもしださ
切りさいなむ	切りさいなま
波打つ	波打た
とりかかる	とりかから
寂びる	寂び
戯れる	戯れ
引き替える	引き替え
うわる	うわら
着る	着
あたる	あたら
もちこむ	もちこま
事寄せる	事寄せ
おどろかす	おどろかさ
綾なす	綾なさ
はいでる	はいで
かいきる	かいきら
附する	附し
でむく	でむか
掻き暮れる	掻き暮れ
ふくれる	ふくれ
せき込む	せき込ま
つづる	つづら
シラケる	シラケ
待ち合せる	待ち合せ
さらけ出す	さらけ出さ
かかえこむ	かかえこま
上がり込む	上がり込ま
水際立つ	水際立た
ぬけでる	ぬけで
確かめる	確かめ
裁つ	裁た
しみいる	しみいら
立ち止まる	立ち止まら
いいわたせる	いいわたせ
思い当る	思い当ら
強請る	強請ら
しもがれる	しもがれ
提げる	提げ
連れ出せる	連れ出せ
刷る	刷ら
つっ放す	つっ放さ
減す	減さ
すぐれる	すぐれ
晴れる	晴れ
あおむける	あおむけ
もてあます	もてあまさ
吹く	吹か
わたせる	わたせ
聞付ける	聞付け
聞き損なう	聞き損なわ
はなじろむ	はなじろま
恥じらう	恥じらわ
くいちらす	くいちらさ
見付かる	見付から
擢んでる	擢んで
恐れる	恐れ
ちかう	ちかわ
あけはなつ	あけはなた
もうしあわせる	もうしあわせ
下ろせる	下ろせ
言いつくす	言いつくさ
祈ぐ	祈が
据わる	据わら
あわだつ	あわだた
なじめる	なじめ
寒気立つ	寒気立た
ぶちあてる	ぶちあて
買い切る	買い切ら
干せる	干せ
兼ね合う	兼ね合わ
ですぎる	ですぎ
凭せかける	凭せかけ
取殺す	取殺さ
立どまる	立どまら
もぐりこむ	もぐりこま
投げ棄てる	投げ棄て
挟み込める	挟み込め
思いだす	思いださ
めざめる	めざめ
にがみばしる	にがみばしら
よぶ	よば
むきだす	むきださ
のれる	のれ
住みつく	住みつか
いろめく	いろめか
くれる	くれ
請け出す	請け出さ
逸れる	逸れ
かくす	かくさ
ひきさげる	ひきさげ
ウケる	ウケ
えらべる	えらべ
引合せる	引合せ
笑いかける	笑いかけ
篩う	篩わ
ほぐす	ほぐさ
拗ける	拗け
下げ渋る	下げ渋ら
織込む	織込ま
転げ落ちる	転げ落ち
過ぎ去る	過ぎ去ら
有り合わせる	有り合わせ
ぞんじる	ぞんじ
討てる	討て
いいよる	いいよら
まつ	また
売払う	売払わ
からませる	からませ
買い受ける	買い受け
憐れむ	憐れま
おくりこむ	おくりこま
触れ回る	触れ回ら
煉れる	煉れ
晴れわたる	晴れわたら
きえる	きえ
召出す	召出さ
ひん曲がる	ひん曲がら
くもる	くもら
へだたる	へだたら
まぎらわす	まぎらわさ
付添う	付添わ
えぐれる	えぐれ
打ち合す	打ち合さ
組みなおせる	組みなおせ
うたぐる	うたぐら
たばかる	たばから
妬く	妬か
借り集める	借り集め
くいしばる	くいしばら
言い寄れる	言い寄れ
嬲る	嬲ら
裏返る	裏返ら
染み付く	染み付か
切り組む	切り組ま
おいはらう	おいはらわ
はいあがる	はいあがら
になう	になわ
防げる	防げ
砕ける	砕け
ふりだす	ふりださ
うちはたせる	うちはたせ
取り出せる	取り出せ
こまる	こまら
連だつ	連だた
修する	修し
組み替える	組み替え
すじる	すじら
呼入れる	呼入れ
つきもどせる	つきもどせ
書き立てる	書き立て
曰う	曰わ
付足す	付足さ
あわせる	あわせ
立すくむ	立すくま
釣りあげる	釣りあげ
つけ回す	つけ回さ
書き残す	書き残さ
追い捲る	追い捲ら
鋤き返す	鋤き返さ
思い立つ	思い立た
締め殺す	締め殺さ
ほったらかす	ほったらかさ
映じる	映じ
ふるふ	ふるは
触れる	触れ
退く	退か
といただす	といたださ
訣れる	訣れ
さしこむ	さしこま
死に変る	死に変ら
抗する	抗し
転ばす	転ばさ
申し出でる	申し出で
生やす	生やさ
こころみる	こころみ
かいかえる	かいかえ
搦める	搦め
ついやせる	ついやせ
おちつける	おちつけ
忘れかける	忘れかけ
けずりとる	けずりとら
よっぱらえる	よっぱらえ
引ずる	引ずら
免ずる	免ぜ
暈す	暈さ
申し聞ける	申し聞け
詣でる	詣で
くゆらせる	くゆらせ
取外す	取外さ
混ぜ返せる	混ぜ返せ
結べる	結べ
突っ込める	突っ込め
贈れる	贈れ
どうずる	どうぜ
みたせる	みたせ
討つ	討た
振り放つ	振り放た
ざれる	ざれ
吹き鳴らす	吹き鳴らさ
すぎさる	すぎさら
とりはこぶ	とりはこば
刈りとる	刈りとら
示しあわせる	示しあわせ
弾む	弾ま
つれこめる	つれこめ
押し入れる	押し入れ
割り当てる	割り当て
ねじ曲げる	ねじ曲げ
さからう	さからわ
乗り込む	乗り込ま
みこめる	みこめ
乗移る	乗移ら
屈まる	屈まら
肥れる	肥れ
よそう	よそわ
むつかる	むつから
見縊る	見縊ら
置換える	置換え
躍りかかる	躍りかから
捗る	捗ら
弔する	弔し
とびのく	とびのか
たちよる	たちよら
呼べる	呼べ
つれだせる	つれだせ
流る	流
ぬかづく	ぬかづか
つきさす	つきささ
ひがむ	ひがま
冷えこむ	冷えこま
通り掛かる	通り掛から
とっくむ	とっくま
おしとおす	おしとおさ
抱き取る	抱き取ら
みかえす	みかえさ
亡びる	亡び
空く	空か
軋めく	軋めか
呼ばわる	呼ばわら
つぐむ	つぐま
突き合わせる	突き合わせ
あわす	あわさ
講ずる	講ぜ
知り合える	知り合え
つきる	つき
振立てる	振立て
織り上げる	織り上げ
聞し召す	聞し召さ
なれる	なれ
せばめる	せばめ
苛立てる	苛立て
こりる	こり
縒れる	縒れ
ぬいつける	ぬいつけ
へあがる	へあがら
引き篭る	引き篭ら
くびれる	くびれ
揺り動かせる	揺り動かせ
畏まる	畏まら
誘い合う	誘い合わ
言い立てる	言い立て
こごる	こごら
角目立つ	角目立た
あゆみよる	あゆみよら
吹ける	吹け
役立つ	役立た
もうしあげる	もうしあげ
訪れる	訪れ
入れ替われる	入れ替われ
塾す	塾さ
ひきつる	ひきつら
そそぎこむ	そそぎこま
憩う	憩わ
迷う	迷わ
よばわる	よばわら
はべれる	はべれ
滴らす	滴らさ
乗遅れる	乗遅れ
割り込める	割り込め
入かわる	入かわら
せびる	せびら
取紛れる	取紛れ
見破れる	見破れ
とびのれる	とびのれ
立ち並ぶ	立ち並ば
醒す	醒さ
つづける	つづけ
閉じ篭る	閉じ篭ら
めげる	めげ
吹き込める	吹き込め
向けなおす	向けなおさ
踏みはずす	踏みはずさ
しめしあわせる	しめしあわせ
ねむれる	ねむれ
ぬける	ぬけ
打ち連れる	打ち連れ
かくれる	かくれ
組織立つ	組織立た
見せつける	見せつけ
取りざたす	取りざたさ
ひむ	ひま
読み込める	読み込め
すきとおる	すきとおら
おめにかかる	おめにかから
介する	介し
競り勝つ	競り勝た
震う	震わ
聞き齧る	聞き齧ら
苦り切る	苦り切ら
はる	はら
住まわす	住まわさ
申越す	申越さ
きらめかす	きらめかさ
昇れる	昇れ
つまみ出せる	つまみ出せ
抛る	抛ら
塞ぎ込む	塞ぎ込ま
あなどる	あなどら
組みあげる	組みあげ
度重なる	度重なら
とりしらべる	とりしらべ
弁じる	弁じ
くるまる	くるまら
きまる	きまら
しょげる	しょげ
差し引く	差し引か
立ちこむ	立ちこま
もぎとる	もぎとら
落魄れる	落魄れ
助け出す	助け出さ
しゅうする	しゅうし
はせあつまる	はせあつまら
おいそだつ	おいそだた
しらせる	しらせ
見つけ出せる	見つけ出せ
折りかえす	折りかえさ
聞き返せる	聞き返せ
反する	反し
殺める	殺め
うちつける	うちつけ
齧る	齧ら
物思う	物思わ
あわてる	あわて
逆立つ	逆立た
断ち割る	断ち割ら
かめる	かめ
ようだいぶる	ようだいぶら
威す	威さ
ふるえる	ふるえ
絞れる	絞れ
汲む	汲ま
引っ掛かる	引っ掛から
断つ	断た
起こす	起こさ
ぎょうずる	ぎょうぜ
もうしつたえる	もうしつたえ
見受ける	見受け
はんずる	はんぜ
紛らせる	紛らせ
ひっ担ぐ	ひっ担が
数え上げる	数え上げ
印せる	印せ
勝ち抜く	勝ち抜か
いさむ	いさま
篭る	篭ら
ふきまくる	ふきまくら
思いまどえる	思いまどえ
脱せる	脱せ
かみころす	かみころさ
讃える	讃え
言い争う	言い争わ
ならえる	ならえ
有する	有し
ひとはなさかせる	ひとはなさかせ
測る	測ら
拐う	拐わ
破れる	破れ
呼付ける	呼付け
すっとぶ	すっとば
絡ませる	絡ませ
折込む	折込ま
もうかる	もうから
駆催す	駆催さ
やりかえす	やりかえさ
当て付ける	当て付け
余る	余ら
ふみきれる	ふみきれ
見なす	見なさ
擦れ違う	擦れ違わ
流れ込む	流れ込ま
かりこす	かりこさ
蹴る	蹴ら
うず巻く	うず巻か
よびもどせる	よびもどせ
ぶっつづける	ぶっつづけ
ふくむ	ふくま
まぎれ込む	まぎれ込ま
生き抜ける	生き抜け
受合う	受合わ
繰延べる	繰延べ
さ迷う	さ迷わ
つけ上がる	つけ上がら
引しまる	引しまら
さしあう	さしあわ
受取る	受取ら
引き具する	引き具し
せっぱつまる	せっぱつまら
かいたたく	かいたたか
揉み合う	揉み合わ
魂消る	魂消
取り運ぶ	取り運ば
すくい上げる	すくい上げ
せせらわらう	せせらわらわ
枉げる	枉げ
言いふくめる	言いふくめ
落ちぶれる	落ちぶれ
しはらえる	しはらえ
なであげる	なであげ
突き放せる	突き放せ
添える	添え
せせら笑える	せせら笑え
とってかえす	とってかえさ
とむらえる	とむらえ
さとる	さとら
篭もる	篭もら
按じる	按じ
見晴らせる	見晴らせ
とどけでる	とどけで
くすぐる	くすぐら
ほうずる	ほうぜ
興ずる	興ぜ
浮びあがる	浮びあがら
織りこむ	織りこま
出せる	出せ
いきわたる	いきわたら
うごめかす	うごめかさ
思いおこす	思いおこさ
はらす	はらさ
もぐり込める	もぐり込め
ごったがえす	ごったがえさ
思いとどまれる	思いとどまれ
荒立つ	荒立た
湯掻く	湯掻か
殺ぐ	殺が
煮つめる	煮つめ
ひしめく	ひしめか
吹き付ける	吹き付け
懐ける	懐け
なぶる	なぶら
思い詰める	思い詰め
償う	償わ
加える	加え
ききはずす	ききはずさ
道化ける	道化け
転べる	転べ
かっこむ	かっこま
躓く	躓か
立ち寄れる	立ち寄れ
結う	結わ
なく	なか
言いそこなう	言いそこなわ
よじ登れる	よじ登れ
滅する	滅し
空ける	空け
脅し付ける	脅し付け
映える	映え
選べる	選べ
死なす	死なさ
告げる	告げ
あやまつ	あやまた
きょうざめる	きょうざめ
誘い込む	誘い込ま
もちあるける	もちあるけ
痛める	痛め
推移る	推移ら
売り出す	売り出さ
きくする	きくし
ひきあてる	ひきあて
打解ける	打解け
言い直せる	言い直せ
退かす	退かさ
気遣う	気遣わ
づける	づけ
取っちめる	取っちめ
デモる	デモら
跳び越す	跳び越さ
甦る	甦ら
かわる	かわら
差固める	差固め
矧ぐ	矧が
まじめくさる	まじめくさら
踏み倒す	踏み倒さ
ひきはなす	ひきはなさ
さかす	さかさ
逆だつ	逆だた
はばめる	はばめ
切詰める	切詰め
たぐえる	たぐえ
射貫く	射貫か
けちる	けちら
嘲笑う	嘲笑わ
ひさぐ	ひさが
あそびあるく	あそびあるか
もうしこめる	もうしこめ
払戻す	払戻さ
逃げ出す	逃げ出さ
ふてる	ふて
ひねれる	ひねれ
勢い付く	勢い付か
ぬれそぼつ	ぬれそぼた
指せる	指せ
あじわえる	あじわえ
流す	流さ
つぼむ	つぼま
わたくしする	わたくしし
いただく	いただか
打ち直す	打ち直さ
やぶる	やぶら
かきあつめる	かきあつめ
おびる	おび
取り落とす	取り落とさ
もうしおくる	もうしおくら
畳む	畳ま
よす	よさ
やむを得る	やむを得
なまる	なまら
語り明かす	語り明かさ
飛び渡る	飛び渡ら
問い詰める	問い詰め
取っつく	取っつか
揺がす	揺がさ
さきんじる	さきんじ
取越す	取越さ
似かよう	似かよわ
見捨てる	見捨て
封ずる	封ぜ
せき止める	せき止め
眠らす	眠らさ
取りつかれる	取りつかれ
蕩かす	蕩かさ
上がれる	上がれ
読みあさる	読みあさら
こわがる	こわがら
刷り込める	刷り込め
怒鳴りつける	怒鳴りつけ
申込む	申込ま
さえる	さえ
くろみがかる	くろみがから
垢抜ける	垢抜け
派する	派し
ちちくる	ちちくら
生らす	生らさ
ものおもう	ものおもわ
読上げる	読上げ
潜まる	潜まら
抛り出す	抛り出さ
ずれ込む	ずれ込ま
驚かす	驚かさ
羽織る	羽織ら
にあがる	にあがら
角立てる	角立て
窶す	窶さ
呈する	呈し
きる	きら
差し固める	差し固め
知れる	知れ
乗りこなす	乗りこなさ
聞き流せる	聞き流せ
みつくろう	みつくろわ
とりかこめる	とりかこめ
ほねばる	ほねばら
入替る	入替ら
いただける	いただけ
たわける	たわけ
よみだす	よみださ
かんがえなおす	かんがえなおさ
取り仕切れる	取り仕切れ
送り届ける	送り届け
引っくり返す	引っくり返さ
見廻す	見廻さ
聞き外す	聞き外さ
飲み込む	飲み込ま
しらべる	しらべ
みならう	みならわ
であう	であわ
奪い返す	奪い返さ
はう	はわ
取り拉ぐ	取り拉が
見届ける	見届け
ころがす	ころがさ
しめだす	しめださ
たたみかける	たたみかけ
さげる	さげ
売りこむ	売りこま
流し入れる	流し入れ
包み隠す	包み隠さ
救い出せる	救い出せ
あく	あか
湛える	湛え
招き入れる	招き入れ
より分ける	より分け
化す	化さ
釣りあがる	釣りあがら
抗える	抗え
切り付ける	切り付け
のりこえる	のりこえ
いれかえる	いれかえ
よびこめる	よびこめ
間引く	間引か
こきつかえる	こきつかえ
利する	利し
活ける	活け
下卑る	下卑
進み出せる	進み出せ
組み込む	組み込ま
突き付ける	突き付け
ねりあるく	ねりあるか
応ずる	応ぜ
まぜかえす	まぜかえさ
書立てる	書立て
はしりこめる	はしりこめ
乗り入れる	乗り入れ
引き継ぐ	引き継が
あいいとなむ	あいいとなま
おれ合う	おれ合わ
吹き飛ばす	吹き飛ばさ
憬れる	憬れ
見下げる	見下げ
採る	採ら
和ぐ	和が
さびる	さび
やつれる	やつれ
穿く	穿か
おちる	おち
耀く	耀か
寄あつまる	寄あつまら
至る	至ら
かよえる	かよえ
あかみがかる	あかみがから
たがねる	たがね
書き成す	書き成さ
突戻す	突戻さ
つくれる	つくれ
擦り寄る	擦り寄ら
競上げる	競上げ
起き直る	起き直ら
すごもる	すごもら
うちよせる	うちよせ
留る	留ら
つきぬく	つきぬか
いそしむ	いそしま
入乱れる	入乱れ
扇ぐ	扇が
清ます	清まさ
放つ	放た
ごった返す	ごった返さ
削ぐ	削が
磨る	磨ら
押えつける	押えつけ
考え抜く	考え抜か
戴く	戴か
いたぶる	いたぶら
わする	わし
つきそえる	つきそえ
切りとれる	切りとれ
睡る	睡ら
働ける	働け
すえつける	すえつけ
取りとめる	取りとめ
ふす	ふさ
閉じこめる	閉じこめ
おっかぶせる	おっかぶせ
見せびらかす	見せびらかさ
うかばれる	うかばれ
よびかける	よびかけ
もちだせる	もちだせ
抱き合える	抱き合え
勝ち進める	勝ち進め
うきあがれる	うきあがれ
うむ	うま
番える	番え
とつぐ	とつが
誘いかける	誘いかけ
言い争える	言い争え
まかなえる	まかなえ
突っ立てる	突っ立て
しゃれる	しゃれ
取澄ます	取澄まさ
うかれ出る	うかれ出
粘つく	粘つか
思い余る	思い余ら
押付ける	押付け
削る	削ら
直す	直さ
うちあう	うちあわ
つっぷす	つっぷさ
繰り下げる	繰り下げ
つきすすむ	つきすすま
踏みつぶす	踏みつぶさ
見送れる	見送れ
裁ち切る	裁ち切ら
生き残れる	生き残れ
憧れる	憧れ
すり減る	すり減ら
割り引く	割り引か
ぬたくる	ぬたくら
よじれる	よじれ
すげかえる	すげかえ
強ばる	強ばら
やりすごす	やりすごさ
起てる	起て
痩せさらばえる	痩せさらばえ
押し返す	押し返さ
言いあう	言いあわ
あったまる	あったまら
のりつける	のりつけ
持運ぶ	持運ば
広げる	広げ
崩れ落ちる	崩れ落ち
ほうける	ほうけ
ひなびる	ひなび
固まれる	固まれ
還す	還さ
とりなおせる	とりなおせ
飲みまわす	飲みまわさ
しかる	しから
うごく	うごか
下す	下さ
肥やす	肥やさ
さしかえる	さしかえ
まちうける	まちうけ
おいこむ	おいこま
青ざめる	青ざめ
踏み外す	踏み外さ
まかりこす	まかりこさ
取り片付ける	取り片付け
たちかわる	たちかわら
書き取る	書き取ら
かきあらわす	かきあらわさ
引き締める	引き締め
入り雑じる	入り雑じら
くみあう	くみあわ
浮き立つ	浮き立た
こもる	こもら
おりなす	おりなさ
しにかける	しにかけ
さんずる	さんぜ
相営む	相営ま
招ずる	招ぜ
つりこむ	つりこま
いきのこる	いきのこら
いかる	いから
ふくらせる	ふくらせ
かみ殺す	かみ殺さ
任す	任さ
制す	制さ
取りかえる	取りかえ
差し込む	差し込ま
にげこむ	にげこま
行える	行え
さ迷う	さ迷わ
おいぬける	おいぬけ
しなびる	しなび
掲げる	掲げ
充ちる	充ち
みつかる	みつから
もつれ合う	もつれ合わ
携わる	携わら
狩出す	狩出さ
ひっくりかえす	ひっくりかえさ
注ぐ	注が
くり貫く	くり貫か
おがむ	おがま
吊る	吊ら
方向づける	方向づけ
回せる	回せ
撃ち落とす	撃ち落とさ
降り注ぐ	降り注が
駆り出す	駆り出さ
掴みかかる	掴みかから
願う	願わ
煮上がる	煮上がら
立込める	立込め
つっ込む	つっ込ま
誉めちぎる	誉めちぎら
うつせる	うつせ
狙える	狙え
したまわる	したまわら
うちおとす	うちおとさ
生まれでる	生まれで
くじけかかる	くじけかから
かいしめる	かいしめ
とりまける	とりまけ
懸け隔たる	懸け隔たら
よみこむ	よみこま
引出す	引出さ
むすびつく	むすびつか
観る	観
演じる	演じ
揃える	揃え
消えはてる	消えはて
すきおこす	すきおこさ
揺り起こす	揺り起こさ
後らせる	後らせ
謙る	謙ら
とりおこなえる	とりおこなえ
取り逃がす	取り逃がさ
おりゃる	おりゃら
住み着く	住み着か
縮くれる	縮くれ
そりくりかえる	そりくりかえら
転ぶ	転ば
きりぬける	きりぬけ
のみあかす	のみあかさ
かぎつける	かぎつけ
しゃうぞく	しゃうぞか
逸らす	逸らさ
まきかえせる	まきかえせ
巻ける	巻け
繰り替える	繰り替え
踏みこたえる	踏みこたえ
うる	うら
ふせぐ	ふせが
叫ぶ	叫ば
立ち去れる	立ち去れ
白む	白ま
持ち出す	持ち出さ
剥ぐ	剥が
励む	励ま
研げる	研げ
剥がれる	剥がれ
のりつげる	のりつげ
つきまとう	つきまとわ
被さる	被さら
かけもつ	かけもた
やどれる	やどれ
しらす	しらさ
吹っ切れる	吹っ切れ
とりしまれる	とりしまれ
合さる	合さら
まつわりつく	まつわりつか
つかみ合う	つかみ合わ
圧す	圧さ
振り捨てる	振り捨て
はぎとる	はぎとら
傷む	傷ま
微睡む	微睡ま
はりだす	はりださ
撃ち込める	撃ち込め
打払える	打払え
組込める	組込め
突き進む	突き進ま
連合う	連合わ
またぐ	またが
燐む	燐ま
緩む	緩ま
付合う	付合わ
踏倒す	踏倒さ
見越す	見越さ
寄り倒す	寄り倒さ
はしょる	はしょら
いれかわる	いれかわら
がたつく	がたつか
みそめる	みそめ
おわらせる	おわらせ
つかいこなせる	つかいこなせ
数えあげる	数えあげ
もとまる	もとまら
垂らす	垂らさ
笑える	笑え
おれる	おれ
葬れる	葬れ
躄る	躄ら
無くなす	無くなさ
吹き降ろす	吹き降ろさ
折り合える	折り合え
無くす	無くさ
もちあげる	もちあげ
沈む	沈ま
ぬけかわる	ぬけかわら
たしなめる	たしなめ
張り出す	張り出さ
立添う	立添わ
除ける	除け
掬う	掬わ
揺らせる	揺らせ
立ち代われる	立ち代われ
あきれ返る	あきれ返ら
とまどう	とまどわ
聞きはずす	聞きはずさ
天翔る	天翔ら
生み落す	生み落さ
からす	からさ
取り澄ます	取り澄まさ
つきささる	つきささら
案ずる	案ぜ
言い伝える	言い伝え
誘き出す	誘き出さ
熾る	熾ら
腫れ上がる	腫れ上がら
よみさす	よみささ
いだく	いだか
すます	すまさ
なげきあかす	なげきあかさ
くさす	くささ
ふやかす	ふやかさ
暴れだす	暴れださ
負かす	負かさ
あいする	あいし
ねむりこむ	ねむりこま
引き返せる	引き返せ
とおりかかる	とおりかから
伏せる	伏せら
学びとる	学びとら
爆ぜる	爆ぜ
うまれつく	うまれつか
出会える	出会え
聞きすます	聞きすまさ
流れ出る	流れ出
淫する	淫し
食らう	食らわ
引く	引か
吊り出す	吊り出さ
まわる	まわら
苦みばしる	苦みばしら
込み上げる	込み上げ
じれ込む	じれ込ま
懸ける	懸け
書き起す	書き起さ
さえかえる	さえかえら
見識張る	見識張ら
ねかしつける	ねかしつけ
あがれる	あがれ
まぎれこむ	まぎれこま
すくめる	すくめ
おきなおれる	おきなおれ
摩れる	摩れ
見抜く	見抜か
入雑じる	入雑じら
よわる	よわら
ひる	ひら
出しゃばる	出しゃばら
おぼれる	おぼれ
おりたためる	おりたため
究める	究め
陣どる	陣どら
投げ込める	投げ込め
受けとる	受けとら
喪う	喪わ
振り絞る	振り絞ら
さきがける	さきがけ
締め括る	締め括ら
そらせる	そらせ
味付ける	味付け
咲こぼれる	咲こぼれ
遅らす	遅らさ
ときあかす	ときあかさ
とっくめる	とっくめ
黙する	黙し
もむ	もま
ほじくる	ほじくら
ひもとける	ひもとけ
打ちあぐむ	打ちあぐま
想える	想え
脱ぐ	脱が
諮れる	諮れ
けずれる	けずれ
謀れる	謀れ
おす	おさ
上れる	上れ
目ざめる	目ざめ
はしりまわれる	はしりまわれ
やすめる	やすめ
攻めのぼる	攻めのぼら
荒む	荒ま
はなしかける	はなしかけ
はたす	はたさ
まする	まし
憶える	憶え
割切れる	割切れ
こなせる	こなせ
太る	太ら
まみれる	まみれ
積込む	積込ま
居座る	居座ら
ききいる	ききいら
躍りでる	躍りで
過つ	過た
とる	とら
みかえせる	みかえせ
のけ反る	のけ反ら
揺さぶれる	揺さぶれ
おしのける	おしのけ
値切れる	値切れ
縊れる	縊れ
はいれる	はいれ
思いきる	思いきら
聰る	聰ら
ほころぶ	ほころば
口篭る	口篭ら
遇う	遇わ
酬いる	酬い
冬篭る	冬篭ら
ふみきる	ふみきら
かき消せる	かき消せ
なげとばす	なげとばさ
死に遅れる	死に遅れ
近付く	近付か
なきしずむ	なきしずま
仕留める	仕留め
醂す	醂さ
たおせる	たおせ
はえる	はえ
いりかわる	いりかわら
見回る	見回ら
差戻す	差戻さ
腹だつ	腹だた
厭き厭きする	厭き厭きし
縛りあげる	縛りあげ
買取る	買取ら
またたく	またたか
立ち竦む	立ち竦ま
足る	足ら
温もる	温もら
惹ける	惹け
立掛ける	立掛け
譲り渡す	譲り渡さ
ひろまる	ひろまら
焦る	焦ら
ひっさげる	ひっさげ
死かわる	死かわら
まざる	まざら
透ける	透け
追込む	追込ま
ほりこむ	ほりこま
ばかす	ばかさ
さがる	さがら
まもりそだてる	まもりそだて
移り変る	移り変ら
混ぜ合わす	混ぜ合わさ
はね上げる	はね上げ
かがる	かがら
潤びる	潤び
押し負ける	押し負け
突ぱる	突ぱら
よびこむ	よびこま
かろんずる	かろんぜ
搾れる	搾れ
こげつく	こげつか
おもんずる	おもんぜ
ささめく	ささめか
突き通る	突き通ら
請けおう	請けおわ
打しおれる	打しおれ
解する	解し
植える	植え
なみだつ	なみだた
取り広げる	取り広げ
はからえる	はからえ
腫れる	腫れ
飛交う	飛交わ
高める	高め
つまずく	つまずか
がぶる	がぶら
捲し立てる	捲し立て
のこれる	のこれ
駆け付ける	駆け付け
引き寄せる	引き寄せ
写る	写ら
解合う	解合わ
たちおくれる	たちおくれ
くずおれる	くずおれ
立会う	立会わ
思ふ	思は
つる	つら
当込む	当込ま
なぐりつける	なぐりつけ
とりつぐ	とりつが
きらう	きらわ
耕せる	耕せ
散じる	散じ
けしとぶ	けしとば
こびる	こび
取り囲む	取り囲ま
一皮剥く	一皮剥か
馳せ参ずる	馳せ参ぜ
むらがる	むらがら
刳る	刳ら
かきとめる	かきとめ
出っ張る	出っ張ら
ひきつれる	ひきつれ
しんぜる	しんぜ
もえる	もえ
やつす	やつさ
知り合う	知り合わ
鍛え上げる	鍛え上げ
持て余す	持て余さ
差し違える	差し違え
おりまぜる	おりまぜ
のべる	のべ
わきまえる	わきまえ
封じる	封じ
覚める	覚め
殉ずる	殉ぜ
思い付く	思い付か
努まる	努まら
陳ぶ	陳ば
がかる	がから
たかれる	たかれ
やりこなす	やりこなさ
ふざける	ふざけ
売り悩む	売り悩ま
向かい合わせる	向かい合わせ
佇つ	佇た
よりそう	よりそわ
曇らす	曇らさ
弔う	弔わ
生かせる	生かせ
撚る	撚ら
なきつく	なきつか
わる	わら
入れる	入れ
行き着く	行き着か
盛り上がる	盛り上がら
締まる	締まら
はしりでる	はしりで
なえる	なえ
亡ぶ	亡ば
燻る	燻ら
すすりなく	すすりなか
ひきのばす	ひきのばさ
にごす	にごさ
くりこす	くりこさ
狭まる	狭まら
取り捌く	取り捌か
娶る	娶ら
急かす	急かさ
ながらえる	ながらえ
転がりこむ	転がりこま
おもひよる	おもひよら
振切る	振切ら
羽ばたく	羽ばたか
請負う	請負わ
落行く	落行か
そろう	そろわ
揺れる	揺れ
だまりこむ	だまりこま
とりすます	とりすまさ
おしだまる	おしだまら
なみうつ	なみうた
ずる	ずら
詰まる	詰まら
合わす	合わさ
ききこむ	ききこま
折る	折ら
正せる	正せ
すり替える	すり替え
連出す	連出さ
つけくわわる	つけくわわら
かきなおせる	かきなおせ
小突き回す	小突き回さ
荒らす	荒らさ
とりこわす	とりこわさ
きわめる	きわめ
待つ	待た
巧む	巧ま
さんする	さんし
くみ取れる	くみ取れ
おもいだせる	おもいだせ
ふきならす	ふきならさ
ごする	ごし
心行く	心行か
食み出す	食み出さ
支う	支わ
溜め込む	溜め込ま
ことわれる	ことわれ
とびはねる	とびはね
繰り込める	繰り込め
ふきはらえる	ふきはらえ
殉じる	殉じ
注ぎ込む	注ぎ込ま
沿う	沿わ
泊まり込む	泊まり込ま
炊きあがる	炊きあがら
すすける	すすけ
飛離れる	飛離れ
ひねり回す	ひねり回さ
取分ける	取分け
流せる	流せ
光らす	光らさ
すがれる	すがれ
折返す	折返さ
へこむ	へこま
漱ぐ	漱が
借りる	借り
問い合わせる	問い合わせ
みせる	みせ
呼出す	呼出さ
数える	数え
着飾る	着飾ら
出来上がる	出来上がら
いたる	いたら
召す	召さ
先んずる	先んぜ
こらしめる	こらしめ
腐れる	腐れ
受けいれる	受けいれ
切り抜ける	切り抜け
巡らせる	巡らせ
ずらす	ずらさ
爪立つ	爪立た
売急ぐ	売急が
翻す	翻さ
くちばしる	くちばしら
捻くれる	捻くれ
錆付く	錆付か
しょうじる	しょうじ
まいる	まいら
歪める	歪め
突き合す	突き合さ
羽ばたける	羽ばたけ
ひす	ひさ
引下げる	引下げ
かんさびる	かんさび
削り倒す	削り倒さ
備え付ける	備え付け
操る	操ら
よれる	よれ
ねばりぬく	ねばりぬか
いいだせる	いいだせ
さげわたす	さげわたさ
叩き起す	叩き起さ
きりかわる	きりかわら
諭せる	諭せ
きける	きけ
打砕く	打砕か
売り込む	売り込ま
ひやかせる	ひやかせ
捩じ伏せる	捩じ伏せ
おしながす	おしながさ
使う	使わ
みすてる	みすて
嚼む	嚼ま
フケる	フケ
積出す	積出さ
めっする	めっし
言い放つ	言い放た
殺気立つ	殺気立た
せきたてる	せきたて
みとおせる	みとおせ
渡れる	渡れ
見かねる	見かね
出回る	出回ら
啜る	啜ら
心ゆく	心ゆか
引連れる	引連れ
よりそえる	よりそえ
じゅくする	じゅくし
酔い潰れる	酔い潰れ
剃る	剃ら
ではじめる	ではじめ
せめたてる	せめたて
ゆき交う	ゆき交わ
かちすすむ	かちすすま
くいこむ	くいこま
じめつく	じめつか
ふんまえる	ふんまえ
しそんじる	しそんじ
撃ち殺す	撃ち殺さ
綰ねる	綰ね
医する	医し
噛み付く	噛み付か
間切る	間切ら
しまふ	しまは
送り込める	送り込め
だんじこむ	だんじこま
みちびきだす	みちびきださ
造れる	造れ
打ちとける	打ちとけ
行く	行か
のたうつ	のたうた
つま弾く	つま弾か
存じ上げる	存じ上げ
汲み出す	汲み出さ
抱締める	抱締め
罪する	罪し
勝ち取る	勝ち取ら
撮す	撮さ
濡れそぼつ	濡れそぼた
くるしめる	くるしめ
泣かす	泣かさ
売り切れる	売り切れ
食い倒す	食い倒さ
踏みだす	踏みださ
きれあがる	きれあがら
咬む	咬ま
飾る	飾ら
へばりつく	へばりつか
すねる	すね
座する	座し
あおみがかる	あおみがから
引き落とす	引き落とさ
はなしこむ	はなしこま
ふりかける	ふりかけ
申出る	申出
漏れる	漏れ
つきあたる	つきあたら
ふりかえる	ふりかえら
とっつく	とっつか
むすびつける	むすびつけ
かたどれる	かたどれ
萎む	萎ま
耀かす	耀かさ
刺殺す	刺殺さ
よう	よわ
たたき出せる	たたき出せ
接する	接し
放す	放さ
掴み掛る	掴み掛ら
遊びあきる	遊びあき
すべり込む	すべり込ま
追いまわす	追いまわさ
挑む	挑ま
押し入る	押し入ら
のぼせる	のぼせ
ざわめく	ざわめか
いりつける	いりつけ
質せる	質せ
たえしのぶ	たえしのば
給する	給し
擦付ける	擦付け
ひきつくろう	ひきつくろわ
そやす	そやさ
引き延ばす	引き延ばさ
付き添う	付き添わ
刺し違える	刺し違え
売り上げる	売り上げ
よだつ	よだた
聞きだす	聞きださ
利く	利か
染み入る	染み入ら
うなずける	うなずけ
ぞんずる	ぞんぜ
よびおこす	よびおこさ
はなせる	はなせ
冷える	冷え
読みくだす	読みくださ
盛り返す	盛り返さ
わきたつ	わきたた
溺らす	溺らさ
やきあげる	やきあげ
振り落とせる	振り落とせ
まきつく	まきつか
ひっ返す	ひっ返さ
引っぱる	引っぱら
まちかまえる	まちかまえ
よこす	よこさ
使われだす	使われださ
じゃれる	じゃれ
賞する	賞し
借り越す	借り越さ
買いつける	買いつけ
はおる	はおら
はしる	はしら
焦げ付く	焦げ付か
借受ける	借受け
さしでる	さしで
さかまく	さかまか
きんじる	きんじ
はらせる	はらせ
生める	生め
つるし上げる	つるし上げ
口説ける	口説け
まねく	まねか
あやす	あやさ
染る	染ら
かじりつく	かじりつか
煮える	煮え
持直す	持直さ
かきちらす	かきちらさ
慕う	慕わ
載る	載ら
頼みこむ	頼みこま
引っ篭る	引っ篭ら
更ける	更け
咳き込む	咳き込ま
押しかける	押しかけ
引っ剥がす	引っ剥がさ
はずれる	はずれ
切り合う	切り合わ
あやぶむ	あやぶま
捉える	捉え
むすべる	むすべ
取り替える	取り替え
寝返る	寝返ら
そっする	そっし
乗込む	乗込ま
こころえる	こころえ
潰せる	潰せ
持越す	持越さ
混ぜっ返す	混ぜっ返さ
こいねがう	こいねがわ
ちゃかす	ちゃかさ
焚きしめる	焚きしめ
打ち落とす	打ち落とさ
け飛ばす	け飛ばさ
まぜ返す	まぜ返さ
よう	よわ
ふりあう	ふりあわ
わらわす	わらわさ
寄りつく	寄りつか
はじきだせる	はじきだせ
ひらめかす	ひらめかさ
嗣げる	嗣げ
かきまぜる	かきまぜ
怖じける	怖じけ
うりだせる	うりだせ
擦り込む	擦り込ま
ゆきたつ	ゆきたた
しかける	しかけ
うつしだせる	うつしだせ
押しきる	押しきら
勿体ぶる	勿体ぶら
ふる	ふら
尽くす	尽くさ
みてとる	みてとら
まるめ込む	まるめ込ま
束ねる	束ね
ねがいさげる	ねがいさげ
もじる	もじら
粒立つ	粒立た
まよわす	まよわさ
たがう	たがわ
集える	集え
寄り掛る	寄り掛ら
じとつく	じとつか
払える	払え
つきあわせる	つきあわせ
嫌う	嫌わ
奉る	奉ら
受けとめる	受けとめ
息詰まる	息詰まら
紛う	紛わ
ゆきかえる	ゆきかえら
うつしだす	うつしださ
したてる	したて
押しつめる	押しつめ
悲しむ	悲しま
あずかる	あずから
年寄る	年寄ら
かぶせる	かぶせ
むける	むけ
泣き伏す	泣き伏さ
ちゃらつかす	ちゃらつかさ
さぐり合う	さぐり合わ
絶する	絶し
縮かむ	縮かま
よばれる	よばれ
おどりでる	おどりで
うちとる	うちとら
泣沈む	泣沈ま
おちつく	おちつか
すいだす	すいださ
貴べる	貴べ
心づく	心づか
握り締める	握り締め
負える	負え
はりめぐらせる	はりめぐらせ
刺す	刺さ
作りあげる	作りあげ
訊く	訊か
ふさぐ	ふさが
脅し取る	脅し取ら
召し上がれる	召し上がれ
かたちづくれる	かたちづくれ
ためこめる	ためこめ
わすれる	わすれ
つくり上げる	つくり上げ
競い合う	競い合わ
こる	こら
ききあわせる	ききあわせ
のぞき込める	のぞき込め
追っぱらう	追っぱらわ
受け合える	受け合え
ぎゅうじる	ぎゅうじら
ふみはずす	ふみはずさ
はたせる	はたせ
賺す	賺さ
かきむしる	かきむしら
踏出す	踏出さ
つかれはてる	つかれはて
やり過す	やり過さ
仕上がる	仕上がら
取回す	取回さ
ズレる	ズレ
面する	面し
言尽す	言尽さ
割当てる	割当て
怒れる	怒れ
ときおこす	ときおこさ
引立てる	引立て
競合う	競合わ
素見す	素見さ
切り返す	切り返さ
砕く	砕か
しめきる	しめきら
息づく	息づか
囲える	囲え
引っ張る	引っ張ら
打ち壊す	打ち壊さ
いう	いわ
押し返せる	押し返せ
入り浸る	入り浸ら
いら立つ	いら立た
襲いかかる	襲いかから
熾きる	熾き
くり出す	くり出さ
きかざれる	きかざれ
かられる	かられ
呼ぶ	呼ば
書出す	書出さ
くぐり抜ける	くぐり抜け
ざんする	ざんし
そりおとす	そりおとさ
しめつける	しめつけ
たんずる	たんぜ
好む	好ま
競べる	競べ
切り捨てる	切り捨て
ほりあげる	ほりあげ
のたうちまわる	のたうちまわら
捕らわれる	捕らわれ
凍みる	凍み
こころゆく	こころゆか
つっきる	つっきら
どやす	どやさ
笑い転げる	笑い転げ
掛る	掛ら
住む	住ま
約まる	約まら
あいしあう	あいしあわ
頑張れる	頑張れ
させる	させ
おかす	おかさ
あます	あまさ
泣き付く	泣き付か
あわれむ	あわれま
積み重ねる	積み重ね
うちあわす	うちあわさ
訳せる	訳せ
詫びる	詫び
創り出せる	創り出せ
担げる	担げ
追い上げる	追い上げ
根づく	根づか
立ち会える	立ち会え
祭り上げる	祭り上げ
こもどす	こもどさ
乗かかる	乗かから
創る	創ら
練直す	練直さ
かがやく	かがやか
うちあわせる	うちあわせ
遜る	遜ら
かする	かし
戦く	戦か
腹立てる	腹立て
擦り込める	擦り込め
勝ち得る	勝ち得
みごもる	みごもら
討ち果たせる	討ち果たせ
野次る	野次ら
よみがえる	よみがえら
踏み抜く	踏み抜か
生かす	生かさ
おいつめる	おいつめ
採れる	採れ
つきやぶる	つきやぶら
めぐりあう	めぐりあわ
尽くせる	尽くせ
進む	進ま
赴く	赴か
くりいれる	くりいれ
しゃっちょこ張る	しゃっちょこ張ら
めしぐす	めしぐさ
煮つまる	煮つまら
渦巻く	渦巻か
動く	動か
くり抜く	くり抜か
試みる	試み
汚す	汚さ
食い入る	食い入ら
反らせる	反らせ
晴らせる	晴らせ
取っ組める	取っ組め
選ぶ	選ば
彫る	彫ら
振りしぼる	振りしぼら
吸寄せる	吸寄せ
かぎだす	かぎださ
紛らす	紛らさ
詰めこむ	詰めこま
どうきづける	どうきづけ
見過す	見過さ
つけ入る	つけ入ら
ぬきあわせる	ぬきあわせ
巻き込む	巻き込ま
結上げる	結上げ
才弾ける	才弾け
ときほぐす	ときほぐさ
結ぼれる	結ぼれ
まいれる	まいれ
うりとばす	うりとばさ
すりむく	すりむか
剥げる	剥げ
たくする	たくし
したがう	したがわ
見せる	見せ
そまる	そまら
煮付ける	煮付け
ぶっつける	ぶっつけ
しずむ	しずま
切り結ぶ	切り結ば
納める	納め
引さがる	引さがら
陥れる	陥れ
つまみだす	つまみださ
引き絞れる	引き絞れ
取留める	取留め
預かる	預から
図抜ける	図抜け
安らぐ	安らが
瞬ぐ	瞬が
くべる	くべ
おちくぼむ	おちくぼま
擦り付ける	擦り付け
組合う	組合わ
たすかる	たすから
俯ける	俯け
かみあわせる	かみあわせ
購う	購わ
はね返る	はね返ら
振れる	振れ
とびまわる	とびまわら
廻らす	廻らさ
持ち寄れる	持ち寄れ
折りあえる	折りあえ
めかす	めかさ
来れる	来れ
えりわける	えりわけ
ふんぞる	ふんぞら
おせる	おせ
搖れる	搖れ
にえたつ	にえたた
罵る	罵ら
欺ける	欺け
まがりくねる	まがりくねら
涼む	涼ま
祝する	祝し
立ち合う	立ち合わ
疑る	疑ら
慶べる	慶べ
連れ添える	連れ添え
やり返せる	やり返せ
燃えたつ	燃えたた
あがりこむ	あがりこま
拗れる	拗れ
かつぎこむ	かつぎこま
ひきずる	ひきずら
埋れる	埋れ
ほかす	ほかさ
静める	静め
成かわる	成かわら
かげる	かげら
つぶれる	つぶれ
出し切る	出し切ら
吸い取れる	吸い取れ
諭す	諭さ
取り紛れる	取り紛れ
取りまわす	取りまわさ
おしむ	おしま
みだれとぶ	みだれとば
買い進む	買い進ま
うる	買い進ま
あう	あわ
捕まる	捕まら
足せる	足せ
うわむく	うわむか
だれる	だれ
わかいしあう	わかいしあわ
振り返る	振り返ら
おいすがる	おいすがら
はねる	はね
直せる	直せ
重ね合う	重ね合わ
いたす	いたさ
埋もる	埋もら
取り崩す	取り崩さ
かける	かけ
かみくだける	かみくだけ
見る	見
中る	中ら
あらいおとす	あらいおとさ
おしながせる	おしながせ
蹴倒す	蹴倒さ
噛みくだく	噛みくだか
まなぶ	まなば
あおばむ	あおばま
攻め懸ける	攻め懸け
研ぎ澄ます	研ぎ澄まさ
訛る	訛ら
おがめる	おがめ
吊りあがる	吊りあがら
履き違える	履き違え
封じこめる	封じこめ
ねめる	ねめ
魘われる	魘われ
押し付ける	押し付け
散残る	散残ら
書き古す	書き古さ
抜きとる	抜きとら
わき起こせる	わき起こせ
絞り出せる	絞り出せ
逃げ出せる	逃げ出せ
うかれでる	うかれで
相次ぐ	相次が
差付ける	差付け
聞取る	聞取ら
どうける	どうけ
被れる	被れ
とり入れる	とり入れ
飛び乗る	飛び乗ら
乗捨てる	乗捨て
うけつげる	うけつげ
しぼりだせる	しぼりだせ
刺し殺す	刺し殺さ
追いちらす	追いちらさ
かいいれる	かいいれ
とりみだす	とりみださ
おもほす	おもほさ
すぼまる	すぼまら
殴り飛ばす	殴り飛ばさ
思い知らせる	思い知らせ
甘える	甘え
きりかかる	きりかから
坐す	坐さ
おもいあわせる	おもいあわせ
ぎしきばる	ぎしきばら
取りつぐ	取りつが
延ばす	延ばさ
報える	報え
うまれかわれる	うまれかわれ
組み直せる	組み直せ
うりさばける	うりさばけ
うりつくす	うりつくさ
仕分ける	仕分け
こだわる	こだわら
崇める	崇め
味わう	味わわ
ふりはなす	ふりはなさ
しゃちほこばる	しゃちほこばら
ぶっ飛ばす	ぶっ飛ばさ
おぼえこむ	おぼえこま
痺れる	痺れ
なぎ払う	なぎ払わ
保つ	保た
抱き上げる	抱き上げ
紡ぐ	紡が
切返す	切返さ
しかりつける	しかりつけ
ひあがる	ひあがら
へがす	へがさ
戦がす	戦がさ
煌めく	煌めか
見当たる	見当たら
雑ざる	雑ざら
うごめく	うごめか
見込める	見込め
飛廻る	飛廻ら
引っ張れる	引っ張れ
飲み明かす	飲み明かさ
負かせる	負かせ
張りつめる	張りつめ
検する	検し
打ち込む	打ち込ま
のせる	のせ
うなづける	うなづけ
もらう	もらわ
請け合う	請け合わ
考え付く	考え付か
成すます	成すまさ
はべる	はべら
挑める	挑め
みちゆく	みちゆか
はね返す	はね返さ
繰り越せる	繰り越せ
即する	即し
さっきだつ	さっきだた
触れまわる	触れまわら
押し流す	押し流さ
碾く	碾か
隠し持つ	隠し持た
詰め込める	詰め込め
追い付ける	追い付け
まくる	まくら
欺く	欺か
うだる	うだら
取上せる	取上せ
摺れる	摺れ
あずかれる	あずかれ
アテる	アテ
けあげる	けあげ
ふりほどく	ふりほどか
張れる	張れ
たる	たら
だましこむ	だましこま
頼み入る	頼み入ら
取りつくろう	取りつくろわ
かいうける	かいうけ
きりきざむ	きりきざま
はぎ合せる	はぎ合せ
かえる	かえ
引絞る	引絞ら
曲りくねる	曲りくねら
養う	養わ
笑割れる	笑割れ
走り出す	走り出さ
取廻す	取廻さ
にくめる	にくめ
打続く	打続か
うるむ	うるま
めしとる	めしとら
漕ぐ	漕が
担わす	担わさ
めしだす	めしださ
厭う	厭わ
泣き伏せる	泣き伏せ
たぎつ	たぎた
なれあう	なれあわ
しみる	しみ
みつけだす	みつけださ
仰れる	仰れ
しみとおる	しみとおら
こげつかす	こげつかさ
おもいもうける	おもいもうけ
断ち切れる	断ち切れ
取決める	取決め
ぬぐい去れる	ぬぐい去れ
やって来る	やって来
あいせる	あいせ
つっ走る	つっ走ら
おとしめる	おとしめ
開け払う	開け払わ
関連付ける	関連付け
誇れる	誇れ
かいす	かいさ
踏んづける	踏んづけ
動き回る	動き回ら
炒める	炒め
になえる	になえ
がめる	がめら
受け止める	受け止め
消す	消さ
擡げる	擡げ
うりこむ	うりこま
よみふける	よみふけら
差しかえる	差しかえ
擂りつぶす	擂りつぶさ
ゆする	ゆすら
見積もる	見積もら
めいじる	めいじ
もちまわれる	もちまわれ
てりつける	てりつけ
かきだせる	かきだせ
容体ぶる	容体ぶら
立ち入れる	立ち入れ
待ち侘びる	待ち侘び
捜し出せる	捜し出せ
申し込める	申し込め
取直す	取直さ
かたりあえる	かたりあえ
振捨てる	振捨て
のりあわす	のりあわさ
いななく	いななか
しそこなう	しそこなわ
招く	招か
つき合える	つき合え
曲げる	曲げ
すり寄る	すり寄ら
語り明かせる	語り明かせ
苛める	苛め
通う	通わ
巻込む	巻込ま
暖める	暖め
まちあぐむ	まちあぐま
いかりくるう	いかりくるわ
組む	組ま
殴る	殴ら
たちかかる	たちかから
たなびく	たなびか
差し越す	差し越さ
さしころせる	さしころせ
まぎらかす	まぎらかさ
冷ませる	冷ませ
しくめる	しくめ
引き延ばせる	引き延ばせ
つかみかかる	つかみかから
付従う	付従わ
わかがえれる	わかがえれ
ふりすてる	ふりすて
ひかす	ひかさ
たちゆく	たちゆか
悄気込む	悄気込ま
引きあげる	引きあげ
引っ繰り返す	引っ繰り返さ
取り纏める	取り纏め
うかびあがる	うかびあがら
照り映える	照り映え
きく	きか
飛び越える	飛び越え
つけこむ	つけこま
そめかえす	そめかえさ
かちとれる	かちとれ
慢ずる	慢ぜ
打ちあける	打ちあけ
さそいあわせる	さそいあわせ
ききながす	ききながさ
かざれる	かざれ
まける	まけ
かきみだす	かきみださ
いせる	いせ
脅かす	脅かさ
やすむ	やすま
溶け込む	溶け込ま
済ます	済まさ
いきつく	いきつか
見当る	見当ら
崩れさる	崩れさら
くいきる	くいきら
じんどる	じんどら
かんがえこむ	かんがえこま
よこたえる	よこたえ
居並ぶ	居並ば
見過ごす	見過ごさ
持ち掛ける	持ち掛け
あとづける	あとづけ
想う	想わ
勧める	勧め
つのめだつ	つのめだた
画く	画か
かえりざく	かえりざか
やってのける	やってのけ
のみつぶす	のみつぶさ
打抜く	打抜か
参ずる	参ぜ
かきふるす	かきふるさ
たむける	たむけ
旅立つ	旅立た
フッカケる	フッカケ
御する	御し
踏む	踏ま
あわれがる	あわれがら
移り変わる	移り変わら
たげる	たげ
打ち寄せる	打ち寄せ
寝静まる	寝静まら
さきんずる	さきんぜ
うかぶ	うかば
しょぼぬれる	しょぼぬれ
ゆきくれる	ゆきくれ
おける	おけ
組みたてる	組みたて
押し詰める	押し詰め
駆りたてる	駆りたて
押しまくる	押しまくら
ぶち込む	ぶち込ま
すべりおちる	すべりおち
抜かわる	抜かわら
いなす	いなさ
総毛立つ	総毛立た
裏返せる	裏返せ
かす	かさ
はりつける	はりつけ
みはからう	みはからわ
めがける	めがけ
流れ出す	流れ出さ
もてあつかう	もてあつかわ
経つ	経た
眩く	眩か
うねる	うねら
くちずさむ	くちずさま
どなりつける	どなりつけ
湧き出る	湧き出
いいつける	いいつけ
つれ去る	つれ去ら
引き合う	引き合わ
よりつく	よりつか
奪い合う	奪い合わ
終える	終え
潤す	潤さ
食う	食わ
旧びる	旧び
切下げる	切下げ
いきおいこむ	いきおいこま
くる	こ
なじむ	なじま
ふるいたつ	ふるいたた
責立てる	責立て
しるす	しるさ
連れ合う	連れ合わ
引っぱたく	引っぱたか
建て直す	建て直さ
とりかたづける	とりかたづけ
押しつける	押しつけ
足す	足さ
行き着ける	行き着け
わかる	わから
愛する	愛し
いばえる	いばえ
粧う	粧わ
おくりだせる	おくりだせ
説ける	説け
ながれつける	ながれつけ
せり出す	せり出さ
芽だつ	芽だた
鑑みる	鑑み
たちいれる	たちいれ
突き立てる	突き立て
めり込む	めり込ま
言い張る	言い張ら
くくる	くくら
ついばむ	ついばま
かろしめる	かろしめ
引離す	引離さ
しだく	しだか
つくる	つくら
懸隔たる	懸隔たら
うわむける	うわむけ
乗後れる	乗後れ
泣きはらす	泣きはらさ
立ちふさがる	立ちふさがら
わがねる	わがね
取離す	取離さ
ねじ上げる	ねじ上げ
うずく	うずか
取り壊す	取り壊さ
でなおす	でなおさ
あてこする	あてこすら
つげる	つげ
光る	光ら
くされる	くされ
くぐれる	くぐれ
押し退ける	押し退け
くどく	くどか
のぼせあがる	のぼせあがら
死ねる	死ね
ながれる	ながれ
落ちのびる	落ちのび
おしたおす	おしたおさ
継ぐ	継が
勤める	勤め
詰む	詰ま
こらえる	こらえ
連れ込める	連れ込め
蒸せる	蒸せ
依る	依ら
したしめる	したしめ
要する	要し
粟立つ	粟立た
使いこなす	使いこなさ
物慣れる	物慣れ
かちすすめる	かちすすめ
よびもどす	よびもどさ
みだせる	みだせ
捩じくれる	捩じくれ
取りもつ	取りもた
かけあわす	かけあわさ
しにかわる	しにかわら
終わらす	終わらさ
見い出す	見い出さ
伐る	伐ら
うみおとす	うみおとさ
ほうじる	ほうじ
泡立てる	泡立て
誉める	誉め
ながしこめる	ながしこめ
伏し拝む	伏し拝ま
取り結ぶ	取り結ば
のりくむ	のりくま
企む	企ま
独りごつ	独りごた
とりけせる	とりけせ
調子付く	調子付か
縫える	縫え
なくす	なくさ
からみつく	からみつか
愚図る	愚図ら
持ち込める	持ち込め
しょっぴく	しょっぴか
尖らす	尖らさ
送れる	送れ
吹きとばす	吹きとばさ
撫でる	撫で
差せる	差せ
潜む	潜ま
おしうつる	おしうつら
質す	質さ
付ける	付け
取り回す	取り回さ
みはらせる	みはらせ
勝ち進む	勝ち進ま
ふるえあがる	ふるえあがら
見下す	見下さ
伸べる	伸べ
取り揃う	取り揃わ
うちしずむ	うちしずま
をろがむ	をろがま
ぬきんでる	ぬきんで
一皮むく	一皮むか
ふうじこむ	ふうじこま
抱きつく	抱きつか
混ぜ合わせる	混ぜ合わせ
荒らせる	荒らせ
おわす	おわさ
なぐさむ	なぐさま
伏し沈む	伏し沈ま
失ふ	失は
追い払う	追い払わ
かぎわける	かぎわけ
凭れる	凭れ
歓べる	歓べ
つれる	つれ
持ち回れる	持ち回れ
はくす	はくさ
規則立つ	規則立た
ねじける	ねじけ
りゃくせる	りゃくせ
摸する	摸し
泊まれる	泊まれ
とりこす	とりこさ
つらねる	つらね
付け足せる	付け足せ
待合せる	待合せ
立て直す	立て直さ
あらえる	あらえ
入れかえる	入れかえ
ビビる	ビビら
祷る	祷ら
みおとす	みおとさ
くう	くわ
かいこす	かいこさ
結びつく	結びつか
与える	与え
得る	与え
撃止める	撃止め
増せる	増せ
溶く	溶か
逃げ延びる	逃げ延び
ねがいでる	ねがいで
勝れる	勝れ
うらぎる	うらぎら
きょうずる	きょうぜ
ひきまわす	ひきまわさ
だらける	だらけ
和む	和ま
くらす	くらさ
つっ切る	つっ切ら
きりむすぶ	きりむすば
追い抜く	追い抜か
うるおう	うるおわ
つかる	つから
そんずる	そんぜ
くみ出す	くみ出さ
なり変わる	なり変わら
うかびでる	うかびで
くみたてる	くみたて
差し入れる	差し入れ
つかまる	つかまら
歪む	歪ま
抜かす	抜かさ
干からびる	干からび
扠措く	扠措か
寝忘れる	寝忘れ
旅立てる	旅立て
崩せる	崩せ
引き合せる	引き合せ
えがける	えがけ
類える	類え
継ぎ合せる	継ぎ合せ
突っ返せる	突っ返せ
うみつける	うみつけ
ねだる	ねだら
打合う	打合わ
飛び降りる	飛び降り
ぬるむ	ぬるま
ほっする	ほっし
噛み分ける	噛み分け
置き忘れる	置き忘れ
もみ消す	もみ消さ
尋め行く	尋め行か
かっとばす	かっとばさ
かつぎこめる	かつぎこめ
釣り上げる	釣り上げ
取り込める	取り込め
逆上せる	逆上せ
おしわける	おしわけ
打ち取る	打ち取ら
引きずり回せる	引きずり回せ
後れる	後れ
住み替える	住み替え
成り下がる	成り下がら
せかせる	せかせ
責め付ける	責め付け
差し回す	差し回さ
いいかえす	いいかえさ
減らす	減らさ
あてる	あて
しらちゃける	しらちゃけ
とけこめる	とけこめ
さく	さか
ねとつく	ねとつか
飾り付ける	飾り付け
生み出せる	生み出せ
切羽詰る	切羽詰ら
きりさく	きりさか
すりむける	すりむけ
ばける	ばけ
居残る	居残ら
せいする	せいし
こみあげる	こみあげ
たぶ	たば
引き下ろせる	引き下ろせ
偲ぶ	偲ば
張り倒す	張り倒さ
おかせる	おかせ
肥る	肥ら
引裂く	引裂か
染み透る	染み透ら
騰がる	騰がら
散り残る	散り残ら
梳く	梳か
綴り合せる	綴り合せ
うりなやむ	うりなやま
賄う	賄わ
ふきこむ	ふきこま
賭ける	賭け
事足る	事足ら
ころげる	ころげ
ポシャる	ポシャら
飛びだす	飛びださ
明け払う	明け払わ
噛みころす	噛みころさ
ねとる	ねとら
ズレ込む	ズレ込ま
成す	成さ
覚え込む	覚え込ま
おくりだす	おくりださ
運び込める	運び込め
はぎ合わす	はぎ合わさ
はらえる	はらえ
立ちのぼる	立ちのぼら
咽ぶ	咽ば
さしきる	さしきら
慶ぶ	慶ば
張回す	張回さ
根差す	根差さ
辷る	辷ら
もうしつける	もうしつけ
立合う	立合わ
思い出せる	思い出せ
読み分ける	読み分け
くらう	くらわ
うねりくねる	うねりくねら
泣崩れる	泣崩れ
蝕む	蝕ま
たくす	たくさ
とどまる	とどまら
やせほそる	やせほそら
打込める	打込め
もうしうける	もうしうけ
だしあう	だしあわ
うちあげる	うちあげ
押し出す	押し出さ
いどむ	いどま
拉げる	拉げ
がいす	がいさ
見おろす	見おろさ
切り払う	切り払わ
ひんまがる	ひんまがら
打付ける	打付け
投げ込む	投げ込ま
ねつく	ねつか
乗り掛る	乗り掛ら
踏みならせる	踏みならせ
さえぎる	さえぎら
いやまさる	いやまさら
ようだてる	ようだて
波うつ	波うた
差し掛ける	差し掛け
詰切る	詰切ら
はりとばす	はりとばさ
出かける	出かけ
すぐる	すぐら
頑張る	頑張ら
織りなす	織りなさ
生延びる	生延び
スレ違う	スレ違わ
投げ飛ばす	投げ飛ばさ
おごる	おごら
せきいる	せきいら
判じる	判じ
さしまわせる	さしまわせ
だきおこす	だきおこさ
勝ち誇る	勝ち誇ら
押隠す	押隠さ
へこたれる	へこたれ
でばる	でばら
脱す	脱さ
生きながらえる	生きながらえ
戦慄く	戦慄か
すたれる	すたれ
張り上げる	張り上げ
よみこなせる	よみこなせ
待ちかねる	待ちかね
ほうる	ほうら
ろくする	ろくし
くわれる	くわれ
すすり上げる	すすり上げ
担う	担わ
まかなう	まかなわ
騰る	騰ら
さからえる	さからえ
はせまわる	はせまわら
読む	読ま
受け入れる	受け入れ
引き連れる	引き連れ
儲ける	儲け
ハマる	ハマら
もちこす	もちこさ
押し上げる	押し上げ
召上がる	召上がら
割込む	割込ま
くりだせる	くりだせ
もつれ込む	もつれ込ま
こまりはてる	こまりはて
立てかける	立てかけ
いきかえれる	いきかえれ
こぎ着く	こぎ着か
立去る	立去ら
りっする	りっし
取り上げる	取り上げ
ひれ伏す	ひれ伏さ
思い知る	思い知ら
下掛る	下掛ら
差迫る	差迫ら
くみかえる	くみかえ
差し合う	差し合わ
出立つ	出立た
ひもとく	ひもとか
うずくまる	うずくまら
温む	温ま
あけはなせる	あけはなせ
洒落る	洒落
こそぐる	こそぐら
はばむ	はばま
積み出せる	積み出せ
くいのばす	くいのばさ
なずらえる	なずらえ
乗り込める	乗り込め
しねる	しね
押し流せる	押し流せ
雇う	雇わ
模する	模し
嘆く	嘆か
しぐれる	しぐれ
したう	したわ
投げ飛ばせる	投げ飛ばせ
起きる	起き
切払う	切払わ
やけだす	やけださ
ふき取る	ふき取ら
知れ渡る	知れ渡ら
訳す	訳さ
住み込む	住み込ま
荒れる	荒れ
こごむ	こごま
まつりあげる	まつりあげ
休する	休し
あらわす	あらわさ
智慧づく	智慧づか
生い茂る	生い茂ら
垂れ篭める	垂れ篭め
翔ぶ	翔ば
あみあげる	あみあげ
なまける	なまけ
取り切れる	取り切れ
もり立てる	もり立て
飲みほす	飲みほさ
まきこむ	まきこま
纏う	纏わ
乗り回せる	乗り回せ
すすりあげる	すすりあげ
助け合える	助け合え
ものもうす	ものもうさ
すてさる	すてさら
免じる	免じ
うけだせる	うけだせ
和解し合う	和解し合わ
とりくめる	とりくめ
受け持つ	受け持た
振りほどく	振りほどか
卒する	卒し
つづりあわす	つづりあわさ
一皮剥ける	一皮剥け
先駆ける	先駆け
えらびだす	えらびださ
うちすえる	うちすえ
使い込む	使い込ま
さまたげる	さまたげ
すたる	すたら
書する	書し
不貞てる	不貞て
とびこめる	とびこめ
見蕩れる	見蕩れ
慥かめる	慥かめ
つまみ上げる	つまみ上げ
のます	のまさ
涸らす	涸らさ
撰する	撰し
寝かしつける	寝かしつけ
歩きつめる	歩きつめら
診る	診
ぬいこむ	ぬいこま
きりこむ	きりこま
膨らます	膨らまさ
ちゃう	ちゃわ
宿る	宿ら
取りかかる	取りかから
巻き返せる	巻き返せ
すり込む	すり込ま
追回す	追回さ
登れる	登れ
差し立てる	差し立て
打ち勝てる	打ち勝て
ふきぬける	ふきぬけ
切回す	切回さ
うつす	うつさ
つみだせる	つみだせ
切合う	切合わ
はいする	はいし
裏切る	裏切ら
かいきれる	かいきれ
埋め込む	埋め込ま
取りあわせる	取りあわせ
閉め出す	閉め出さ
出来合う	出来合わ
騒がせる	騒がせ
ほどこす	ほどこさ
習わせる	習わせ
ぬけだす	ぬけださ
追越す	追越さ
ばらつく	ばらつか
ばてる	ばて
傷付ける	傷付け
うちやぶれる	うちやぶれ
ふきわける	ふきわけ
棲む	棲ま
頻る	頻ら
きそう	きそわ
ねじ込む	ねじ込ま
たてこむ	たてこま
いく	いか
ひずむ	ひずま
取り置く	取り置か
はしゃぐ	はしゃが
とう	とわ
どかす	どかさ
あらわれる	あらわれ
かりうける	かりうけ
繰り寄せる	繰り寄せ
まくれる	まくれ
とりちらす	とりちらさ
ものなれる	ものなれ
角ぐむ	角ぐま
思いまどう	思いまどわ
押し隠す	押し隠さ
あらそう	あらそわ
取っ付く	取っ付か
血迷う	血迷わ
だする	だし
絡げる	絡げ
言い合せる	言い合せ
かかげる	かかげ
おいかえせる	おいかえせ
かつぎ込む	かつぎ込ま
切替える	切替え
軋む	軋ま
切り捲る	切り捲ら
綻ばす	綻ばさ
しのびなく	しのびなか
つくりだせる	つくりだせ
ひきしぼれる	ひきしぼれ
乗回す	乗回さ
かんじとる	かんじとら
控える	控え
わりびく	わりびか
呼びいれる	呼びいれ
切伏せる	切伏せ
掻きたてる	掻きたて
煮えたつ	煮えたた
補い合う	補い合わ
住み着ける	住み着け
寝付く	寝付か
念じる	念じ
きりまわせる	きりまわせ
吹っ切る	吹っ切ら
甘ったれる	甘ったれ
勝ち残る	勝ち残ら
慌てる	慌て
癒せる	癒せ
乗組む	乗組ま
咳き上げる	咳き上げ
つきとめる	つきとめ
潰れる	潰れ
わりだせる	わりだせ
博す	博さ
組み入れる	組み入れ
かしぐ	かしが
やり過ごせる	やり過ごせ
崩ずる	崩ぜ
言いおく	言いおか
有り余る	有り余ら
わらいとばす	わらいとばさ
逃がす	逃がさ
まちがう	まちがわ
ねじきる	ねじきら
神しずまる	神しずまら
やとえる	やとえ
切り伏せる	切り伏せ
滲む	滲ま
あせる	あせ
ひょうする	ひょうし
吸取る	吸取ら
よじのぼる	よじのぼら
殖やせる	殖やせ
ちんずる	ちんぜ
またげる	またげ
繰回す	繰回さ
笑わせる	笑わせ
ふりしぼる	ふりしぼら
かつぎあげる	かつぎあげ
使い切る	使い切ら
脅す	脅さ
歩き疲れる	歩き疲れ
かたよる	かたよら
裂ける	裂け
帰す	帰さ
かみ合う	かみ合わ
分る	分ら
戦える	戦え
切りつめる	切りつめ
言い表せる	言い表せ
啼く	啼か
たたむ	たたま
おこたる	おこたら
せめる	せめ
もちなおす	もちなおさ
譲り渡せる	譲り渡せ
よみする	よみし
彌増さる	彌増さら
やむ	やま
長ける	長け
おとせる	おとせ
きがまえる	きがまえ
乗越す	乗越さ
見渡せる	見渡せ
かくしもてる	かくしもて
かんがえる	かんがえ
うたがう	うたがわ
損する	損し
うめく	うめか
くらいつく	くらいつか
返せる	返せ
すっこむ	すっこま
運べる	運べ
まわる	まわら
おとる	おとら
萌え出る	萌え出
晴渡る	晴渡ら
果てる	果て
録する	録し
移せる	移せ
悄気げる	悄気げ
言い返せる	言い返せ
ぎんずる	ぎんぜ
止る	止ら
みさげる	みさげ
阻む	阻ま
来なさる	来なさら
折重なる	折重なら
ふっ飛ぶ	ふっ飛ば
通がる	通がら
てまどる	てまどら
しにはてる	しにはて
向かい合わす	向かい合わさ
当てはめる	当てはめ
とびこせる	とびこせ
ためる	ため
なきふす	なきふさ
さらう	さらわ
ぬりたてる	ぬりたて
かたりあかせる	かたりあかせ
接ぎ合せる	接ぎ合せ
とりだせる	とりだせ
募る	募ら
ひっこぬく	ひっこぬか
つけ足す	つけ足さ
見通せる	見通せ
みあきる	みあき
思いあまる	思いあまら
追う	追わ
もれきく	もれきか
ふゆごもる	ふゆごもら
飛び歩く	飛び歩か
刷り込む	刷り込ま
くいつめる	くいつめ
くぐる	くぐら
いいきる	いいきら
かき合せる	かき合せ
荒立てる	荒立て
閲する	閲し
焦げつかす	焦げつかさ
のりまわせる	のりまわせ
隠す	隠さ
そだつ	そだた
被える	被え
でる	で
殴れる	殴れ
洩れる	洩れ
いびりだす	いびりださ
しがみつく	しがみつか
いただく	いただか
打見る	打見
討取る	討取ら
誤る	誤ら
受流す	受流さ
責め立てる	責め立て
尋ねる	尋ね
かびる	かび
ほおばる	ほおばら
射抜く	射抜か
啄む	啄ま
よりすがる	よりすがら
浸ける	浸け
撃ち破れる	撃ち破れ
突合せる	突合せ
謡う	謡わ
立ち篭める	立ち篭め
のりだす	のりださ
立ちつくす	立ちつくさ
吹き分ける	吹き分け
香る	香ら
せめあぐむ	せめあぐま
払い戻せる	払い戻せ
さしかざす	さしかざさ
ひっぱる	ひっぱら
似つく	似つか
用いる	用い
とりさげる	とりさげ
取り混ぜる	取り混ぜ
ほだされる	ほだされ
いきつける	いきつけ
目指す	目指さ
立ち直れる	立ち直れ
惑う	惑わ
てつだえる	てつだえ
きりたおせる	きりたおせ
ならう	ならわ
拝める	拝め
落ちこむ	落ちこま
かつ	かた
ねらう	ねらわ
焙る	焙ら
としとる	としとら
犇めく	犇めか
ごろつく	ごろつか
翻せる	翻せ
くずす	くずさ
扱える	扱え
哭く	哭か
とびでる	とびで
書き留める	書き留め
悩む	悩ま
のがれる	のがれ
突き刺さる	突き刺さら
役だつ	役だた
とげる	とげ
勝る	勝ら
ぶった切る	ぶった切ら
読み解く	読み解か
惹く	惹か
きらす	きらさ
穿つ	穿た
巻き付ける	巻き付け
るいする	るいし
うけあえる	うけあえ
差し響く	差し響か
ふみつける	ふみつけ
ならわせる	ならわせ
りゃくする	りゃくし
へせる	へせ
通いつめる	通いつめ
なげく	なげか
みつぐ	みつが
かがす	かがさ
伸し歩く	伸し歩か
くばれる	くばれ
縛り付ける	縛り付け
みすえる	みすえ
暮らす	暮らさ
持ちこむ	持ちこま
掛かる	掛から
掻い繕う	掻い繕わ
噎せ返る	噎せ返ら
混じる	混じら
付きまとう	付きまとわ
しんじこめる	しんじこめ
ゆであがる	ゆであがら
寇する	寇し
振りだす	振りださ
にごらせる	にごらせ
取繕う	取繕わ
みくだせる	みくだせ
巻き起こす	巻き起こさ
せり合う	せり合わ
こいしたう	こいしたわ
焼付ける	焼付け
ほとびる	ほとび
怨む	怨ま
はじまる	はじまら
取り直せる	取り直せ
飽かす	飽かさ
おしいれる	おしいれ
まぎれる	まぎれ
かぶりつく	かぶりつか
あつまる	あつまら
にげまどう	にげまどわ
誤らせる	誤らせ
生き抜く	生き抜か
急がす	急がさ
煽る	煽ら
ひねくれる	ひねくれ
とめゆく	とめゆか
働き掛ける	働き掛け
やきなます	やきなまさ
引きずり回す	引きずり回さ
ゆれうごく	ゆれうごか
伸し掛る	伸し掛ら
消える	消え
習う	習わ
振掛ける	振掛け
おぼめく	おぼめか
もうしおくれる	もうしおくれ
しゃぶりつく	しゃぶりつか
浮出す	浮出さ
喚く	喚か
染みとおる	染みとおら
標す	標さ
奪える	奪え
縁付く	縁付か
歩み寄れる	歩み寄れ
たいす	たいさ
だまかす	だまかさ
湧く	湧か
コケる	コケ
ひっ付く	ひっ付か
思いつく	思いつか
焚ける	焚け
溺れる	溺れ
はかなむ	はかなま
きりはらえる	きりはらえ
みまわす	みまわさ
巣ごもる	巣ごもら
そびやかす	そびやかさ
きずつける	きずつけ
傷つける	傷つけ
のっとれる	のっとれ
えつにいる	えつにいら
はらだつ	はらだた
預かれる	預かれ
たる	たら
煎じる	煎じ
毀れる	毀れ
おいさらばえる	おいさらばえ
おれあう	おれあわ
つき刺さる	つき刺さら
笑われる	笑われ
かき回す	かき回さ
かみあわす	かみあわさ
たかる	たから
はたらかす	はたらかさ
織りまぜる	織りまぜ
縁る	縁ら
取りすがる	取りすがら
うっちゃらかす	うっちゃらかさ
表わす	表わさ
型どる	型どら
乗り越せる	乗り越せ
作り直す	作り直さ
さしちがえる	さしちがえ
浮き上がる	浮き上がら
かけはなれる	かけはなれ
眺める	眺め
見離す	見離さ
説き明かす	説き明かさ
すっぽかす	すっぽかさ
いなむ	いなま
てく	てか
とうずる	とうぜ
連れ込む	連れ込ま
漉す	漉さ
持ち回る	持ち回ら
しとげる	しとげ
かき混ぜる	かき混ぜ
差し掛かる	差し掛から
取り散らす	取り散らさ
癒える	癒え
晴れ上がる	晴れ上がら
失する	失し
つぎこむ	つぎこま
言い漏らす	言い漏らさ
おぼす	おぼさ
バレる	バレ
ほそる	ほそら
とまどう	とまどわ
ゆる	ゆら
こさえる	こさえ
鬻ぐ	鬻が
めざす	めざさ
蕾む	蕾ま
ぬがす	ぬがさ
しゃがめる	しゃがめ
追い詰める	追い詰め
押し通せる	押し通せ
戸惑う	戸惑わ
とりはずせる	とりはずせ
そむく	そむか
浮かす	浮かさ
選びとれる	選びとれ
からむ	からま
銘打つ	銘打た
振るえる	振るえ
心得る	心得
混じる	混じ
付け足す	付け足さ
立ちこめる	立ちこめ
跳ぶ	跳ば
引抜く	引抜か
出向ける	出向け
差つかえる	差つかえ
わたりあるく	わたりあるか
つぶる	つぶら
打捨てる	打捨て
申しかねる	申しかね
速める	速め
賜わる	賜わら
怒らす	怒らさ
なだめる	なだめ
きどる	きどら
追い散らす	追い散らさ
知る	知ら
かかれる	かかれ
かいもどせる	かいもどせ
笑わす	笑わさ
振舞う	振舞わ
うりまくる	うりまくら
きぶくれる	きぶくれ
借る	借ら
呼び込む	呼び込ま
蹴違える	蹴違え
そくす	そくさ
いましめる	いましめ
さそいあわす	さそいあわさ
ふるい落とせる	ふるい落とせ
扱く	扱か
平伏す	平伏さ
あぶらぎる	あぶらぎら
わりだす	わりださ
突っ放す	突っ放さ
へだてる	へだて
なりさがれる	なりさがれ
呼掛ける	呼掛け
点く	点か
せきこむ	せきこま
かくばる	かくばら
涙ぐむ	涙ぐま
画する	画し
つまむ	つまま
靠れる	靠れ
つかえる	つかえ
にぎりしめる	にぎりしめ
小戻す	小戻さ
減ずる	減ぜ
にぎやかす	にぎやかさ
ぶら下がる	ぶら下がら
売りさばける	売りさばけ
さておく	さておか
伸び上がる	伸び上がら
よびつづける	よびつづけ
託つ	託た
たずさえる	たずさえ
つき合せる	つき合せ
吊り上がる	吊り上がら
出廻る	出廻ら
かき消える	かき消え
したたらす	したたらさ
すがめる	すがめ
ことづかる	ことづから
見通す	見通さ
はがせる	はがせ
手慣れる	手慣れ
聞き分ける	聞き分け
きあわす	きあわさ
しりあえる	しりあえ
見破る	見破ら
反る	反ら
しぼむ	しぼま
才走る	才走ら
形作る	形作ら
片付ける	片付け
くる	こ
いあわせる	いあわせ
引っ被る	引っ被ら
噛み合せる	噛み合せ
振りさけみる	振りさけみ
見回す	見回さ
あおむく	あおむか
すだく	すだか
えんする	えんし
結え付ける	結え付け
病む	病ま
膨らむ	膨らま
追いまくる	追いまくら
捲揚げる	捲揚げ
引き返す	引き返さ
寝ころべる	寝ころべ
擦り剥ける	擦り剥け
出つくす	出つくさ
思い設ける	思い設け
しめせる	しめせ
終える	終え
落とし込める	落とし込め
呼寄せる	呼寄せ
いきのびる	いきのび
施せる	施せ
たもつ	たもた
立てこもれる	立てこもれ
ふんづける	ふんづけ
こわす	こわさ
嵩張る	嵩張ら
区切れる	区切れ
押し込む	押し込ま
あらいながす	あらいながさ
おびき出せる	おびき出せ
とけ込む	とけ込ま
持ち寄る	持ち寄ら
もちあるく	もちあるか
振絞る	振絞ら
しりあう	しりあわ
とまりこむ	とまりこま
談ずる	談ぜ
かてる	かて
焦がす	焦がさ
思える	思え
たどり着ける	たどり着け
ひきあわせる	ひきあわせ
泊り込む	泊り込ま
追いはらう	追いはらわ
目ざす	目ざさ
割り切れる	割り切れ
科する	科し
みはなす	みはなさ
しむける	しむけ
ねじ伏せる	ねじ伏せ
かえりみる	かえりみ
引き回す	引き回さ
しく	しか
かする	かすら
みちびく	みちびか
載っかる	載っから
ほめる	ほめ
さきのこる	さきのこら
悩ます	悩まさ
世慣れる	世慣れ
にらみ合う	にらみ合わ
だぶつく	だぶつか
住み成す	住み成さ
わく	わか
垣間見る	垣間見
かくせる	かくせ
論る	論ら
あたう	あたわ
かけ込む	かけ込ま
融かす	融かさ
簸る	簸
きあわせる	きあわせ
わりつける	わりつけ
つきあわす	つきあわさ
ひきあう	ひきあわ
まわせる	まわせ
切裂く	切裂か
たくましゅうする	たくましゅうし
かきのこす	かきのこさ
浮く	浮か
いじめる	いじめ
食らえる	食らえ
飛び下りる	飛び下り
踏み止まる	踏み止まら
囲う	囲わ
なきくずれる	なきくずれ
賣る	賣ら
掛け合せる	掛け合せ
射し込む	射し込ま
御座る	御座ら
さしあげる	さしあげ
ふるいおこす	ふるいおこさ
しょぼたれる	しょぼたれ
ちょろまかす	ちょろまかさ
使いこなせる	使いこなせ
もえうつる	もえうつら
いいつかる	いいつから
はねのける	はねのけ
焼払う	焼払わ
楽しめる	楽しめ
たらし込む	たらし込ま
這いだす	這いださ
呼び続ける	呼び続け
あわ立つ	あわ立た
めす	めさ
句切る	句切ら
触れこむ	触れこま
いなおる	いなおら
分捕る	分捕ら
葺く	葺か
痩せる	痩せ
引き受ける	引き受け
寂れる	寂れ
たたき込む	たたき込ま
判る	判ら
暖まる	暖まら
漕ぎつける	漕ぎつけ
咲く	咲か
ほりこめる	ほりこめ
かみくだく	かみくだか
伸び上がれる	伸び上がれ
かいあさる	かいあさら
すが立つ	すが立た
いきせききる	いきせききら
もえつきる	もえつき
ひねりまわす	ひねりまわさ
おいこす	おいこさ
からげる	からげ
践む	践ま
割り込む	割り込ま
受け継ぐ	受け継が
思ひ寄る	思ひ寄ら
こじらす	こじらさ
おしもどす	おしもどさ
はじき返す	はじき返さ
冷やせる	冷やせ
まじる	まじら
きりおとす	きりおとさ
さらせる	さらせ
食い下がれる	食い下がれ
つくす	つくさ
時雨れる	時雨れ
座る	座ら
まねる	まね
済む	済ま
疎んずる	疎んぜ
すべりだす	すべりださ
霜枯れる	霜枯れ
かんじる	かんじ
えづく	えづか
煮立てる	煮立て
あびせかける	あびせかけ
もつれる	もつれ
押し遣る	押し遣ら
凍りつく	凍りつか
達っする	達っし
資する	資し
透かす	透かさ
濁る	濁ら
込み合う	込み合わ
えっする	えっし
絞り上げる	絞り上げ
擦り切る	擦り切ら
産す	産さ
仰げる	仰げ
まいくるう	まいくるわ
寄せ掛ける	寄せ掛け
陳ずる	陳ぜ
捲き込む	捲き込ま
うちとめる	うちとめ
ふすべる	ふすべ
得する	得し
ずり上がる	ずり上がら
踏まえる	踏まえ
まわれる	まわれ
いいけす	いいけさ
じゅんじる	じゅんじ
いてつく	いてつか
ちらす	ちらさ
遺す	遺さ
拱く	拱か
のめる	のめ
となりあわす	となりあわさ
ふみこえる	ふみこえ
誘ふ	誘は
まいあがる	まいあがら
打ちだせる	打ちだせ
蹴返す	蹴返さ
浴びせる	浴びせ
背く	背か
きめつける	きめつけ
暮す	暮さ
継る	継ら
問ただす	問たださ
つかわれだす	つかわれださ
なさる	なさら
連れあう	連れあわ
ぶんどる	ぶんどら
押詰める	押詰め
ちらかす	ちらかさ
おどしとる	おどしとら
ひっこせる	ひっこせ
介す	介さ
ぱさつく	ぱさつか
抜放つ	抜放た
取出す	取出さ
であえる	であえ
損なう	損なわ
ほどく	ほどか
刃向かえる	刃向かえ
苦しむ	苦しま
身ごもる	身ごもら
うすずく	うすずか
生れる	生れ
かきのこせる	かきのこせ
行きつく	行きつか
飛び違う	飛び違わ
むらす	むらさ
やにさがる	やにさがら
うたう	うたわ
見知る	見知ら
ききとれる	ききとれ
おいつく	おいつか
語らう	語らわ
武張る	武張ら
請じ入れる	請じ入れ
さきだてる	さきだて
あがなう	あがなわ
かけ合う	かけ合わ
さしころす	さしころさ
ほする	ほし
もがける	もがけ
尽くす	尽くさ
塗る	塗ら
引き取る	引き取ら
出る	出
手掛ける	手掛け
かいまみる	かいまみ
かたむく	かたむか
開きなおる	開きなおら
映ろう	映ろわ
にこむ	にこま
たちどまる	たちどまら
こいする	こいし
現す	現さ
すいつける	すいつけ
ひき殺す	ひき殺さ
いびる	いびら
引き退ける	引き退け
愛し合える	愛し合え
生る	生ら
ぬぐい去る	ぬぐい去ら
表れる	表れ
寄り添える	寄り添え
てばなせる	てばなせ
表す	表さ
動きだす	動きださ
せりあえる	せりあえ
おいあげる	おいあげ
いいおよぼす	いいおよぼさ
吼える	吼え
へんする	へんし
ひきかえせる	ひきかえせ
在りあわせる	在りあわせ
聞込む	聞込ま
よせる	よせ
ゆりうごかせる	ゆりうごかせ
むしゃぶりつく	むしゃぶりつか
にぎりつぶせる	にぎりつぶせ
おいはらえる	おいはらえ
見つかる	見つから
閃かす	閃かさ
浮き足立つ	浮き足立た
廃る	廃ら
振り向く	振り向か
書き表す	書き表さ
燃え尽きる	燃え尽き
生みつける	生みつけ
みつめる	みつめ
のぞき込む	のぞき込ま
交わる	交わら
思わす	思わさ
やる	やら
聴く	聴か
にる	に
つまる	つまら
上せる	上せ
たきしめる	たきしめ
げする	げし
うちきる	うちきら
触込む	触込ま
靡く	靡か
さしつかわす	さしつかわさ
遣りこなす	遣りこなさ
青みがかる	青みがから
攻め落す	攻め落さ
掻き混ぜる	掻き混ぜ
蹶る	蹶ら
せめつける	せめつけ
引き抜く	引き抜か
ふりおこす	ふりおこさ
仰向ける	仰向け
定義付ける	定義付け
染めわける	染めわけ
押し出せる	押し出せ
しす	しさ
うかれだす	うかれださ
申し立てる	申し立て
いだける	いだけ
好き好む	好き好ま
点ずる	点ぜ
枯らす	枯らさ
のびる	のび
綴り合す	綴り合さ
見紛う	見紛わ
澱む	澱ま
巣立てる	巣立て
知合う	知合わ
紐解ける	紐解け
わき起こす	わき起こさ
おもいおよぶ	おもいおよば
暮れる	暮れ
かんがえぬく	かんがえぬか
吐かす	吐かさ
俯く	俯か
空惚ける	空惚け
にげだす	にげださ
色めく	色めか
からめる	からめ
いう	いわ
だんずる	だんぜ
こびへつらう	こびへつらわ
読み込む	読み込ま
よじる	よじら
いたわる	いたわら
引合う	引合わ
行う	行わ
押し掛ける	押し掛け
捏ねる	捏ね
ひきわける	ひきわけ
分かれる	分かれ
習わす	習わさ
立のく	立のか
見やる	見やら
引き留める	引き留め
入り込める	入り込め
ひっくり返す	ひっくり返さ
べたつく	べたつか
のす	のさ
かきすてる	かきすて
こびり付く	こびり付か
うきあがる	うきあがら
吸い込む	吸い込ま
きよめる	きよめ
だいする	だいし
写せる	写せ
さめる	さめ
補う	補わ
起き上がれる	起き上がれ
とりこめる	とりこめ
攻める	攻め
待ち焦がれる	待ち焦がれ
にらみ合わす	にらみ合わさ
跡づける	跡づけ
よりたおせる	よりたおせ
わりきれる	わりきれ
報ずる	報ぜ
およぶ	およば
備わる	備わら
晴れ渡る	晴れ渡ら
とりはこべる	とりはこべ
つつみこむ	つつみこま
てわたせる	てわたせ
値切る	値切ら
干す	干さ
浮かび上がる	浮かび上がら
おくりかえす	おくりかえさ
ふっとぶ	ふっとば
張り合わす	張り合わさ
逃げる	逃げ
吹まくる	吹まくら
いいたてる	いいたて
行き届く	行き届か
罹る	罹ら
汚れる	汚れ
罷る	罷ら
立て掛ける	立て掛け
すむ	すま
ぎす	ぎさ
書散らす	書散らさ
涌かす	涌かさ
伝える	伝え
そえる	そえ
打ち消せる	打ち消せ
ずらかる	ずらから
やすらぐ	やすらが
はしりさる	はしりさら
乱せる	乱せ
うわまわる	うわまわら
剥く	剥か
巣くう	巣くわ
引きずる	引きずら
ゆでこぼす	ゆでこぼさ
押切る	押切ら
草生す	草生さ
撒ける	撒け
昂る	昂ら
ひきあわす	ひきあわさ
ぬう	ぬわ
うらがえる	うらがえら
受け流せる	受け流せ
たでる	たで
つつく	つつか
籠る	籠ら
余す	余さ
くれのこる	くれのこら
書き入れる	書き入れ
取りつける	取りつけ
飾れる	飾れ
まねきいれる	まねきいれ
買いためる	買いため
ぬぐい取る	ぬぐい取ら
焼け付く	焼け付か
衰える	衰え
げすばる	げすばら
言捨てる	言捨て
開け放つ	開け放た
躍り出る	躍り出
おぼらす	おぼらさ
ため込める	ため込め
竄する	竄し
ぬいあわせる	ぬいあわせ
しゃくれる	しゃくれ
かせげる	かせげ
素っ破抜く	素っ破抜か
突破る	突破ら
うつろう	うつろわ
もちこたえる	もちこたえ
見合せる	見合せ
なびかす	なびかさ
旧る	旧ら
行き暮す	行き暮さ
食い延す	食い延さ
行ける	行け
ごまかす	ごまかさ
でっち上げる	でっち上げ
ひびかす	ひびかさ
もたらす	もたらさ
置く	置か
聞き合わせる	聞き合わせ
さわげる	さわげ
勉める	勉め
ひびわれる	ひびわれ
競い立つ	競い立た
瞬く	瞬か
売飛ばす	売飛ばさ
かどわかす	かどわかさ
遷り変る	遷り変ら
ささる	ささら
たりる	たり
け落とせる	け落とせ
いきむ	いきま
攻め上る	攻め上ら
みれる	みれ
和する	和し
ふるい落す	ふるい落さ
あおのける	あおのけ
ひきぬける	ひきぬけ
みはれる	みはれ
為成す	為成さ
まきちらす	まきちらさ
ねじ合う	ねじ合わ
なやみぬく	なやみぬか
わたりあえる	わたりあえ
思い切る	思い切ら
できあう	できあわ
とろける	とろけ
迷う	迷わ
おぎなえる	おぎなえ
熾す	熾さ
高鳴る	高鳴ら
つかわす	つかわさ
立まじる	立まじら
渫う	渫わ
暮れ残る	暮れ残ら
穢す	穢さ
組合す	組合さ
膨らせる	膨らせ
反らす	反らさ
練り歩く	練り歩か
反っくり返る	反っくり返ら
使い古す	使い古さ
けなす	けなさ
措く	措か
踏みやぶる	踏みやぶら
殺気だつ	殺気だた
開く	開か
つけたす	つけたさ
ゆき過ぎる	ゆき過ぎ
刑する	刑し
おます	おまさ
すみつべる	すみつべ
付き添える	付き添え
うらやむ	うらやま
しばれる	しばれ
言い触らす	言い触らさ
委する	委し
燃やす	燃やさ
おしかえす	おしかえさ
はせ向う	はせ向わ
たどれる	たどれ
ねじる	ねじら
やせおとろえる	やせおとろえ
相うつ	相うた
いいくるめる	いいくるめ
さざめく	さざめか
連れ去る	連れ去ら
つらぬける	つらぬけ
熟す	熟さ
呼び出せる	呼び出せ
書き表せる	書き表せ
削げる	削げ
つとまる	つとまら
舐る	舐ら
涼める	涼め
隠し持てる	隠し持て
切りくずす	切りくずさ
眠り込む	眠り込ま
つきもどす	つきもどさ
打消せる	打消せ
激つ	激た
さる	さら
混ぜる	混ぜ
言い残す	言い残さ
雪崩込む	雪崩込ま
登りつめる	登りつめ
銘ずる	銘ぜ
ふせる	ふせ
みそなはす	みそなはさ
なきしきる	なきしきら
聞きおよぶ	聞きおよば
もどす	もどさ
苅る	苅ら
押し寄せる	押し寄せ
騒ぎ出す	騒ぎ出さ
思う	思わ
みくらべる	みくらべ
まわりこむ	まわりこま
曲がる	曲がら
てびかえる	てびかえ
含む	含ま
費える	費え
ずるける	ずるけ
ばたつかせる	ばたつかせ
能くする	能くし
捩じ上げる	捩じ上げ
くみかわす	くみかわさ
煤ける	煤け
入りかわる	入りかわら
見詰める	見詰め
仰せる	仰せ
ひきよせる	ひきよせ
うちかさなる	うちかさなら
獲る	獲
差し遣わす	差し遣わさ
温める	温め
吐き出せる	吐き出せ
問合せる	問合せ
満たせる	満たせ
すすり泣く	すすり泣か
ひっこもる	ひっこもら
うなだれる	うなだれ
振り切れる	振り切れ
味わえる	味わえ
摂る	摂ら
押しだす	押しださ
ふみこめる	ふみこめ
待ち受ける	待ち受け
事足りる	事足り
とりすがる	とりすがら
喰える	喰え
憾む	憾ま
こきまぜる	こきまぜ
済す	済さ
抜連ねる	抜連ね
入れ合せる	入れ合せ
天てらす	天てらさ
言い旧す	言い旧さ
秋めく	秋めか
払い下げる	払い下げ
禁ずる	禁ぜ
つりあう	つりあわ
あみ出す	あみ出さ
封じこむ	封じこま
ひっつく	ひっつか
なのりでる	なのりで
作り上げる	作り上げ
すみこむ	すみこま
持あがる	持あがら
吹すさぶ	吹すさば
ランクづける	ランクづけ
野次れる	野次れ
削り倒せる	削り倒せ
切あがる	切あがら
しゃがむ	しゃがま
突っ転ばす	突っ転ばさ
はしれる	はしれ
のぞける	のぞけ
取り抑える	取り抑え
奮いおこす	奮いおこさ
つるせる	つるせ
やすんずる	やすんぜ
充たす	充たさ
かけこむ	かけこま
捲ける	捲け
いたす	いたさ
積重なる	積重なら
言いだす	言いださ
燃え立つ	燃え立た
はきかける	はきかけ
引きしぼる	引きしぼら
経る	経
しでかす	しでかさ
交ぜっ返す	交ぜっ返さ
欠かす	欠かさ
きらめく	きらめか
綯い交ぜる	綯い交ぜ
恥づ	恥ぢ
はき出す	はき出さ
引っ提げる	引っ提げ
好く	好か
ぬく	ぬか
鋤き起す	鋤き起さ
みいだす	みいださ
撃ち込む	撃ち込ま
繰広げる	繰広げ
走りでる	走りで
もうしわたす	もうしわたさ
取り次ぐ	取り次が
座れる	座れ
夾める	夾め
ききすます	ききすまさ
紛らわす	紛らわさ
装束く	装束か
圧する	圧し
ハネ上がる	ハネ上がら
もちさる	もちさら
食荒らす	食荒らさ
のみほす	のみほさ
取り組む	取り組ま
はせる	はせ
ひっ込める	ひっ込め
突き飛ばす	突き飛ばさ
当てる	当て
込み入る	込み入ら
痛み入る	痛み入ら
申しあげる	申しあげ
ではずれる	ではずれ
やすらう	やすらわ
即す	即さ
ゆりうごかす	ゆりうごかさ
律する	律し
言い募る	言い募ら
発す	発さ
煮え立つ	煮え立た
まくしたてる	まくしたて
突きだす	突きださ
言張る	言張ら
でさかる	でさから
ききただす	ききたださ
書捨てる	書捨て
用立てる	用立て
迷い込む	迷い込ま
申し付ける	申し付け
こきつかう	こきつかわ
ほころばす	ほころばさ
寝っ転がる	寝っ転がら
わだかまる	わだかまら
くじける	くじけ
世離れる	世離れ
しみ付く	しみ付か
すいこめる	すいこめ
剰る	剰ら
揺り動かす	揺り動かさ
起る	起ら
掻い込む	掻い込ま
撥ねつける	撥ねつけ
刷り上げる	刷り上げ
恋焦がれる	恋焦がれ
覆す	覆さ
脈打つ	脈打た
包み込める	包み込め
思い煩う	思い煩わ
咎める	咎め
ひとなれる	ひとなれ
ぬぐ	ぬが
まぜあわす	まぜあわさ
ぶらさげる	ぶらさげ
当る	当ら
のみこめる	のみこめ
這いまつわる	這いまつわら
ふさぎ込む	ふさぎ込ま
つぐなう	つぐなわ
曲がれる	曲がれ
歩み寄る	歩み寄ら
はじらう	はじらわ
ちびる	ちび
かき暮れる	かき暮れ
突きぬける	突きぬけ
取立てる	取立て
己惚れる	己惚れ
噛みつく	噛みつか
打返せる	打返せ
からまる	からまら
もとづく	もとづか
まみえる	まみえ
かんする	かんし
擂る	擂ら
薙ぎ払う	薙ぎ払わ
高ずる	高ぜ
ゆく	ゆか
かくしもつ	かくしもた
悟れる	悟れ
欠ける	欠け
切離す	切離さ
諌む	諌ま
めもる	めもら
食い潰す	食い潰さ
組み込める	組み込め
もぐる	もぐら
凄む	凄ま
おいぼれる	おいぼれ
小切る	小切ら
諷する	諷し
否む	否ま
くいつなぐ	くいつなが
ことたる	ことたら
引っ立てる	引っ立て
そめだせる	そめだせ
ひっかかる	ひっかから
しぼりだす	しぼりださ
乗り出す	乗り出さ
弛む	弛ま
とりかわせる	とりかわせ
ききあきる	ききあき
流し込める	流し込め
みせる	みせ
たずねあわせる	たずねあわせ
走り込む	走り込ま
ぶっぱなす	ぶっぱなさ
おりたつ	おりたた
供える	供え
振り替える	振り替え
笑い返す	笑い返さ
憑かれる	憑かれ
とえる	とえ
めく	めか
買い越す	買い越さ
むれる	むれ
でんぐり返る	でんぐり返ら
書きとる	書きとら
振払う	振払わ
引き起こす	引き起こさ
降り暮す	降り暮さ
よづく	よづか
にらみあわせる	にらみあわせ
みかわす	みかわさ
もちまわる	もちまわら
節くれだつ	節くれだた
増やせる	増やせ
のぞかせる	のぞかせ
そよがす	そよがさ
退る	退ら
紛れこむ	紛れこま
繰上げる	繰上げ
くっつく	くっつか
ばらす	ばらさ
かんぐる	かんぐら
解きほぐす	解きほぐさ
おどりあがる	おどりあがら
彌次る	彌次ら
せまる	せまら
列ねる	列ね
うつ向く	うつ向か
溶合う	溶合わ
配れる	配れ
ずりあがる	ずりあがら
困りきる	困りきら
謂う	謂わ
うちつれる	うちつれ
打くつろぐ	打くつろが
安んずる	安んぜ
いいあう	いいあわ
おこなう	おこなわ
示し合せる	示し合せ
しなす	しなさ
たたきおこせる	たたきおこせ
向かい合う	向かい合わ
飲み回す	飲み回さ
評する	評し
言い返す	言い返さ
立直る	立直ら
遠ざかる	遠ざから
くりぬける	くりぬけ
とり除く	とり除か
みかねる	みかね
びくつく	びくつか
ぎょする	ぎょし
振りまわす	振りまわさ
けつまずく	けつまずか
のぼりつめるる	のぼりつめる
支える	支え
にらみあう	にらみあわ
割振る	割振ら
われる	われ
行き当る	行き当ら
切りつける	切りつけ
引き起す	引き起さ
売りまくれる	売りまくれ
狂する	狂し
厭く	厭か
住替る	住替ら
うかれる	うかれ
折り畳める	折り畳め
しょうじいれる	しょうじいれ
あそびほうける	あそびほうけ
見分ける	見分け
慰む	慰ま
立上がる	立上がら
あたえる	あたえ
駆けずりまわる	駆けずりまわら
項垂れる	項垂れ
ふるまう	ふるまわ
かたぶく	かたぶか
おさえつける	おさえつけ
探し求める	探し求め
投ずる	投ぜ
まげる	まげ
点てる	点て
蹴っとばす	蹴っとばさ
富める	富め
片づく	片づか
作り替える	作り替え
おもいたつ	おもいたた
祷れる	祷れ
まとめる	まとめ
だしきる	だしきら
させる	させ
とびちがう	とびちがわ
かけよる	かけよら
うちぬける	うちぬけ
つみかえる	つみかえ
けし飛ぶ	けし飛ば
もちかける	もちかけ
呼び戻せる	呼び戻せ
浮かぶ	浮かば
そだてる	そだて
うちこむ	うちこま
しっける	しっけ
飛び越せる	飛び越せ
くつがえす	くつがえさ
かんづく	かんづか
忍び泣く	忍び泣か
いきあたる	いきあたら
めくる	めくら
つきだす	つきださ
責める	責め
咲におう	咲におわ
くらます	くらまさ
うらなう	うらなわ
言付かる	言付から
バラつく	バラつか
始める	始め
引き止める	引き止め
引っかかる	引っかから
製する	製し
寝ぼける	寝ぼけ
尽かす	尽かさ
そらんずる	そらんぜ
搗く	搗か
思いやる	思いやら
引受ける	引受け
はきかえる	はきかえ
だきつく	だきつか
醸し出せる	醸し出せ
来合せる	来合せ
睨み合せる	睨み合せ
すくむ	すくま
さませる	さませ
ならせる	ならせ
燃え広がる	燃え広がら
紛れ込む	紛れ込ま
張り足す	張り足さ
垂こめる	垂こめ
漉せる	漉せ
打抜ける	打抜け
はさまる	はさまら
差っ引く	差っ引か
炊く	炊か
とりおく	とりおか
倦む	倦ま
組み合う	組み合わ
つくばう	つくばわ
立ちはだかる	立ちはだから
打ち返せる	打ち返せ
繰り出す	繰り出さ
ちかよせる	ちかよせ
噛む	噛ま
べんずる	べんぜ
わりふれる	わりふれ
計らう	計らわ
駁する	駁し
力づける	力づけ
書きたてる	書きたて
せおいこむ	せおいこま
乗りかかる	乗りかから
取り除ける	取り除け
らっしゃる	らっしゃら
見下ろす	見下ろさ
召し寄せる	召し寄せ
浮かべる	浮かべ
あばれる	あばれ
醒める	醒め
つくりあげる	つくりあげ
憎む	憎ま
こけむす	こけむさ
突付ける	突付け
きざみつける	きざみつけ
すり混ぜる	すり混ぜ
こわせる	こわせ
塗りつぶす	塗りつぶさ
ほける	ほけ
おもいなおせる	おもいなおせ
押しつぶせる	押しつぶせ
引きだす	引きださ
あむ	あま
はしりまわる	はしりまわら
すくいだせる	すくいだせ
開き直る	開き直ら
打連れる	打連れ
わきばさむ	わきばさま
おもいとどまる	おもいとどまら
だしきれる	だしきれ
下る	下ら
鯱張る	鯱張ら
覆る	覆ら
ふきでる	ふきで
とりころす	とりころさ
ながしこむ	ながしこま
受けあう	受けあわ
おっぱらう	おっぱらわ
積める	積め
清める	清め
有る	有ら
到る	到ら
吸いつける	吸いつけ
取り離す	取り離さ
突きあわせる	突きあわせ
貼る	貼ら
片づける	片づけ
おっことす	おっことさ
掻きまぜる	掻きまぜ
がんばれる	がんばれ
撤する	撤し
飛び出でる	飛び出で
追い込む	追い込ま
きたえる	きたえ
取り外す	取り外さ
ふみにじれる	ふみにじれ
さしひびく	さしひびか
放りだす	放りださ
ゆらす	ゆらさ
けたてる	けたて
立ちあがる	立ちあがら
くりこめる	くりこめ
さけべる	さけべ
きめこむ	きめこま
飛び越す	飛び越さ
しむ	しま
だせる	だせ
霜がれる	霜がれ
だっする	だっし
ふやせる	ふやせ
言い誤る	言い誤ら
引っ越す	引っ越さ
あるきまわれる	あるきまわれ
むしかえす	むしかえさ
のりきれる	のりきれ
打立てる	打立て
合す	合さ
とりのぼせる	とりのぼせ
やり直せる	やり直せ
務まる	務まら
炊ける	炊け
かう	かわ
ぬげる	ぬげ
数えたてる	数えたて
きりすてる	きりすて
見出す	見出さ
うえつける	うえつけ
くちごもる	くちごもら
こう	こわ
読みかける	読みかけ
おだてる	おだて
とじこむ	とじこま
ゆう	ゆわ
綴じる	綴じ
悦に入る	悦に入ら
せせら笑う	せせら笑わ
申し上げる	申し上げ
寝過ごす	寝過ごさ
作りだす	作りださ
うちとれる	うちとれ
たしかめる	たしかめ
なづける	なづけ
あっする	あっし
きわだつ	きわだた
打合わす	打合わさ
けんする	けんし
そい遂げる	そい遂げ
推し移る	推し移ら
擦れあう	擦れあわ
相成る	相成ら
口走る	口走ら
為損なう	為損なわ
変わる	変わら
抑える	抑え
継ぎ足せる	継ぎ足せ
振向ける	振向け
溶かせる	溶かせ
打ちつける	打ちつけ
煤ばむ	煤ばま
よろめく	よろめか
見切れる	見切れ
とり上げる	とり上げ
虐げる	虐げ
おいもとめる	おいもとめ
燻らす	燻らさ
立ち直る	立ち直ら
ふりはらう	ふりはらわ
すくみあがる	すくみあがら
とりあわせる	とりあわせ
突っきる	突っきら
誘く	誘か
漬ける	漬け
そわる	そわら
つみたてる	つみたて
はかどる	はかどら
萌す	萌さ
きりとる	きりとら
あやまらす	あやまらさ
乾く	乾か
打砕ける	打砕け
たのみこめる	たのみこめ
並び立てる	並び立て
痛む	痛ま
冒す	冒さ
買いたたく	買いたたか
選びだす	選びださ
渡り歩く	渡り歩か
張り切れる	張り切れ
爪繰る	爪繰ら
取りのける	取りのけ
切放す	切放さ
いつくしむ	いつくしま
ゆきとどく	ゆきとどか
ぐちる	ぐちら
耳だつ	耳だた
またせる	またせ
さがしあてる	さがしあて
成り変わる	成り変わら
待たす	待たさ
みはる	みはら
そめつける	そめつけ
取り仕切る	取り仕切ら
呪う	呪わ
とりよせる	とりよせ
さそいだせる	さそいだせ
すいよせる	すいよせ
汲みだす	汲みださ
立て直せる	立て直せ
うごける	うごけ
うずまる	うずまら
しらける	しらけ
零れる	零れ
くける	くけ
けずる	けずら
おしつぶせる	おしつぶせ
明け暮れる	明け暮れ
おどりあかす	おどりあかさ
勇み立つ	勇み立た
ふるえ上がる	ふるえ上がら
塞げる	塞げ
かすめる	かすめ
乗りこなせる	乗りこなせ
抉る	抉ら
差し上げる	差し上げ
行きあたる	行きあたら
薄らぐ	薄らが
救ける	救け
きりそろえる	きりそろえ
ぬらつく	ぬらつか
けどる	けどら
成りすます	成りすまさ
移す	移さ
推せる	推せ
当て嵌る	当て嵌ら
はり合う	はり合わ
馴れあう	馴れあわ
繰越す	繰越さ
刈り取る	刈り取ら
ぬりたくる	ぬりたくら
見霽かす	見霽かさ
断ち切る	断ち切ら
捲したてる	捲したて
まとめあげる	まとめあげ
うちみる	うちみ
添わせる	添わせ
釣上がる	釣上がら
すみつぶ	すみつば
こぎつく	こぎつか
涙す	涙さ
待ち合わせる	待ち合わせ
くみだす	くみださ
貼れる	貼れ
願える	願え
詰め寄る	詰め寄ら
ゆき着く	ゆき着か
属す	属さ
通える	通え
焼き切る	焼き切ら
干上がる	干上がら
縫い合わす	縫い合わさ
かたりあう	かたりあわ
しおたれる	しおたれ
断ずる	断ぜ
うきあしだつ	うきあしだた
そぼつ	そぼた
おしひろめる	おしひろめ
追付く	追付か
急き込む	急き込ま
射すくめる	射すくめ
話しこむ	話しこま
うらがれる	うらがれ
煮えくり返る	煮えくり返ら
組立てる	組立て
煌む	煌ま
おもいかえす	おもいかえさ
捧げる	捧げ
すく	すか
会う	会わ
はんする	はんし
つかみあう	つかみあわ
はらいだせる	はらいだせ
いきおいづく	いきおいづか
剪む	剪ま
泣きじゃくる	泣きじゃくら
とびまわれる	とびまわれ
押し開く	押し開か
くだける	くだけ
そめる	そめ
上げる	上げ
溯る	溯ら
長らえる	長らえ
ちらかる	ちらから
相継ぐ	相継が
引越す	引越さ
ふりさけみる	ふりさけみ
ちらつく	ちらつか
透る	透ら
ほお張る	ほお張ら
干割れる	干割れ
骨張る	骨張ら
打ち破れる	打ち破れ
こする	こし
尋ね合せる	尋ね合せ
成り代わる	成り代わら
まがれる	まがれ
とりくずす	とりくずさ
揺るぐ	揺るが
略せる	略せ
かまえる	かまえ
組み伏せる	組み伏せ
具する	具し
傾く	傾か
生き残る	生き残ら
のし上がれる	のし上がれ
命ずる	命ぜ
よろこぶ	よろこば
狩る	狩ら
繋がる	繋がら
すぼむ	すぼま
ねらいうてる	ねらいうて
さわがす	さわがさ
竦める	竦め
そぼ降る	そぼ降ら
うりこめる	うりこめ
負う	負わ
くすぶる	くすぶら
みなれる	みなれ
知り抜く	知り抜か
とりまく	とりまか
こころざす	こころざさ
吹雪く	吹雪か
用だつ	用だた
もどれる	もどれ
ころげこむ	ころげこま
くいとめる	くいとめ
かんれんづける	かんれんづけ
曲る	曲ら
出会す	出会さ
透す	透さ
涙する	涙し
そうなる	そうなら
生き返る	生き返ら
損ずる	損ぜ
鋏む	鋏ま
軋る	軋ら
おじゃる	おじゃら
やって退ける	やって退け
さらす	さらさ
いんしょうづける	いんしょうづけ
いからせる	いからせ
似せる	似せ
立ち代る	立ち代ら
みやぶる	みやぶら
まぎらす	まぎらさ
ささやきあう	ささやきあわ
身じろぐ	身じろが
しりぞく	しりぞか
おきだせる	おきだせ
記す	記さ
攻め落とせる	攻め落とせ
そそぎいれる	そそぎいれ
透き通る	透き通ら
かいこむ	かいこま
みせかける	みせかけ
片付く	片付か
釣上げる	釣上げ
のける	のけ
おもいしらせる	おもいしらせ
やせ細る	やせ細ら
理解し合える	理解し合え
ていぎづける	ていぎづけ
つなぎとめる	つなぎとめ
残せる	残せ
突放す	突放さ
請する	請し
落とせる	落とせ
縮らす	縮らさ
うつ伏す	うつ伏さ
絶え果てる	絶え果て
起きあがれる	起きあがれ
まつれる	まつれ
でる	で
力む	力ま
ダブる	ダブら
一皮むける	一皮むけ
糺す	糺さ
抜きだす	抜きださ
逃げ切る	逃げ切ら
すべれる	すべれ
突っ撥ねる	突っ撥ね
秀でる	秀で
つけ狙う	つけ狙わ
抱込む	抱込ま
きっする	きっし
泣かせる	泣かせ
打ち据える	打ち据え
酔潰れる	酔潰れ
捜し出す	捜し出さ
たたす	たたさ
くるめく	くるめか
充つ	充た
巫山戯る	巫山戯
暴く	暴か
蹴上げる	蹴上げ
咲き揃う	咲き揃わ
そぐう	そぐわ
捏ち上げる	捏ち上げ
躍り上がる	躍り上がら
乗りかえる	乗りかえ
約める	約め
読み取れる	読み取れ
漂わす	漂わさ
あせする	あせし
瞑する	瞑し
けおとせる	けおとせ
めぐる	めぐら
きりはなせる	きりはなせ
差替える	差替え
もちこせる	もちこせ
打ち払う	打ち払わ
たえしのべる	たえしのべ
坐り込む	坐り込ま
読みふける	読みふけら
かじける	かじけ
聞入れる	聞入れ
呻く	呻か
けんしきばる	けんしきばら
書き込む	書き込ま
仄めく	仄めか
滲みる	滲み
言える	言え
解き離す	解き離さ
口説き落とす	口説き落とさ
引回す	引回さ
買い取れる	買い取れ
出し抜く	出し抜か
めんずる	めんぜ
立迷う	立迷わ
いいはなつ	いいはなた
すかす	すかさ
やくだつ	やくだた
消え去る	消え去ら
待ちこがれる	待ちこがれ
長びく	長びか
しぼりとる	しぼりとら
斎う	斎わ
脂下がる	脂下がら
かきしるす	かきしるさ
知ろし食す	知ろし食さ
やきはらう	やきはらわ
めぐむ	めぐま
働かす	働かさ
手間どる	手間どら
呟く	呟か
投げだす	投げださ
かぶる	かぶら
くりゃる	くりゃら
凍る	凍ら
書き出す	書き出さ
喋る	喋ら
へいする	へいし
言い表す	言い表さ
ふきこぼれる	ふきこぼれ
疵付ける	疵付け
はねあげる	はねあげ
吹飛ばす	吹飛ばさ
有りふれる	有りふれ
行き詰る	行き詰ら
りきむ	りきま
おもいとまる	おもいとまら
にたつ	にたた
追っ掛ける	追っ掛け
しめる	しめら
侍る	侍ら
しおる	しおら
へるる	へる
攻め立てる	攻め立て
ついやす	ついやさ
づく	づか
説き付ける	説き付け
振り出す	振り出さ
おどりこむ	おどりこま
吟ずる	吟ぜ
篭める	篭め
近寄れる	近寄れ
きばれる	きばれ
すみきる	すみきら
訪ねる	訪ね
そわせる	そわせ
しのばせる	しのばせ
接ぐ	接が
たぐる	たぐら
せぎる	せぎら
耐える	耐え
よりあう	よりあわ
あいてどる	あいてどら
攻寄せる	攻寄せ
棚びく	棚びか
うながす	うながさ
射止める	射止め
担ぐ	担が
よびたてる	よびたて
落ち着ける	落ち着け
吊るせる	吊るせ
広める	広め
うらがえす	うらがえさ
ねむる	ねむら
ふんぞり返る	ふんぞり返ら
骨折る	骨折ら
托す	托さ
どく	どか
さんじる	さんじ
撃ち取る	撃ち取ら
取りあつめる	取りあつめ
並み居る	並み居
集める	集め
給わる	給わら
逢える	逢え
端折る	端折ら
たちわる	たちわら
取崩す	取崩さ
あるきはじめる	あるきはじめ
ひきしめる	ひきしめ
かきなす	かきなさ
決めつける	決めつけ
くみいれる	くみいれ
はげる	はげ
めぐまれる	めぐまれ
為る	為ら
強がる	強がら
鳴らせる	鳴らせ
舁く	舁か
かきくだす	かきくださ
浮かれだす	浮かれださ
達す	達さ
つるむ	つるま
詰め切る	詰め切ら
訳する	訳し
淀む	淀ま
はなしあう	はなしあわ
かっぱらう	かっぱらわ
聞き出す	聞き出さ
持ち堪える	持ち堪え
たばさむ	たばさま
切り落とせる	切り落とせ
散らかる	散らから
載っける	載っけ
笑い飛ばす	笑い飛ばさ
かいする	かいし
かきならす	かきならさ
吹こぼれる	吹こぼれ
考え出せる	考え出せ
よくする	よくし
裁く	裁か
ふみやぶる	ふみやぶら
組み付く	組み付か
繰り広げる	繰り広げ
きりつめる	きりつめ
翳す	翳さ
閊える	閊え
さす	ささ
ききかじる	ききかじら
欹てる	欹て
投棄てる	投棄て
かたる	かたら
馨る	馨ら
おほとのごもる	おほとのごもら
かち取れる	かち取れ
存える	存え
さまよえる	さまよえ
切りとる	切りとら
ゆがく	ゆがか
すれる	すれ
徹する	徹し
燃え付く	燃え付か
かどばる	かどばら
まいる	まいら
結び付く	結び付か
気負い立つ	気負い立た
組みつける	組みつけ
代われる	代われ
舞える	舞え
しみ入る	しみ入ら
つきたてる	つきたて
入りこむ	入りこま
包む	包ま
咬める	咬め
飾りつける	飾りつけ
はらだてる	はらだて
あえぐ	あえが
鳴り渡る	鳴り渡ら
執り行える	執り行え
忍ばす	忍ばさ
召捕る	召捕ら
突き通す	突き通さ