引き込む	引き込ん
すきかえす	すきかえし
看取る	看取っ
睦む	睦ん
きこす	きこし
つける	つけ
封切る	封切っ
逃げまどう	逃げまどっ
さしだす	さしだし
わりきる	わりきっ
飛び抜ける	飛び抜け
書き直せる	書き直せ
ひしめきあう	ひしめきあっ
乗り組む	乗り組ん
引き戻す	引き戻し
持てる	持て
立あう	立あっ
基づく	基づい
弓引く	弓引い
ぶち壊す	ぶち壊し
わきあがる	わきあがっ
語りつぐ	語りつい
問掛ける	問掛け
狙われる	狙われ
埋めあわす	埋めあわし
喚ぶ	喚ん
しりぞける	しりぞけ
こす	こし
大人ぶる	大人ぶっ
居る	居
ねじふせる	ねじふせ
しゃくりあげる	しゃくりあげ
にごせる	にごせ
較べる	較べ
罷り越す	罷り越し
射せる	射せ
描きだす	描きだし
けっとばす	けっとばし
満つ	満っ
明け放す	明け放し
返り咲ける	返り咲け
誘い合わせる	誘い合わせ
つきつける	つきつけ
埋る	埋っ
かき乱す	かき乱し
だまし取る	だまし取っ
配り歩く	配り歩い
抱き込む	抱き込ん
めしあがる	めしあがっ
つうずる	めしあがっ
ずば抜ける	ずば抜け
泣きぬれる	泣きぬれ
くしけずる	くしけずっ
つみとる	つみとっ
割戻す	割戻し
さだまる	さだまっ
睨み合う	睨み合っ
かわれる	かわれ
そむ	そん
後らす	後らし
ごわする	後らし
迷わす	迷わし
泥む	泥ん
仕出す	仕出し
おくする	仕出し
逆らえる	逆らえ
居あわせる	居あわせ
苛立つ	苛立っ
堕ちる	堕ち
慮る	慮っ
怖じ気立つ	怖じ気立っ
きずく	きずい
とりあつかえる	とりあつかえ
扱き雑ぜる	扱き雑ぜ
はじける	はじけ
ふしおがむ	ふしおがん
黙る	黙っ
のめす	のめし
危ぶむ	危ぶん
いりびたる	いりびたっ
洗い流す	洗い流し
呉れる	呉れ
定まる	定まっ
ばかせる	ばかせ
語りあう	語りあっ
敬える	敬え
食らわせる	食らわせ
わたる	わたっ
いいまわす	いいまわし
打ち抜ける	打ち抜け
ヒネる	ヒネっ
転げでる	転げで
打ちのめす	打ちのめし
思い合せる	思い合せ
萎れる	萎れ
総べる	総べ
鳴らす	鳴らし
貸出す	貸出し
差し換える	差し換え
もぐり込む	もぐり込ん
睨む	睨ん
打ちつづく	打ちつづい
おいかける	おいかけ
ふりつもる	ふりつもっ
かわく	かわい
はしりだせる	はしりだせ
省みる	省み
出合う	出合っ
といかえす	といかえし
かぶさる	かぶさっ
こづく	こづい
這う	這っ
縫う	縫っ
降込む	降込ん
はめこむ	はめこん
すみわたる	すみわたっ
いふ	いひ
思へる	思へ
刷りこむ	刷りこん
くらわせる	くらわせ
ゆすぶる	ゆすぶっ
触れ合える	触れ合え
はねあがる	はねあがっ
察する	はねあがっ
ころげおちる	ころげおち
すぐす	すぐし
押しかえす	押しかえし
ただよわす	ただよわし
結論づける	結論づけ
しばり上げる	しばり上げ
欠く	欠い
乗り継ぐ	乗り継い
ひめる	ひめ
むせびなく	むせびない
やじる	やじっ
けっする	やじっ
みかぎる	みかぎっ
わりあてる	わりあて
かき立てる	かき立て
あわてふためく	あわてふためい
吸付ける	吸付け
ごねる	ごね
ほざく	ほざい
せめぐ	せめい
食さがる	食さがっ
追い打つ	追い打っ
休まれる	休まれ
動じる	動じ
染まる	染まっ
立ち迷う	立ち迷っ
染め上げる	染め上げ
たちむかう	たちむかっ
はかれる	はかれ
巻き付く	巻き付い
光らせる	光らせ
挫ける	挫け
燃え移る	燃え移っ
鈍する	燃え移っ
ふくれあがる	ふくれあがっ
いいそこなう	いいそこなっ
ぶんなげる	ぶんなげ
生い立つ	生い立っ
ごたつく	ごたつい
うろたえる	うろたえ
燃える	燃え
はむかう	はむかっ
推する	はむかっ
取逃す	取逃し
乗り通す	乗り通し
よそおう	よそおっ
さむけだつ	さむけだっ
こぼれおちる	こぼれおち
かいつくす	かいつくし
祀る	祀っ
痛め付ける	痛め付け
持ちきる	持ちきっ
疑える	疑え
掻き曇る	掻き曇っ
返り咲く	返り咲い
うばえる	うばえ
願い出る	願い出
落ち延びる	落ち延び
辱める	辱め
おったてる	おったて
編み出す	編み出し
呼び止める	呼び止め
澄みきる	澄みきっ
踏みきる	踏みきっ
寄り付く	寄り付い
だきこむ	だきこん
轟かせる	轟かせ
仰ける	仰け
毒する	仰け
かかえる	かかえ
ほふる	ほふっ
捻る	捻っ
触り合う	触り合っ
角張る	角張っ
悦ぶ	悦ん
いちづける	いちづけ
仕込める	仕込め
くいこめる	くいこめ
組みこむ	組みこん
おそう	おそっ
あつかえる	あつかえ
嘱する	あつかえ
なげきくらす	なげきくらし
けやぶる	けやぶっ
つくりなおす	つくりなおし
まるめる	まるめ
しびれる	しびれ
溶けあう	溶けあっ
突き合わす	突き合わし
はぐる	はぐっ
頼む	頼ん
ゆがむ	ゆがん
はみ出る	はみ出
あおむ	あおん
玩ぶ	玩ん
裁てる	裁て
ちりいそぐ	ちりいそい
棚引く	棚引い
引き下がる	引き下がっ
てぐすねひく	てぐすねひい
括れる	括れ
引き締まる	引き締まっ
参れる	参れ
立ちならぶ	立ちならん
そらうそぶく	そらうそぶい
羨む	羨ん
ふきかえす	ふきかえし
はぐ	はい
みはらす	みはらし
けおされる	けおされ
洒落れる	洒落れ
おもいやる	おもいやっ
ふとる	ふとっ
ちぢらす	ちぢらし
うちまくる	うちまくっ
明け残る	明け残っ
ひきわたす	ひきわたし
ならびたてる	ならびたて
書き出せる	書き出せ
聞きつける	聞きつけ
研ぐ	研い
つきはなせる	つきはなせ
萌む	萌ん
ませる	ませ
折り込める	折り込め
ふり入れる	ふり入れ
押し分ける	押し分け
見慣れる	見慣れ
跳ねのける	跳ねのけ
染む	染ん
訃ぐ	訃い
拒める	拒め
貫き通せる	貫き通せ
くねる	くねっ
ふりやむ	ふりやん
ゆらぐ	ゆらい
読み切れる	読み切れ
ようだつ	ようだっ
またす	またし
畳み込める	畳み込め
掛け合える	掛け合え
誘い出す	誘い出し
のりまわす	のりまわし
ほぐせる	ほぐせ
ぜっする	ほぐせ
蔵する	ほぐせ
食い違う	食い違っ
印す	印し
手古摺る	手古摺っ
まびける	まびけ
わりこむ	わりこん
しくむ	しくん
怪しむ	怪しん
締めつける	締めつけ
受ける	受け
立ちどまる	立ちどまっ
はいりきる	はいりきっ
証す	証し
漕げる	漕げ
捜しまわる	捜しまわっ
ゆきわたる	ゆきわたっ
相入れる	相入れ
奏す	奏し
悦べる	悦べ
料る	料っ
吸い寄せる	吸い寄せ
せぐくまる	せぐくまっ
よえる	よえ
阻める	阻め
くるわす	くるわし
わすれさる	わすれさっ
隠る	隠っ
おもいのこす	おもいのこし
探し出せる	探し出せ
成さがる	成さがっ
およげる	およげ
引き換える	引き換え
引き離せる	引き離せ
さえわたる	さえわたっ
抱き起こせる	抱き起こせ
むち打つ	むち打っ
抗う	抗っ
しょげかえる	しょげかえっ
取り調べる	取り調べ
捕われる	捕われ
なる	なっ
ふししずむ	ふししずん
寂する	ふししずん
取り持つ	取り持っ
おもいあたる	おもいあたっ
語りかける	語りかけ
引っ越せる	引っ越せ
おもいなす	おもいなし
けす	けし
ぎらつく	ぎらつい
きりくむ	きりくん
刻める	刻め
世ばなれる	世ばなれ
ひっくくる	ひっくくっ
そぼぬれる	そぼぬれ
教え諭す	教え諭し
織り込める	織り込め
仰け反る	仰け反っ
けがれる	けがれ
聞漏らす	聞漏らし
あざける	あざけっ
飼う	飼っ
引っ括める	引っ括め
ひょうげる	ひょうげ
延べる	延べ
かけ隔てる	かけ隔て
播く	播い
かすめ取る	かすめ取っ
くだす	くだし
角立つ	角立っ
ほこる	ほこっ
芽ぶく	芽ぶい
疲れはてる	疲れはて
くわわる	くわわっ
追い付く	追い付い
差し上る	差し上っ
踏ん切る	踏ん切っ
ぬきはなつ	ぬきはなっ
言い付ける	言い付け
そよ吹く	そよ吹い
ぼる	ぼっ
蹲る	蹲っ
繰下げる	繰下げ
率いる	率い
化かす	化かし
労する	化かし
持ちかえれる	持ちかえれ
つぎたす	つぎたし
住成す	住成し
締切る	締切っ
挙がる	挙がっ
突っぱる	突っぱっ
出歩ける	出歩け
せる	せっ
躙り寄る	躙り寄っ
排す	排し
いさよう	いさよっ
飲み潰す	飲み潰し
迎える	迎え
参らす	参らし
張りつく	張りつい
にげまわる	にげまわっ
押掛ける	押掛け
掻き集める	掻き集め
住みつぶ	住みつん
妬む	妬ん
愁える	愁え
はりつめる	はりつめ
追い立てる	追い立て
そりかえる	そりかえっ
演ずる	そりかえっ
取り立てる	取り立て
縁どる	縁どっ
侍れる	侍れ
飛び跳ねる	飛び跳ね
つかいこむ	つかいこん
忌む	忌ん
ひとかわむける	ひとかわむけ
くりよせる	くりよせ
掛け離れる	掛け離れ
立替える	立替え
蹴落す	蹴落し
寝そべる	寝そべっ
ひいでる	ひいで
ほりつける	ほりつけ
拾う	拾っ
もうしかねる	もうしかね
明るむ	明るん
張詰める	張詰め
吸いこむ	吸いこん
流れ着く	流れ着い
降り懸る	降り懸っ
植わる	植わっ
追いやれる	追いやれ
すり付ける	すり付け
乗りつける	乗りつけ
飛あがる	飛あがっ
いきおいづける	いきおいづけ
もどく	もどい
うつむける	うつむけ
たもちあう	たもちあっ
かっきづく	かっきづい
取れる	取れ
語り合う	語り合っ
討ち果たす	討ち果たし
まわす	まわし
たちあがれる	たちあがれ
取り毀す	取り毀し
跡絶える	跡絶え
裏がえる	裏がえっ
解明かす	解明かし
加え持つ	加え持っ
あてこめる	あてこめ
せき立てる	せき立て
くちる	くち
きがえる	きがえ
輝り返す	輝り返し
じれる	じれ
やっかむ	やっかん
あそびまわれる	あそびまわれ
書入れる	書入れ
のり出す	のり出し
あてはまる	あてはまっ
ふえる	ふえ
折れ曲がる	折れ曲がっ
惜しむ	惜しん
かきおくる	かきおくっ
つきさせる	つきさせ
ひりつく	ひりつい
うかす	うかし
薫ずる	うかし
めしあげる	めしあげ
ききかえす	ききかえし
焼け出す	焼け出し
掛ける	掛け
置忘れる	置忘れ
筋ばる	筋ばっ
浮腫む	浮腫ん
散らばる	散らばっ
与する	散らばっ
負かる	負かっ
願える	願え
重なる	重なっ
弑する	重なっ
つんざく	つんざい
読通す	読通し
まるめこむ	まるめこん
息張る	息張っ
きおう	きおっ
直る	直っ
回り込む	回り込ん
つんのめる	つんのめっ
おいしげる	おいしげっ
屈む	屈ん
孵す	孵し
取散らす	取散らし
つぎあわせる	つぎあわせ
まちあわせる	まちあわせ
思い起す	思い起し
決める	決め
漉く	漉い
引きおこす	引きおこし
貧する	引きおこし
まるまる	まるまっ
うまれかわる	うまれかわっ
さきでる	さきで
突き合せる	突き合せ
しわめる	しわめ
出し切れる	出し切れ
居直る	居直っ
よびだせる	よびだせ
なんなんとする	よびだせ
出会う	出会っ
叶える	叶え
かいくぐる	かいくぐっ
遵う	遵っ
混ざる	混ざっ
ずり落ちる	ずり落ち
挙げる	挙げ
減る	減っ
はきちがえる	はきちがえ
解け合う	解け合っ
せぐりあげる	せぐりあげ
みまわる	みまわっ
飲み込める	飲み込め
拭き込む	拭き込ん
田舎びる	田舎び
かもしだせる	かもしだせ
行なう	行なっ
うるおす	うるおし
とがらす	とがらし
来あわす	来あわし
みせつける	みせつけ
かたよせる	かたよせ
拒む	拒ん
閉じ込もる	閉じ込もっ
かりとる	かりとっ
おびやかす	おびやかし
比す	比し
仕損じる	仕損じ
打切れる	打切れ
息巻く	息巻い
追っ払う	追っ払っ
扠置く	扠置い
飛びのる	飛びのっ
さかのぼる	さかのぼっ
休らう	休らっ
生れかわる	生れかわっ
かきたてる	かきたて
くっつける	くっつけ
寝とぼける	寝とぼけ
擂れる	擂れ
瀬切る	瀬切っ
試せる	試せ
託す	託し
洩る	洩っ
向ける	向け
ぬすめる	ぬすめ
つれそう	つれそっ
もりたてる	もりたて
ふみこたえる	ふみこたえ
とりあつめる	とりあつめ
哮る	哮っ
見初める	見初め
突っ返す	突っ返し
立ち退ける	立ち退け
寝ころぶ	寝ころん
試す	試し
だきあわせる	だきあわせ
てっする	だきあわせ
しのげる	しのげ
チラつく	チラつい
書抜く	書抜い
後ずさる	後ずさっ
起す	起し
さえずる	さえずっ
裂く	裂い
そこなう	そこなっ
みいる	みいっ
突ぷす	突ぷし
はじき出す	はじき出し
うめこむ	うめこん
出ばる	出ばっ
乗り切れる	乗り切れ
ふくせる	ふくせ
かいもどす	かいもどし
仕舞う	仕舞っ
かける	かけ
往ぬ	往ん
聞える	聞え
読替える	読替え
はこびこむ	はこびこん
暇どる	暇どっ
頂ける	頂け
競り落す	競り落し
立込む	立込ん
晴あがる	晴あがっ
費す	費し
けたおす	けたおし
いいのこす	いいのこし
きりだす	きりだし
とりくずせる	とりくずせ
くいあう	くいあっ
ほそめる	ほそめ
切取る	切取っ
吐く	吐い
のろける	のろけ
しろしめす	しろしめし
じする	しろしめし
具える	具え
取りこむ	取りこん
渡せる	渡せ
ほめそやす	ほめそやし
彩れる	彩れ
むくむ	むくん
与る	与っ
そろえる	そろえ
ねがう	ねがっ
嵌る	嵌っ
沖する	嵌っ
持する	嵌っ
もがく	もがい
おれ込む	おれ込ん
運び出す	運び出し
いがみあう	いがみあっ
はさみ切る	はさみ切っ
ふんだくる	ふんだくっ
まなべる	まなべ
にごる	にごっ
すきこのむ	すきこのん
座す	座し
頑ばる	頑ばっ
ずぬける	ずぬけ
縛りつける	縛りつけ
くみ取る	くみ取っ
履く	履い
とりおさえる	とりおさえ
話し込む	話し込ん
駆立てる	駆立て
のりつぐ	のりつい
あらす	あらし
はきだす	はきだし
いたむ	いたん
売りはらう	売りはらっ
ひきかえる	ひきかえ
ふりしきる	ふりしきっ
やすまる	やすまっ
きたす	きたし
ようする	きたし
かきしるせる	かきしるせ
はせむかう	はせむかっ
近寄せる	近寄せ
錬れる	錬れ
挙る	挙っ
差回す	差回し
鬱ぐ	鬱い
含まる	含まっ
遷す	遷し
練る	練っ
寛げる	寛げ
ころがりこむ	ころがりこん
汲み取れる	汲み取れ
仕掛ける	仕掛け
めさる	めさっ
はいる	はいっ
造る	造っ
抱留める	抱留め
啜り上げる	啜り上げ
堕す	堕し
はやまる	はやまっ
入りびたる	入りびたっ
つったてる	つったて
きわだたす	きわだたし
みせびらかす	みせびらかし
めあわせる	めあわせ
あやしむ	あやしん
乞う	乞う
あざなう	あざなっ
切り回す	切り回し
ながれでる	ながれで
伴う	伴っ
宛てがう	宛てがっ
取り直す	取り直し
摘む	摘ん
見て取る	見て取っ
ひっかつぐ	ひっかつい
引具する	ひっかつい
引き伸ばせる	引き伸ばせ
考えつく	考えつい
しわる	しわっ
揺する	揺すっ
みちたりる	みちたり
聞返す	聞返し
作る	作っ
くやむ	くやん
ふり向く	ふり向い
手折る	手折っ
ぬえる	ぬえ
残れる	残れ
下さる	下さっ
てんずる	下さっ
やみほうける	やみほうけ
駆け込める	駆け込め
やしなう	やしなっ
冷める	冷め
むかえいれる	むかえいれ
慰する	むかえいれ
あきあきする	むかえいれ
勤まる	勤まっ
移れる	移れ
吹掛ける	吹掛け
盛上げる	盛上げ
落し入れる	落し入れ
はせ着ける	はせ着け
しこめる	しこめ
きりまくる	きりまくっ
引ける	引け
凌ぐ	凌い
張り合える	張り合え
みまかる	みまかっ
言いなす	言いなし
説おこす	説おこし
くっする	説おこし
懸かる	懸かっ
ふさげる	ふさげ
いそがす	いそがし
唄える	唄え
もる	もっ
こびりつく	こびりつい
引換える	引換え
はじめる	はじめ
よろこびあう	よろこびあっ
すみなす	すみなし
ともす	ともし
食散らす	食散らし
つみのこす	つみのこし
伺う	伺っ
導く	導い
たたみこむ	たたみこん
寛ぐ	寛い
折り畳む	折り畳ん
はらいこむ	はらいこん
しゃがれる	しゃがれ
垣間みる	垣間み
みすごせる	みすごせ
差し昇る	差し昇っ
うごかす	うごかし
黒みがかる	黒みがかっ
垂れこめる	垂れこめ
持上げる	持上げ
立働く	立働い
あみだす	あみだし
つきのける	つきのけ
返す	返し
整える	整え
食み出でる	食み出で
ききおよぶ	ききおよん
進ぜる	進ぜ
かなぐりすてる	かなぐりすて
送り込む	送り込ん
かみ締める	かみ締め
振り乱す	振り乱し
見失う	見失っ
彷徨く	彷徨い
離れる	離れ
張り飛ばす	張り飛ばし
白茶ける	白茶け
はちきれる	はちきれ
漬かる	漬かっ
振乱す	振乱し
筋張る	筋張っ
わめく	わめい
張りきる	張りきっ
差す	差し
つきとばす	つきとばし
賦する	つきとばし
そりくり返る	そりくり返っ
ひわれる	ひわれ
押さえつける	押さえつけ
振り撒く	振り撒い
切り抜く	切り抜い
舐めずる	舐めずっ
振り翳す	振り翳し
連ねる	連ね
生き延びる	生き延び
まぶす	まぶし
たて込む	たて込ん
ひく	ひい
鋳込む	鋳込ん
滑べる	滑べっ
みすごす	みすごし
感極まる	感極まっ
言いくるめる	言いくるめ
いみきらう	いみきらっ
刈り急ぐ	刈り急い
賭す	賭し
僻する	賭し
競り合える	競り合え
泣ぬれる	泣ぬれ
みまもれる	みまもれ
怒り狂う	怒り狂っ
撓める	撓め
つがえる	つがえ
待ち合わす	待ち合わし
盗む	盗ん
側める	側め
先細る	先細っ
うけつぐ	うけつい
探れる	探れ
鼻じろむ	鼻じろん
挟む	挟ん
いこむ	いこん
たのしむ	たのしん
うりまくれる	うりまくれ
混ぜかえす	混ぜかえし
取り出す	取り出し
よびとめる	よびとめ
抜き出す	抜き出し
跨る	跨っ
ほかなる	ほかなっ
あり合せる	あり合せ
なきこむ	なきこん
つけ込む	つけ込ん
競り上げる	競り上げ
言い繕う	言い繕っ
繙く	繙い
推し進める	推し進め
価する	推し進め
もりあわせる	もりあわせ
いじる	いじっ
釣り出す	釣り出し
やっつける	やっつけ
ひり出す	ひり出し
言い逃れる	言い逃れ
とびだせる	とびだせ
かえす	かえし
しょう	しょっ
いじける	いじけ
もたげる	もたげ
出ぱる	出ぱっ
こう	こう
騙かす	騙かし
苦しめる	苦しめ
やみつく	やみつい
打出せる	打出せ
ひっ掻く	ひっ掻い
えんづく	えんづい
窪める	窪め
ちまよう	ちまよっ
すぎる	すぎ
転がせる	転がせ
たちいる	たちいっ
着飾れる	着飾れ
つきしたがう	つきしたがっ
ふりこむ	ふりこん
書き分ける	書き分け
浴する	書き分け
編出す	編出し
飛込む	飛込ん
驚き入る	驚き入っ
笑み割れる	笑み割れ
とりはからえる	とりはからえ
掬ぶ	掬ん
暗ます	暗まし
茹でる	茹で
取り戻せる	取り戻せ
病みつく	病みつい
ネグる	ネグっ
卷く	卷い
はこぶ	はこん
せんじる	せんじ
祈れる	祈れ
命じる	命じ
喜ぶ	喜ん
みしる	みしっ
爛れる	爛れ
囀る	囀っ
さきだつ	さきだっ
薨ずる	さきだっ
見兼ねる	見兼ね
あいともなう	あいともなっ
小突く	小突い
おりあげる	おりあげ
きらめむ	きらめん
掻き起す	掻き起し
思いかえす	思いかえし
やりかえせる	やりかえせ
ちばしる	ちばしっ
かみわける	かみわけ
さしおく	さしおい
なれ合う	なれ合っ
見かける	見かけ
おおわれる	おおわれ
かちあう	かちあっ
たたき起こせる	たたき起こせ
成り済ます	成り済まし
おじけづく	おじけづい
くみ出せる	くみ出せ
なやむ	なやん
頼み込む	頼み込ん
ゆずる	ゆずっ
転ずる	ゆずっ
息まく	息まい
ひぞる	ひぞっ
青む	青ん
づける	づけ
ひろう	ひろっ
ござる	ござっ
蹴出す	蹴出し
ふする	蹴出し
きりはらう	きりはらっ
遣いこむ	遣いこん
もたせ掛ける	もたせ掛け
遣り込める	遣り込め
なかす	なかし
ちえづく	ちえづい
混ぜ合う	混ぜ合っ
噛める	噛め
煮え返る	煮え返っ
飾り立てる	飾り立て
古びる	古び
とび出る	とび出
感じる	感じ
奬める	奬め
吊す	吊し
つれもどせる	つれもどせ
握れる	握れ
えり分ける	えり分け
焚き染める	焚き染め
由る	由っ
あまんじる	あまんじ
振替える	振替え
産みつける	産みつけ
植え込める	植え込め
沸き起これる	沸き起これ
目覚める	目覚め
委せる	委せ
住み慣れる	住み慣れ
思ほす	思ほし
みちがえる	みちがえ
せめのぼる	せめのぼっ
気どる	気どっ
したしむ	したしん
持ち合わせる	持ち合わせ
置換わる	置換わっ
聞流す	聞流し
追い落とす	追い落とし
焦れ込む	焦れ込ん
歌う	歌っ
極める	極め
ねせる	ねせ
つづめる	つづめ
ろんずる	つづめ
書き下ろす	書き下ろし
綴れる	綴れ
かねる	かね
凍り付く	凍り付い
見損なう	見損なっ
すんたる	すんたっ
計る	計っ
開き直れる	開き直れ
取りそろえる	取りそろえ
割り戻せる	割り戻せ
しみこむ	しみこん
にげうせる	にげうせ
しつける	しつけ
すりまぜる	すりまぜ
とりあう	とりあっ
匂わせる	匂わせ
転がり込む	転がり込ん
貸切る	貸切っ
縫い込む	縫い込ん
ひきつづける	ひきつづけ
割りあてる	割りあて
ぼうする	割りあて
ひたす	ひたし
振り落とす	振り落とし
ひきおろす	ひきおろし
みおろせる	みおろせ
立ふさがる	立ふさがっ
切付ける	切付け
目慣れる	目慣れ
ころがる	ころがっ
付き従う	付き従っ
はたらきかける	はたらきかけ
ちかづける	ちかづけ
立ち返る	立ち返っ
むかつく	むかつい
芽生える	芽生え
侮れる	侮れ
取り去れる	取り去れ
ぶちこわす	ぶちこわし
期す	期し
伝わる	伝わっ
任じる	任じ
つま先立つ	つま先立っ
うけあう	うけあっ
垂れ込む	垂れ込ん
勝取る	勝取っ
ちからつきる	ちからつき
踏んばる	踏んばっ
かちこせる	かちこせ
たがる	たがっ
おく	おい
咲き乱れる	咲き乱れ
ねんじる	ねんじ
留める	留め
打ちよせる	打ちよせ
つっこめる	つっこめ
おもう	おもう
已める	已め
つちかう	つちかっ
ききかえせる	ききかえせ
みやる	みやっ
仇する	みやっ
きょうする	みやっ
むきなおる	むきなおっ
突き放す	突き放し
引き立てる	引き立て
やききる	やききっ
取上げる	取上げ
あばれまわる	あばれまわっ
きりとれる	きりとれ
忍び込める	忍び込め
取りあつかう	取りあつかっ
掻っ切る	掻っ切っ
突き止める	突き止め
もえひろがる	もえひろがっ
ねぼける	ねぼけ
むかいあわす	むかいあわし
捏ね返す	捏ね返し
拘わる	拘わっ
遣う	遣っ
たまわる	たまわっ
ひっ篭る	ひっ篭っ
酔いしれる	酔いしれ
とどろく	とどろい
かかわりあう	かかわりあっ
カミつく	カミつい
いいきかせる	いいきかせ
隔てる	隔て
攻あぐむ	攻あぐん
ハサむ	ハサん
かざりたてる	かざりたて
呷る	呷っ
てわたす	てわたし
取もつ	取もっ
はぎとれる	はぎとれ
組替える	組替え
寝過す	寝過し
けむる	けむっ
ゆらせる	ゆらせ
畏れ入る	畏れ入っ
歩ける	歩け
すりつぶす	すりつぶし
踏める	踏め
臆する	踏め
踏み越える	踏み越え
けかえす	けかえし
疼く	疼い
語りこめる	語りこめ
ぬきとれる	ぬきとれ
つけ加える	つけ加え
なきさけぶ	なきさけん
くじく	くじい
名指す	名指し
しょたいじみる	しょたいじみ
焦がれる	焦がれ
会わす	会わし
坐る	坐っ
入れ揚げる	入れ揚げ
舐める	舐め
うけながす	うけながし
てつだう	てつだっ
慈しむ	慈しん
握り潰す	握り潰し
たえいる	たえいっ
さばける	さばけ
からみあう	からみあっ
おる	おっ
まきおこせる	まきおこせ
はげおちる	はげおち
よめる	よめ
かきぬける	かきぬけ
打ち捨てる	打ち捨て
みやぶれる	みやぶれ
受入れる	受入れ
掛合う	掛合っ
はなしあえる	はなしあえ
迫り出す	迫り出し
すする	すすっ
見極める	見極め
畳み込む	畳み込ん
擦りむける	擦りむけ
脱捨てる	脱捨て
訃げる	訃げ
しずれる	しずれ
取りなす	取りなし
咲きそろう	咲きそろっ
あたりちらす	あたりちらし
取り落す	取り落し
押し迫る	押し迫っ
けぶる	けぶっ
途絶える	途絶え
熔ける	熔け
かんがみる	かんがみ
かけへだてる	かけへだて
あかちゃける	あかちゃけ
懐く	懐い
来あわせる	来あわせ
叱りつける	叱りつけ
ながれあるく	ながれあるい
伸び悩む	伸び悩ん
おえる	おえ
験する	おえ
略する	おえ
追いすがる	追いすがっ
かがめる	かがめ
さうぞく	さうぞい
溶きほぐす	溶きほぐし
すりきれる	すりきれ
とりとめる	とりとめ
立ち塞がる	立ち塞がっ
たくむ	たくん
便じる	便じ
聘する	便じ
破ける	破け
行き過ぎる	行き過ぎ
うきだす	うきだし
ひくまる	ひくまっ
恋い焦がれる	恋い焦がれ
糊する	恋い焦がれ
すみかわる	すみかわっ
死におくれる	死におくれ
理る	理っ
こと切れる	こと切れ
採りあげる	採りあげ
かけこめる	かけこめ
倍する	かけこめ
へこます	へこまし
燃えつきる	燃えつき
す	し
引っさげる	引っさげ
破る	破っ
へる	へ
閉じ込める	閉じ込め
ひしぐ	ひしい
つかれ果てる	つかれ果て
くろめる	くろめ
たちかえる	たちかえっ
かざる	かざっ
酔いつぶれる	酔いつぶれ
仕あがる	仕あがっ
持ち込む	持ち込ん
嘆き暮す	嘆き暮し
垂れる	垂れ
あえる	あえ
篩い落す	篩い落し
いきとどく	いきとどい
付まとう	付まとっ
ぶつける	ぶつけ
こみいる	こみいっ
ゆずれる	ゆずれ
うらびれる	うらびれ
哮り立つ	哮り立っ
くいさがる	くいさがっ
上げる	上げ
回す	回し
生れ変る	生れ変っ
滅ぶ	滅ん
利す	利し
ちらめく	ちらめい
伍する	ちらめい
たてかえる	たてかえ
伺ふ	伺ひ
絶つ	絶っ
透きとおる	透きとおっ
布く	布い
とがる	とがっ
こなれる	こなれ
とっちめる	とっちめ
ふめる	ふめ
出す	出し
おしかくす	おしかくし
こぐらかる	こぐらかっ
そう	そっ
突っ切る	突っ切っ
締め出す	締め出し
のぞめる	のぞめ
読み破る	読み破っ
弛める	弛め
仰ぐ	仰い
ねじ切る	ねじ切っ
迸る	迸っ
かちほこる	かちほこっ
有り得る	有り得
掻き消える	掻き消え
よみくだす	よみくだし
煎じつめる	煎じつめ
泣き腫らす	泣き腫らし
貶する	泣き腫らし
突飛ばす	突飛ばし
とぎれる	とぎれ
明らむ	明らん
あさる	あさっ
待ちかまえる	待ちかまえ
したがえる	したがえ
畳める	畳め
呼び戻す	呼び戻し
打上げる	打上げ
言放つ	言放っ
抱き込める	抱き込め
そめあがる	そめあがっ
見繕う	見繕っ
若返れる	若返れ
つかいこなす	つかいこなし
泣き沈む	泣き沈ん
釈ける	釈け
跳びつく	跳びつい
きたえあげる	きたえあげ
うけとれる	うけとれ
ねじまげる	ねじまげ
割り引ける	割り引け
陥る	陥っ
沸きあがる	沸きあがっ
嘶える	嘶え
立ち向かえる	立ち向かえ
引き降ろせる	引き降ろせ
替る	替っ
よみかえす	よみかえし
ひきちぎれる	ひきちぎれ
弔える	弔え
汗する	弔え
窪まる	窪まっ
配する	窪まっ
せせる	せせっ
褪める	褪め
さえ返る	さえ返っ
よむ	よん
すがりつく	すがりつい
理解し合う	理解し合っ
験す	験し
まく	まい
たくらむ	たくらん
みたてる	みたて
思い浮かべる	思い浮かべ
焚きつける	焚きつけ
作れる	作れ
のびあがる	のびあがっ
あいす	あいし
あらだつ	あらだっ
はりきれる	はりきれ
立ち退く	立ち退い
おびき寄せる	おびき寄せ
這いずる	這いずっ
手折れる	手折れ
嘉する	手折れ
剃り落とせる	剃り落とせ
候う	候っ
しゃくり上げる	しゃくり上げ
貫く	貫い
葬る	葬っ
語り込む	語り込ん
食い荒らす	食い荒らし
取り乱す	取り乱し
参らせる	参らせ
譏る	譏っ
もうでる	もうで
死する	もうで
継ぎあわせる	継ぎあわせ
悴む	悴ん
住みなす	住みなし
しとる	しとっ
とんがらかす	とんがらかし
交ぜ返す	交ぜ返し
立ち止る	立ち止っ
押黙る	押黙っ
書きあげる	書きあげ
貸し切る	貸し切っ
あつらえる	あつらえ
沸く	沸い
跳上がる	跳上がっ
飲込む	飲込ん
つみあげる	つみあげ
徹す	徹し
まどう	まどっ
引き揚げる	引き揚げ
書き付ける	書き付け
見落とす	見落とし
掻き毟る	掻き毟っ
付け廻す	付け廻し
消うせる	消うせ
さがしもとめる	さがしもとめ
かけあう	かけあっ
慣らせる	慣らせ
とりやめる	とりやめ
痩ける	痩け
押し隠せる	押し隠せ
架かる	架かっ
さわす	さわし
こころがける	こころがけ
ぬかす	ぬかし
飢える	飢え
ながせる	ながせ
成立つ	成立っ
はなしだす	はなしだし
弱める	弱め
打返す	打返し
打ち合わす	打ち合わし
打ち切る	打ち切っ
うなずく	うなずい
ふくらます	ふくらまし
吐ける	吐け
差掛ける	差掛け
打ち返す	打ち返し
打払う	打払っ
思う	思っ
汲み乾す	汲み乾し
はね上がる	はね上がっ
さんけづく	さんけづい
よこたわる	よこたわっ
寝取る	寝取っ
つっかえす	つっかえし
あびる	あび
冀う	冀っ
刺さる	刺さっ
ふきつける	ふきつけ
はせつける	はせつけ
乗り継げる	乗り継げ
改める	改め
吹き荒ぶ	吹き荒ん
遠ざける	遠ざけ
輝る	輝っ
懸隔てる	懸隔て
たちきる	たちきっ
吹き飛ばせる	吹き飛ばせ
煩い付く	煩い付い
思い残す	思い残し
そっくり返る	そっくり返っ
すておく	すておい
召しかかえる	召しかかえ
取り繕う	取り繕っ
呆れかえる	呆れかえっ
しみ込む	しみ込ん
取消す	取消し
くさる	くさっ
ほのめく	ほのめい
聞分ける	聞分け
たもちあえる	たもちあえ
ゆく	ゆき
切れ込む	切れ込ん
ねれる	ねれ
むせる	むせ
たかぶる	たかぶっ
ほどこせる	ほどこせ
かかり合う	かかり合っ
染み込む	染み込ん
積み残す	積み残し
食える	食え
張り付ける	張り付け
つり合う	つり合っ
のし上がる	のし上がっ
思い切れる	思い切れ
みかえる	みかえっ
はしりぬける	はしりぬけ
拠る	拠っ
てる	て
だきとる	だきとっ
攀じ登る	攀じ登っ
こいこがれる	こいこがれ
なみだする	こいこがれ
すべりこむ	すべりこん
見粉う	見粉っ
打落す	打落し
きする	打落し
ひきずりだせる	ひきずりだせ
ころげでる	ころげで
建ち並ぶ	建ち並ん
往く	往い
みとる	みとっ
巡る	巡っ
読み流す	読み流し
代る	代っ
罷める	罷め
かかえ込む	かかえ込ん
まぜっかえす	まぜっかえし
おりあう	おりあっ
ゐる	ゐ
見せかける	見せかけ
かつげる	かつげ
きりまわす	きりまわし
躊躇う	躊躇っ
しんじる	しんじ
堪え忍ぶ	堪え忍ん
すべりこめる	すべりこめ
おとす	おとし
射竦める	射竦め
付加わる	付加わっ
捲れる	捲れ
たがえる	たがえ
かかわり合う	かかわり合っ
はねだす	はねだし
うたいまくる	うたいまくっ
過す	過し
こおりつく	こおりつい
科す	科し
連れ帰る	連れ帰っ
まくる	まくっ
抓む	抓ん
おどり上がる	おどり上がっ
切り立つ	切り立っ
見馴れる	見馴れ
振り分ける	振り分け
撃ち合う	撃ち合っ
うかべる	うかべ
饐える	饐え
思いとどまる	思いとどまっ
ふりおとす	ふりおとし
組付く	組付い
聞き落す	聞き落し
かき分ける	かき分け
洗える	洗え
うったえる	うったえ
借切る	借切っ
こぎ着ける	こぎ着け
脹らす	脹らし
分かつ	分かっ
言いならわす	言いならわし
挿頭す	挿頭し
飛び込める	飛び込め
切出す	切出し
いつぶす	いつぶし
休まる	休まっ
降ろせる	降ろせ
はためく	はためい
もうす	もうし
死にかける	死にかけ
諌める	諌め
もとめる	もとめ
駆回る	駆回っ
くりこせる	くりこせ
キメる	キメ
取片付ける	取片付け
いすくめる	いすくめ
へんじる	へんじ
ほつれる	ほつれ
交わす	交わし
うりはらえる	うりはらえ
混ぜ返す	混ぜ返し
あれくるう	あれくるっ
摂する	あれくるっ
ねがえる	ねがえ
ながす	ながし
言い過ぎる	言い過ぎ
すだてる	すだて
ぼかす	ぼかし
押込める	押込め
立ち遅れる	立ち遅れ
むくれる	むくれ
ひるむ	ひるん
降くらす	降くらし
やすまれる	やすまれ
通れる	通れ
買いあさる	買いあさっ
巡らす	巡らし
持ち去る	持ち去っ
縅す	縅し
拭き取る	拭き取っ
あまえる	あまえ
じゅくす	じゅくし
捻り回す	捻り回し
過る	過っ
歩く	歩い
売りつくす	売りつくし
ひらめく	ひらめい
叙する	ひらめい
咲かせる	咲かせ
おどりかかる	おどりかかっ
きかす	きかし
契れる	契れ
つきあげる	つきあげ
おっつける	おっつけ
恋う	恋う
くさらす	くさらし
にじむ	にじん
みとれる	みとれ
欲張る	欲張っ
つっこむ	つっこん
呼び込める	呼び込め
取去る	取去っ
嵌め込む	嵌め込ん
焼きつける	焼きつけ
恵まれる	恵まれ
切かかる	切かかっ
見晴らす	見晴らし
聞き出せる	聞き出せ
眩む	眩ん
得る	得
さおさす	さおさし
かわす	かわし
替える	替え
といつめる	といつめ
濾せる	濾せ
突き抜ける	突き抜け
育て上げる	育て上げ
見すかせる	見すかせ
歴る	歴
生きる	生き
道ける	道け
願う	願っ
噛みわける	噛みわけ
取り決める	取り決め
着ける	着け
気がつく	気がつい
つつしむ	つつしん
泳げる	泳げ
おいる	おい
かいあげる	かいあげ
書き抜く	書き抜い
乾涸びる	乾涸び
繋げる	繋げ
割りふる	割りふっ
縮れる	縮れ
紛らかす	紛らかし
驚く	驚い
失う	失っ
かりかえる	かりかえ
かきそえる	かきそえ
買い取る	買い取っ
口ごもる	口ごもっ
くいつく	くいつい
突詰める	突詰め
とりけす	とりけし
しにたえる	しにたえ
煮詰まる	煮詰まっ
あきれ果てる	あきれ果て
役立てる	役立て
ありつく	ありつい
動き出す	動き出し
切り詰める	切り詰め
行交う	行交っ
求め行く	求め行き
枯ればむ	枯ればん
バカげる	バカげ
絡まる	絡まっ
下げる	下げ
曳ける	曳け
せっぱ詰まる	せっぱ詰まっ
組みつく	組みつい
ほうりだす	ほうりだし
手馴れる	手馴れ
転がる	転がっ
抱き合う	抱き合っ
しおれる	しおれ
割り付ける	割り付け
飛ばせる	飛ばせ
にじる	にじっ
よくばる	よくばっ
つめこめる	つめこめ
夢見る	夢見
はんじる	はんじ
冷やす	冷やし
めしかかえる	めしかかえ
丸め込む	丸め込ん
見落す	見落し
飲潰す	飲潰し
撃つ	撃っ
むくう	むくっ
ありあまる	ありあまっ
つまどる	つまどっ
囃す	囃し
認める	認め
ときめかす	ときめかし
儀式張る	儀式張っ
恍ける	恍け
あたける	あたけ
制する	あたけ
見せ付ける	見せ付け
流れる	流れ
はせ参ずる	流れ
掻き分ける	掻き分け
適す	適し
出歩く	出歩い
舞上がる	舞上がっ
関係付ける	関係付け
舂く	舂い
縁付ける	縁付け
まかり間違う	まかり間違っ
軽しめる	軽しめ
ひっこす	ひっこし
ゆき暮れる	ゆき暮れ
ほれ込む	ほれ込ん
ふりはじめる	ふりはじめ
越える	越え
うめる	うめ
誅する	うめ
學ぶ	學ん
被ける	被け
かきながす	かきながし
詰めかける	詰めかけ
窮め尽くす	窮め尽くし
整え直す	整え直し
遮れる	遮れ
しれわたる	しれわたっ
すみなれる	すみなれ
なげこめる	なげこめ
投げ勝てる	投げ勝て
ていする	投げ勝て
なやます	なやまし
突きとばす	突きとばし
当たれる	当たれ
さかだつ	さかだっ
なげだせる	なげだせ
かきこむ	かきこん
振当てる	振当て
つかいわける	つかいわけ
誣いる	誣い
ゆき渡る	ゆき渡っ
はたける	はたけ
碎く	碎い
抱き着く	抱き着い
ひっくるめる	ひっくるめ
吹っ飛ぶ	吹っ飛ん
押しこめる	押しこめ
さいはじける	さいはじけ
ととのう	ととのっ
誹る	誹っ
わきおこれる	わきおこれ
はりあげる	はりあげ
折り合う	折り合っ
置きわすれる	置きわすれ
ひざまずく	ひざまずい
かたまる	かたまっ
言誤る	言誤っ
うち続く	うち続い
有り触れる	有り触れ
生い育つ	生い育っ
擦寄る	擦寄っ
書下す	書下し
のこる	のこっ
当て擦る	当て擦っ
思いなす	思いなし
杓う	杓っ
とおせる	とおせ
住みかえる	住みかえ
そこしる	そこしっ
責め落とす	責め落とし
染出す	染出し
つかめる	つかめ
いやます	いやまし
竦む	竦ん
ならぶ	ならん
詰る	詰っ
排する	詰っ
のしかかる	のしかかっ
集る	集っ
振分ける	振分け
かんがえつく	かんがえつい
求まる	求まっ
ゆわえ付ける	ゆわえ付け
吊れる	吊れ
聞き込む	聞き込ん
もえあがる	もえあがっ
さきみだれる	さきみだれ
侮る	侮っ
まかり通る	まかり通っ
押し切れる	押し切れ
見とれる	見とれ
つづまる	つづまっ
みさだめる	みさだめ
こましゃくれる	こましゃくれ
遊び回れる	遊び回れ
うつしとる	うつしとっ
鞣す	鞣し
でかける	でかけ
勝ちぬく	勝ちぬい
とって返す	とって返し
ねぐ	ねい
みいだせる	みいだせ
掃きだす	掃きだし
切り取る	切り取っ
飛のく	飛のい
かみしだく	かみしだい
詛う	詛っ
片寄る	片寄っ
わき出る	わき出
ぞんじあげる	ぞんじあげ
寄り縋る	寄り縋っ
もとる	もとっ
めぐれる	めぐれ
重立つ	重立っ
黄ばむ	黄ばん
書き散らす	書き散らし
刺し通す	刺し通し
おそれいる	おそれいっ
優る	優っ
もてなす	もてなし
しゃくにさわる	しゃくにさわっ
よびあげる	よびあげ
食い合う	食い合っ
いきぬく	いきぬい
鈍る	鈍っ
しげりあう	しげりあっ
話す	話し
言い損なう	言い損なっ
押しつまる	押しつまっ
踏み破る	踏み破っ
請う	請っ
たわむ	たわん
降り積る	降り積っ
打出す	打出し
響きわたる	響きわたっ
もぎ落とす	もぎ落とし
膨れる	膨れ
借入れる	借入れ
翔る	翔っ
いきまく	いきまい
そっくりかえる	そっくりかえっ
となりあう	となりあっ
相する	となりあっ
まぬかれる	まぬかれ
逢う	逢っ
逃れる	逃れ
食いつぶす	食いつぶし
すわりこめる	すわりこめ
強める	強め
剥ける	剥け
耳慣れる	耳慣れ
よいしれる	よいしれ
荒れ狂う	荒れ狂っ
よみとれる	よみとれ
欲ばる	欲ばっ
なげいれる	なげいれ
わすれかける	わすれかけ
てなずける	てなずけ
抱ける	抱け
とりさる	とりさっ
課す	課し
焼き鈍す	焼き鈍し
うっする	焼き鈍し
りょうる	りょうっ
わらいこける	わらいこけ
同ずる	わらいこけ
運び込む	運び込ん
差向ける	差向け
もぐりこめる	もぐりこめ
安らう	安らっ
紛える	紛え
ほころばせる	ほころばせ
犯せる	犯せ
読み出す	読み出し
なきぬれる	なきぬれ
祝える	祝え
おもんばかる	おもんばかっ
たたえる	たたえ
よびよせる	よびよせ
手渡せる	手渡せ
いる	い
結い上げる	結い上げ
かつえる	かつえ
もったいぶる	もったいぶっ
こせる	こせ
統べる	統べ
送りこむ	送りこん
差上る	差上っ
引き出す	引き出し
盗み見る	盗み見
おおせつかる	おおせつかっ
くるまれる	くるまれ
区切る	区切っ
折り曲げる	折り曲げ
逃げだす	逃げだし
けがす	けがし
要る	要っ
拗じくれる	拗じくれ
及ぶ	及ん
ねじこむ	ねじこん
ひきおとせる	ひきおとせ
拗くれる	拗くれ
身まかる	身まかっ
可愛がれる	可愛がれ
泣明かす	泣明かし
鳴しきる	鳴しきっ
すえる	すえ
しばりつける	しばりつけ
にじみでる	にじみで
震わす	震わし
ぶら下げる	ぶら下げ
恋こがれる	恋こがれ
おもいあがる	おもいあがっ
ひきしぼる	ひきしぼっ
とりかえす	とりかえし
つかれる	つかれ
練り合わせる	練り合わせ
所帯染みる	所帯染み
おどろく	おどろい
はばかる	はばかっ
活かす	活かし
打据える	打据え
うかがえる	うかがえ
輸する	うかがえ
察す	察し
振る舞う	振る舞っ
諂う	諂っ
取り去る	取り去っ
目論む	目論ん
殴り込む	殴り込ん
言い直す	言い直し
のみつぶれる	のみつぶれ
隣合わす	隣合わし
おぎなう	おぎなっ
ひねり出す	ひねり出し
洗い直す	洗い直し
つかねる	つかね
おいちらす	おいちらし
うけいれる	うけいれ
かなう	かなっ
知抜く	知抜い
象れる	象れ
受け出す	受け出し
ゆすぐ	ゆすい
あそびあきる	あそびあき
次ぐ	次い
さぐりあう	さぐりあっ
える	えっ
揚る	揚っ
ねそびれる	ねそびれ
すすぐ	すすい
顕れる	顕れ
赤みがかる	赤みがかっ
嗜める	嗜め
うがつ	うがっ
掻き乱す	掻き乱し
生み付ける	生み付け
綴じ込む	綴じ込ん
あつかう	あつかっ
噛み砕ける	噛み砕け
祟る	祟っ
さんざめく	さんざめい
話せる	話せ
打ちあわせる	打ちあわせ
ぐずる	ぐずっ
べんじる	べんじ
携える	携え
請け負う	請け負っ
ながしいれる	ながしいれ
くいさがれる	くいさがれ
たたき落とす	たたき落とし
飲明かす	飲明かし
似合う	似合っ
きかせる	きかせ
寄越す	寄越し
湿す	湿し
にげのびる	にげのび
まかりでる	まかりで
たちのく	たちのい
つぼまる	つぼまっ
よろこばす	よろこばし
いいつのる	いいつのっ
耽ける	耽け
聞き置く	聞き置い
ふりまわせる	ふりまわせ
めとる	めとっ
てる	てっ
うたがえる	うたがえ
甘んずる	うたがえ
たちされる	たちされ
おののく	おののい
燃やせる	燃やせ
生ずる	燃やせ
導き出す	導き出し
嵩む	嵩ん
ふみぬける	ふみぬけ
ひらめる	ひらめ
すれあう	すれあっ
虐める	虐め
うけとる	うけとっ
たたきおとす	たたきおとし
築ける	築け
どく	どい
蠢く	蠢い
たぎる	たぎっ
呼び付ける	呼び付け
心掛ける	心掛け
のり出せる	のり出せ
ふりきれる	ふりきれ
汲みあげる	汲みあげ
捻り出す	捻り出し
はずかしめる	はずかしめ
交える	交え
いいおわる	いいおわっ
組込む	組込ん
打ち放す	打ち放し
拾える	拾え
おもいめぐらす	おもいめぐらし
つきとおる	つきとおっ
みのる	みのっ
革まる	革まっ
引っ掛ける	引っ掛け
来る	来
抜取る	抜取っ
よわいする	抜取っ
抜出す	抜出し
大殿篭る	大殿篭っ
ちゅうする	大殿篭っ
したためる	したため
生ける	生け
ひっくり返せる	ひっくり返せ
あらためる	あらため
腐る	腐っ
鞭打つ	鞭打っ
さわがせる	さわがせ
思いめぐらす	思いめぐらし
はくする	思いめぐらし
につまる	につまっ
並外れる	並外れ
かがむ	かがん
輝く	輝い
やく	やい
ある	あっ
心温まる	心温まっ
なぐ	ない
さきにおう	さきにおっ
しみ渡る	しみ渡っ
咲きみだれる	咲きみだれ
うばいあえる	うばいあえ
建てる	建て
頼める	頼め
かり集める	かり集め
ふみたおせる	ふみたおせ
やみほおける	やみほおけ
言習わす	言習わし
ありあわせる	ありあわせ
吐き出す	吐き出し
導ける	導け
止まる	止まっ
正す	正し
盛り殺す	盛り殺し
しまう	しまっ
磨ぐ	磨い
におわす	におわし
さらえる	さらえ
しわける	しわけ
躱す	躱し
討ち止める	討ち止め
交ぜる	交ぜ
のける	のけ
といあわせる	といあわせ
嵌める	嵌め
憂ふ	憂へ
ひねりだす	ひねりだし
恐る	恐
居座れる	居座れ
塗り付ける	塗り付け
執り成す	執り成し
張る	張っ
にえかえる	にえかえっ
乗り掛ける	乗り掛け
帯する	乗り掛け
にやける	にやけ
しぶく	しぶい
戦ふ	戦ひ
てがける	てがけ
でく	でっ
くいたおす	くいたおし
差し伸べる	差し伸べ
いきどおる	いきどおっ
張り切る	張り切っ
やめる	やめ
誘き寄せる	誘き寄せ
いきばる	いきばっ
たたきだせる	たたきだせ
煎る	煎っ
おうじる	おうじ
遊ばせる	遊ばせ
けしかける	けしかけ
突き出る	突き出
行かす	行かし
よくなる	よくなっ
あがる	あがっ
もつ	もっ
迫り上げる	迫り上げ
鉗む	鉗ん
たっする	鉗ん
こえる	こえ
ぬがせる	ぬがせ
かみつく	かみつい
捌く	捌い
聞き流す	聞き流し
占める	占め
鳴りだす	鳴りだし
赦す	赦し
見返す	見返し
威張る	威張っ
罅割れる	罅割れ
みまう	みまっ
きはじめる	きはじめ
飛降りる	飛降り
なぎ倒す	なぎ倒し
振りまける	振りまけ
とりくむ	とりくん
ひそまる	ひそまっ
持ち直す	持ち直し
意気込む	意気込ん
見つけ出す	見つけ出し
あきなう	あきなっ
見惚れる	見惚れ
けだす	けだし
占える	占え
持寄る	持寄っ
染入る	染入っ
ゆきあう	ゆきあっ
そそぎ入れる	そそぎ入れ
もぎとれる	もぎとれ
癒す	癒し
氷る	氷っ
引き続く	引き続い
買占める	買占め
哀れむ	哀れん
叱れる	叱れ
のびあがれる	のびあがれ
茶化す	茶化し
申し入れる	申し入れ
借り倒す	借り倒し
押さえ込む	押さえ込ん
乗り合わせる	乗り合わせ
あきらめる	あきらめ
渇する	あきらめ
見いだす	見いだし
掻く	掻い
話し出す	話し出し
先だつ	先だっ
かっ切る	かっ切っ
打放す	打放し
わりふる	わりふっ
うろ抜く	うろ抜い
授ける	授け
のぞきこめる	のぞきこめ
はぐれる	はぐれ
つれあう	つれあっ
引き絞る	引き絞っ
グレる	グレ
聞き過す	聞き過し
ただせる	ただせ
それる	それ
見くびる	見くびっ
買入れる	買入れ
買い換える	買い換え
抑え込む	抑え込ん
そびえたつ	そびえたっ
嗅ぎつける	嗅ぎつけ
ねころぶ	ねころん
える	え
ほのめかす	ほのめかし
面くらう	面くらっ
こころづく	こころづい
摩り替える	摩り替え
かけ合せる	かけ合せ
言い出せる	言い出せ
詫び入る	詫び入っ
つくす	つくし
亡くする	つくし
よみあわす	よみあわし
懸け離れる	懸け離れ
選び出せる	選び出せ
吐きだす	吐きだし
近付ける	近付け
やれる	やれ
過ぎる	過ぎ
めぐらせる	めぐらせ
まちがえる	まちがえ
ききながせる	ききながせ
扮する	ききながせ
乗外す	乗外し
取り結べる	取り結べ
かわせる	かわせ
取り囲める	取り囲め
噴ける	噴け
老込む	老込ん
もうしでる	もうしで
あそばす	あそばし
儲かる	儲かっ
つぎ込む	つぎ込ん
ねばる	ねばっ
縮こまる	縮こまっ
うまれおちる	うまれおち
見つめる	見つめ
添う	添っ
踏み切れる	踏み切れ
よみかける	よみかけ
うける	うけ
乗っ取る	乗っ取っ
始める	始め
とりむすべる	とりむすべ
踏とどまる	踏とどまっ
転じる	転じ
積み込む	積み込ん
参る	参っ
つるす	つるし
はける	はけ
ふきだす	ふきだし
成り上がる	成り上がっ
匂う	匂っ
もたせる	もたせ
読取る	読取っ
ひまどる	ひまどっ
志す	志し
けずりたおす	けずりたおし
だしぬく	だしぬい
聞き取れる	聞き取れ
もたれかかる	もたれかかっ
はずす	はずし
おしひらく	おしひらい
まえる	まえ
待ちくたびれる	待ちくたびれ
苛む	苛ん
ふみたおす	ふみたおし
切り上げる	切り上げ
はち切れる	はち切れ
取り合わす	取り合わし
借り換える	借り換え
力尽きる	力尽き
みえる	みえ
組み付ける	組み付け
そり返る	そり返っ
作り出す	作り出し
おしこむ	おしこん
せまれる	せまれ
食つなぐ	食つない
擦込む	擦込ん
くむ	くん
相まつ	相まっ
わき起これる	わき起これ
焼ける	焼け
緘する	焼け
貢げる	貢げ
かたづける	かたづけ
まもる	まもっ
ふやす	ふやし
晒す	晒し
たすけあえる	たすけあえ
粘り抜く	粘り抜い
なげつける	なげつけ
引っこ抜く	引っこ抜い
焙じる	焙じ
舞い降りる	舞い降り
やぶける	やぶけ
ときめく	ときめい
引っ掛る	引っ掛っ
聞き糺す	聞き糺し
くる	くっ
みあらわす	みあらわし
ひとりごつ	ひとりごっ
譲り合う	譲り合っ
ツッパる	ツッパっ
策する	ツッパっ
気張る	気張っ
しゃちこ張る	しゃちこ張っ
差合う	差合っ
言い及す	言い及し
伏す	伏し
病みほおける	病みほおけ
取り返す	取り返し
消え入る	消え入っ
こがす	こがし
焼く	焼い
はやし立てる	はやし立て
いきすぎる	いきすぎ
腰かける	腰かけ
かおる	かおっ
にがりきる	にがりきっ
抱きとる	抱きとっ
はじきかえす	はじきかえし
ぶばる	ぶばっ
ながめる	ながめ
潜る	潜っ
惚れ込む	惚れ込ん
掘り下げる	掘り下げ
くばりあるく	くばりあるい
哀しむ	哀しん
向かわる	向かわっ
おし黙る	おし黙っ
追払う	追払っ
ざらつく	ざらつい
滾る	滾っ
褒めそやす	褒めそやし
うばいかえす	うばいかえし
そめなおせる	そめなおせ
優れる	優れ
弾き返す	弾き返し
重んずる	弾き返し
見入る	見入っ
とびつく	とびつい
うりさばく	うりさばい
築き上げる	築き上げ
混ずる	築き上げ
突き除ける	突き除け
分合う	分合っ
とりかえる	とりかえ
水漬く	水漬い
考へる	考へ
洗い落とせる	洗い落とせ
とりこぼす	とりこぼし
かちえる	かちえ
張倒す	張倒し
にあう	にあっ
はねかえる	はねかえっ
とどむる	とどむっ
いみづける	いみづけ
つながる	つながっ
巻き込める	巻き込め
持て囃す	持て囃し
引きずり込める	引きずり込め
報せる	報せ
際す	際し
差しのべる	差しのべ
醸す	醸し
積み上げる	積み上げ
うらぶれる	うらぶれ
うみだせる	うみだせ
かずける	かずけ
見おろせる	見おろせ
ひんする	見おろせ
ひきかえす	ひきかえし
繰入れる	繰入れ
動機付ける	動機付け
存ずる	動機付け
取仕切る	取仕切っ
おいやる	おいやっ
表する	おいやっ
艷めく	艷めい
喋れる	喋れ
かきけせる	かきけせ
聞きいれる	聞きいれ
飛び出せる	飛び出せ
そよぐ	そよい
おおせる	おおせ
よびかわす	よびかわし
向かえる	向かえ
振り上げる	振り上げ
慰める	慰め
にくがる	にくがっ
言いつける	言いつけ
あびせる	あびせ
誘える	誘え
極め込む	極め込ん
くどきおとす	くどきおとし
聞き入る	聞き入っ
呼び上げる	呼び上げ
訝る	訝っ
かつぐ	かつい
引掻く	引掻い
擦切れる	擦切れ
属する	擦切れ
せりあげる	せりあげ
泡だつ	泡だっ
下廻る	下廻っ
失す	失し
討ち取る	討ち取っ
仕組める	仕組め
読み合わせる	読み合わせ
掻っ込む	掻っ込ん
攻め込む	攻め込ん
たたきつける	たたきつけ
ささくれる	ささくれ
いいならわす	いいならわし
売り急ぐ	売り急い
繰りかえる	繰りかえ
ぐする	繰りかえ
轟かす	轟かし
おしはかれる	おしはかれ
曵ける	曵け
忍ばせる	忍ばせ
隣合わせる	隣合わせ
取り合せる	取り合せ
ゆきづまる	ゆきづまっ
組みかえる	組みかえ
ゆうきづける	ゆうきづけ
描く	描い
伸し上がる	伸し上がっ
けおとす	けおとし
取寄せる	取寄せ
たちあがる	たちあがっ
恵む	恵ん
抜け出る	抜け出
引きつける	引きつけ
錆びる	錆び
つらぬく	つらぬい
言いのがれる	言いのがれ
ともなう	ともなっ
繰り上げる	繰り上げ
ねる	ねっ
押しやる	押しやっ
寝かし付ける	寝かし付け
につける	につけ
ならわす	ならわし
ぶりかえす	ぶりかえし
つがう	つがっ
沈める	沈め
ぶんなぐる	ぶんなぐっ
待ちあぐむ	待ちあぐん
やけだされる	やけだされ
取り組める	取り組め
おちつきはらう	おちつきはらっ
断る	断っ
いれる	いれ
冷す	冷し
はねかす	はねかし
諳んじる	諳んじ
くぐまる	くぐまっ
くらむ	くらん
走らす	走らし
さし当たる	さし当たっ
追いこむ	追いこん
引き抜ける	引き抜け
まごつく	まごつい
嚇す	嚇し
叩き込む	叩き込ん
養える	養え
準じる	準じ
かきけす	かきけし
可愛がる	可愛がっ
軽んずる	可愛がっ
飛び交う	飛び交っ
かく	かい
治める	治め
泣き崩れる	泣き崩れ
充てる	充て
誇る	誇っ
浚う	浚っ
明くらす	明くらし
とりおとす	とりおとし
ことわる	ことわっ
交す	交し
拭える	拭え
ひきもどせる	ひきもどせ
むせかえる	むせかえっ
ヤジる	ヤジっ
飽く	飽い
相変わる	相変わっ
呼び寄せる	呼び寄せ
ほほ笑みかける	ほほ笑みかけ
戻る	戻っ
堕する	戻っ
飲める	飲め
きりぬく	きりぬい
写す	写し
むかいあわせる	むかいあわせ
扱きおろす	扱きおろし
震え上がる	震え上がっ
書き落とす	書き落とし
ふまえる	ふまえ
はむかえる	はむかえ
覚す	覚し
彫り込む	彫り込ん
聞きすごす	聞きすごし
空とぼける	空とぼけ
書換える	書換え
ひっぱれる	ひっぱれ
贖う	贖っ
しょする	贖っ
塗り潰す	塗り潰し
はまりこむ	はまりこん
うばいあう	うばいあっ
たどり着く	たどり着い
脱がせる	脱がせ
つけまわす	つけまわし
入替える	入替え
攻め落とす	攻め落とし
積み込める	積み込め
歌い上げる	歌い上げ
見掛ける	見掛け
為遂げる	為遂げ
腹ばう	腹ばっ
燃えさかる	燃えさかっ
へずる	へずっ
うちたおせる	うちたおせ
題す	題し
行ずる	題し
ひょろつく	ひょろつい
精出せる	精出せ
言い尽くす	言い尽くし
てむかう	てむかっ
詰め込む	詰め込ん
喰らう	喰らっ
射掛ける	射掛け
思い返す	思い返し
瀕する	思い返し
ちりはてる	ちりはて
武ばる	武ばっ
跼る	跼っ
残る	残っ
のばす	のばし
つき合う	つき合っ
ときふせる	ときふせ
みこむ	みこん
ひたる	ひたっ
妨げる	妨げ
忍ぶ	忍ん
唱える	唱え
差し出す	差し出し
見上ぐ	見上げ
とおる	とおっ
ねじむける	ねじむけ
どよめく	どよめい
物語る	物語っ
酔払う	酔払っ
はぶける	はぶけ
まいらす	まいらし
長ずる	まいらし
超す	超し
かしらだつ	かしらだっ
かたらう	かたらっ
引つる	引つっ
ききほれる	ききほれ
わきかえる	わきかえっ
掘り返せる	掘り返せ
知らす	知らし
果す	果し
咳きあげる	咳きあげ
燃あがる	燃あがっ
見切る	見切っ
気負う	気負っ
息づまる	息づまっ
仕出かす	仕出かし
たいらげる	たいらげ
見棄てる	見棄て
しかめる	しかめ
散る	散っ
とばせる	とばせ
押し戻す	押し戻し
おしえる	おしえ
陣取る	陣取っ
口説く	口説い
上向ける	上向け
すくえる	すくえ
爪立てる	爪立て
ひっくり返る	ひっくり返っ
引き取れる	引き取れ
蹲う	蹲っ
うずめる	うずめ
見据える	見据え
てなれる	てなれ
ときあるく	ときあるい
取持つ	取持っ
横たわる	横たわっ
おもんじる	おもんじ
溢れる	溢れ
死に果てる	死に果て
立至る	立至っ
亘る	亘っ
手挟む	手挟ん
書留める	書留め
うりはらう	うりはらっ
覆せる	覆せ
抜けでる	抜けで
すり抜ける	すり抜け
売りまくる	売りまくっ
倣う	倣っ
きりさいなむ	きりさいなん
なりさがる	なりさがっ
おきわすれる	おきわすれ
折れ合える	折れ合え
禿げる	禿げ
切りそろえる	切りそろえ
立ち合える	立ち合え
居る	居っ
払う	払っ
盛り潰す	盛り潰し
踏み出せる	踏み出せ
ゆする	踏み出せ
差引く	差引い
太れる	太れ
まきあげる	まきあげ
弄う	弄っ
乗りきる	乗りきっ
汲める	汲め
行く	行っ
いむ	いん
撮む	撮ん
わたれる	わたれ
自惚れる	自惚れ
たびだつ	たびだっ
伝え聞く	伝え聞い
押し切る	押し切っ
わらいとばせる	わらいとばせ
れいする	わらいとばせ
たゆたう	たゆたっ
もだす	もだし
驕る	驕っ
起つ	起っ
ゆわえつける	ゆわえつけ
おれまがる	おれまがっ
たのみこむ	たのみこん
飛び込む	飛び込ん
うちしおれる	うちしおれ
まかりとおる	まかりとおっ
ひび割れる	ひび割れ
なぎふせる	なぎふせ
刳り貫く	刳り貫い
潤む	潤ん
ときはなつ	ときはなっ
際だつ	際だっ
煮つける	煮つけ
吹き払える	吹き払え
へたばる	へたばっ
はばたく	はばたい
切り放す	切り放し
切抜ける	切抜け
競う	競っ
いいかねる	いいかね
とりはなせる	とりはなせ
見倣す	見倣し
煽ぐ	煽い
かばう	かばっ
唆す	唆し
飲干す	飲干し
すわり込む	すわり込ん
狙う	狙っ
とりかこむ	とりかこん
彫りあげる	彫りあげ
打ち合う	打ち合っ
みうける	みうけ
捕れる	捕れ
のりすごす	のりすごし
組み敷く	組み敷い
読みかえる	読みかえ
突き当る	突き当っ
背ける	背け
あるきつかれる	あるきつかれ
そそり立つ	そそり立っ
出直す	出直し
震る	震っ
振い落す	振い落し
舞あがる	舞あがっ
置きかえる	置きかえ
務める	務め
とじこもる	とじこもっ
脹れる	脹れ
やせ衰える	やせ衰え
瞑る	瞑っ
駆け出す	駆け出し
賜ぶ	賜ん
聞外す	聞外し
売り捌く	売り捌い
了する	売り捌い
おきあがる	おきあがっ
切り離せる	切り離せ
据えつける	据えつけ
のびゆく	のびゆき
書き下す	書き下し
司る	司っ
咳きこむ	咳きこん
ひったくる	ひったくっ
みる	み
致す	致し
ごわつく	ごわつい
引っこぬく	引っこぬい
たきあがる	たきあがっ
掻き立てる	掻き立て
いろどる	いろどっ
蔽う	蔽っ
掻い摘む	掻い摘ん
こじれる	こじれ
聞届ける	聞届け
洗上げる	洗上げ
容態ぶる	容態ぶっ
老ける	老け
切り替る	切り替っ
甘やかす	甘やかし
逐う	逐っ
いいかえる	いいかえ
しょうこだてる	しょうこだて
さしこえる	さしこえ
聞及ぶ	聞及ん
ひきわたせる	ひきわたせ
はなれる	はなれ
いさめる	いさめ
抄く	抄い
かけへだたる	かけへだたっ
踏み込む	踏み込ん
くらせる	くらせ
授かる	授かっ
あじわう	あじわっ
戒める	戒め
みとめる	みとめ
おしつける	おしつけ
凹ます	凹まし
塞き上げる	塞き上げ
ふすぼる	ふすぼっ
かせる	かせ
荒らげる	荒らげ
営む	営ん
考え直す	考え直し
おくれる	おくれ
駆込む	駆込ん
あらしまわる	あらしまわっ
居すくまる	居すくまっ
切り開ける	切り開け
払い込む	払い込ん
見つけだす	見つけだし
這い蹲う	這い蹲っ
老いさらばえる	老いさらばえ
閉まる	閉まっ
はなす	はなし
いすわれる	いすわれ
くらわす	くらわし
へしあう	へしあっ
突きつめる	突きつめ
量り込む	量り込ん
とくする	量り込ん
取り戻す	取り戻し
とよむ	とよん
やり込める	やり込め
しゃべる	しゃべっ
嗅ぎ当てる	嗅ぎ当て
巻き起す	巻き起し
ととのえる	ととのえ
噤む	噤ん
調子づく	調子づい
説明かす	説明かし
暮らせる	暮らせ
於く	於い
研ける	研け
なぐりとばす	なぐりとばし
語れる	語れ
行悩む	行悩ん
ふんぎれる	ふんぎれ
持掛ける	持掛け
やけしぬ	やけしん
さしくる	さしくっ
むしる	むしっ
講じる	講じ
張り込む	張り込ん
修まる	修まっ
つれだす	つれだし
みとおす	みとおし
もらえる	もらえ
ふらつく	ふらつい
断わる	断わっ
入れ違う	入れ違っ
おりかえす	おりかえし
当て嵌める	当て嵌め
おちゆく	おちゆき
つくりかえる	つくりかえ
休む	休ん
落ちつける	落ちつけ
つきのめす	つきのめし
古ぼける	古ぼけ
矯める	矯め
折り重なる	折り重なっ
入びたる	入びたっ
たてこもれる	たてこもれ
じょうずる	たてこもれ
あきれはてる	あきれはて
かりだす	かりだし
はみだす	はみだし
参じる	参じ
罷り通る	罷り通っ
醸せる	醸せ
入り組む	入り組ん
うれる	うれ
選る	選っ
しる	しっ
及ぼせる	及ぼせ
絎ける	絎け
除する	絎け
へりくだる	へりくだっ
みゃくうつ	みゃくうっ
はぐくめる	はぐくめ
打てる	打て
だまし込む	だまし込ん
揺るがす	揺るがし
買い替える	買い替え
饗する	買い替え
汗ばむ	汗ばん
ひきぐする	汗ばん
刈る	刈っ
走り出る	走り出
賣れる	賣れ
はめこめる	はめこめ
来たす	来たし
まじわる	まじわっ
突当る	突当っ
かさなる	かさなっ
つりあがる	つりあがっ
はせもどる	はせもどっ
刈り込む	刈り込ん
たおす	たおし
のたうち回る	のたうち回っ
目がける	目がけ
碎ける	碎け
おもいうかべる	おもいうかべ
つっかえせる	つっかえせ
おわる	おわっ
押寄せる	押寄せ
いれあわせる	いれあわせ
凍てる	凍て
鋳る	鋳
効く	効い
爪先立つ	爪先立っ
おこれる	おこれ
申し伝える	申し伝え
生す	生し
閉ざす	閉ざし
焼き付ける	焼き付け
借換える	借換え
坐りこむ	坐りこん
あけわたる	あけわたっ
おしかくせる	おしかくせ
育てる	育て
給ぶ	給ん
書き上げる	書き上げ
えむ	えん
配る	配っ
のりこなす	のりこなし
あゆむ	あゆん
矧げる	矧げ
突っ走る	突っ走っ
さぐりあてる	さぐりあて
飛散る	飛散っ
滅ぼす	滅ぼし
ふかめる	ふかめ
縛する	ふかめ
駈る	駈っ
ほりさげる	ほりさげ
もたせかける	もたせかけ
わらえる	わらえ
こじる	こじっ
泣腫らす	泣腫らし
据付ける	据付け
吐出す	吐出し
焦げる	焦げ
おしつめる	おしつめ
隠れる	隠れ
打倒す	打倒し
踏み鳴らす	踏み鳴らし
寄せ付ける	寄せ付け
切り掛る	切り掛っ
在る	在っ
だきこめる	だきこめ
言いたてる	言いたて
組み合せる	組み合せ
いる	いっ
入れあげる	入れあげ
ごうする	入れあげ
ねいる	ねいっ
亡くなす	亡くなし
暴れる	暴れ
まします	ましまし
ぬきだす	ぬきだし
なげかける	なげかけ
荒れ果てる	荒れ果て
きこしめす	きこしめし
噎せる	噎せ
ひきとれる	ひきとれ
あらしめる	あらしめ
うちくだける	うちくだけ
指す	指し
つどえる	つどえ
変える	変え
どやしつける	どやしつけ
消えうせる	消えうせ
叩き付ける	叩き付け
抜き連ねる	抜き連ね
飛かかる	飛かかっ
突っころばす	突っころばし
のこせる	のこせ
表せる	表せ
であるく	であるい
とりにがす	とりにがし
差入れる	差入れ
とりさばく	とりさばい
取り外せる	取り外せ
まん延する	まん延す
嘶く	嘶い
ぶちかます	ぶちかまし
なでつける	なでつけ
平らぐ	平らい
吊上げる	吊上げ
いとう	いとっ
吹きかける	吹きかけ
くぎる	くぎっ
かい出す	かい出し
こき使える	こき使え
かこえる	かこえ
とりもどせる	とりもどせ
たたかう	たたかっ
なげすてる	なげすて
刺違える	刺違え
汲み込む	汲み込ん
つぶせる	つぶせ
のぼれる	のぼれ
帰る	帰っ
忌み嫌う	忌み嫌っ
熨す	熨し
盛り分ける	盛り分け
なじる	なじっ
ばっする	なじっ
偏する	なじっ
うまれる	うまれ
ぬきとる	ぬきとっ
大人びる	大人び
贏ち得える	贏ち得え
差しいれる	差しいれ
かきつける	かきつけ
うけたまわる	うけたまわっ
捩じる	捩じっ
重ねる	重ね
怖がる	怖がっ
いこう	いこっ
あかるむ	あかるん
行着く	行着い
燃え上がる	燃え上がっ
乗り後れる	乗り後れ
盛りあがる	盛りあがっ
怠る	怠っ
入れ代わる	入れ代わっ
売れ残る	売れ残っ
よりきる	よりきっ
締付ける	締付け
しみつく	しみつい
取り揃える	取り揃え
のりかえる	のりかえ
ふき清める	ふき清め
言い込める	言い込め
諒する	言い込め
寝付ける	寝付け
肥える	肥え
よみあさる	よみあさっ
ののしる	ののしっ
終る	終っ
わりもどす	わりもどし
うちのめす	うちのめし
上り詰めるる	上り詰める
買い漁る	買い漁っ
捨てる	捨て
神さびる	神さび
根ざす	根ざし
添いとげる	添いとげ
さそいこむ	さそいこん
きこえる	きこえ
連れ立つ	連れ立っ
さける	さけ
成りたつ	成りたっ
あけはなす	あけはなし
遊ぶ	遊ん
たちなおれる	たちなおれ
書ける	書け
なぐさめる	なぐさめ
出迎える	出迎え
つくろう	つくろっ
おぎないあう	おぎないあっ
申し送れる	申し送れ
冠す	冠し
仰せつける	仰せつけ
おいまわす	おいまわし
にんじる	にんじ
入れ換える	入れ換え
煮あがる	煮あがっ
滑り出す	滑り出し
もてあそぶ	もてあそん
拭く	拭い
息吹く	息吹い
つれそえる	つれそえ
やしなえる	やしなえ
波立つ	波立っ
駆けずり回る	駆けずり回っ
撲り飛ばす	撲り飛ばし
切り替わる	切り替わっ
ふさがる	ふさがっ
たがやせる	たがやせ
張り付く	張り付い
つぶだつ	つぶだっ
奪い取る	奪い取っ
汲み取る	汲み取っ
泣き叫ぶ	泣き叫ん
巣食う	巣食っ
だべる	だべっ
嵩ずる	だべっ
できる	でき
わかせる	わかせ
ねぢ伏せる	ねぢ伏せ
問詰める	問詰め
ぶらさがれる	ぶらさがれ
たたきだす	たたきだし
だきすくめる	だきすくめ
打ち崩せる	打ち崩せ
切り換える	切り換え
青ばむ	青ばん
ぬすむ	ぬすん
腹だてる	腹だて
借れる	借れ
きわめつくす	きわめつくし
ひきうける	ひきうけ
並び立つ	並び立っ
たてこめる	たてこめ
窺える	窺え
たわむれる	たわむれ
彌増す	彌増し
ほっぽる	ほっぽっ
はねつける	はねつけ
かさねる	かさね
擬する	かさね
うかび出る	うかび出
濁せる	濁せ
扱ぐ	扱い
報じる	報じ
盗み出せる	盗み出せ
褪せる	褪せ
踏ん張れる	踏ん張れ
ねぎれる	ねぎれ
勝誇る	勝誇っ
間違う	間違っ
ずばぬける	ずばぬけ
とりなおす	とりなおし
畳みかける	畳みかけ
あまんずる	畳みかけ
しゃっちょこばる	しゃっちょこばっ
きれる	きれ
くわせる	くわせ
打ち付ける	打ち付け
書取る	書取っ
いける	いけ
結ぶ	結ん
続く	続い
蒔く	蒔い
浮き立てる	浮き立て
くずれる	くずれ
射る	射
抜け出す	抜け出し
におわせる	におわせ
切り崩せる	切り崩せ
読み通す	読み通し
憎まれる	憎まれ
えいずる	憎まれ
預ける	預け
取りしきる	取りしきっ
よせつける	よせつけ
わらわせる	わらわせ
うりだす	うりだし
縛る	縛っ
註する	縛っ
投げ捨てる	投げ捨て
つぐ	つい
のぞむ	のぞん
振り掛ける	振り掛け
上ずる	上ずっ
見出せる	見出せ
揚げる	揚げ
くもらす	くもらし
ゆきかかる	ゆきかかっ
綴合せる	綴合せ
引去る	引去っ
突き戻せる	突き戻せ
相寄る	相寄っ
誤魔化す	誤魔化し
益する	誤魔化し
あかす	あかし
つたえる	つたえ
取止める	取止め
悶える	悶え
えんずる	悶え
害する	悶え
続ける	続け
掠る	掠っ
かいたたける	かいたたけ
思い起こす	思い起こし
習える	習え
のしあるく	のしあるい
せめおとせる	せめおとせ
目差す	目差し
編み込む	編み込ん
たけり立つ	たけり立っ
かしげる	かしげ
みのがせる	みのがせ
のりくめる	のりくめ
はる	はっ
もちいる	もちい
かたむける	かたむけ
読み切る	読み切っ
辞す	辞し
証拠立てる	証拠立て
屈める	屈め
くみあわす	くみあわし
凭せ掛ける	凭せ掛け
かこう	かこっ
がる	がっ
感じ取る	感じ取っ
ひねる	ひね
出外れる	出外れ
立ち後れる	立ち後れ
うつりかわる	うつりかわっ
いいあらわす	いいあらわし
糾う	糾っ
つもる	つもっ
ふんする	つもっ
振りかぶる	振りかぶっ
剥がす	剥がし
そめなおす	そめなおし
賄える	賄え
寫す	寫し
事欠く	事欠い
蒸かす	蒸かし
みのがす	みのがし
明け放つ	明け放っ
持ち運ぶ	持ち運ん
いざる	いざっ
組合せる	組合せ
減じる	減じ
投げ出せる	投げ出せ
見透かせる	見透かせ
にらみあわす	にらみあわし
持ち歩く	持ち歩い
しょびく	しょびい
浮上がる	浮上がっ
かたりこめる	かたりこめ
おもいがける	おもいがけ
とりつげる	とりつげ
なだれ込む	なだれ込ん
かぎる	かぎっ
舞いあがる	舞いあがっ
散らかす	散らかし
ほりおこす	ほりおこし
見付ける	見付け
切り落とす	切り落とし
あかめる	あかめ
生む	生ん
貢ぐ	貢い
おくる	おくっ
攣れる	攣れ
挟まる	挟まっ
とりまぜる	とりまぜ
あみこむ	あみこん
つたえきく	つたえきい
外す	外し
交われる	交われ
わきおこす	わきおこし
煽てる	煽て
きりたつ	きりたっ
替わる	替わっ
舞い狂う	舞い狂っ
憎がる	憎がっ
乗り合わす	乗り合わし
打落とせる	打落とせ
とびたてる	とびたて
見習う	見習っ
くださる	くださっ
ひそむ	ひそん
跳ね除ける	跳ね除け
盗る	盗っ
賑わす	賑わし
褄取る	褄取っ
削ぎ落す	削ぎ落し
会す	会し
踏み抜ける	踏み抜け
仰せつかる	仰せつかっ
さしたてる	さしたて
出し合う	出し合っ
ちょうする	出し合っ
しぬ	しん
ぽしゃる	ぽしゃっ
さしつける	さしつけ
借り入れる	借り入れ
いいだす	いいだし
拗じる	拗じっ
こおる	こおっ
食わせる	食わせ
哀れがる	哀れがっ
煉りあわせる	煉りあわせ
伏拝む	伏拝ん
わかいしあえる	わかいしあえ
問いつめる	問いつめ
浮かれる	浮かれ
わめきたてる	わめきたて
学びとれる	学びとれ
読み下す	読み下し
首肯く	首肯い
請ける	請け
ぶっこぬく	ぶっこぬい
ぬらす	ぬらし
えいじる	えいじ
あれる	あれ
くつがえる	くつがえっ
飛べる	飛べ
曳く	曳い
躍る	躍っ
無くなる	無くなっ
おしすすめる	おしすすめ
ちょうしづく	ちょうしづい
書添える	書添え
法る	法っ
染め直す	染め直し
仄めかす	仄めかし
なみだぐむ	なみだぐん
ゆきなやむ	ゆきなやん
兆す	兆し
わずらいつく	わずらいつい
抱き竦める	抱き竦め
惚れる	惚れ
たえぬく	たえぬい
おしはかる	おしはかっ
たすけあう	たすけあっ
びびる	びびっ
あふれる	あふれ
たちあう	たちあっ
わりこめる	わりこめ
突き破る	突き破っ
ききとがめる	ききとがめ
律す	律し
きづかう	きづかっ
差違える	差違え
引き降ろす	引き降ろし
踏み躙る	踏み躙っ
はやり立つ	はやり立っ
買い込める	買い込め
差し回せる	差し回せ
やせさらばえる	やせさらばえ
就ける	就け
魅せる	魅せ
売り飛ばす	売り飛ばし
こげる	こげ
たちふさがる	たちふさがっ
くじる	くじっ
あいせっする	くじっ
うつる	うつっ
受付ける	受付け
とりしまる	とりしまっ
かちぬく	かちぬい
申し受ける	申し受け
つらぬきとおせる	つらぬきとおせ
おとろえる	おとろえ
まぎる	まぎっ
かわりはてる	かわりはて
かけちがう	かけちがっ
見回れる	見回れ
捩くれる	捩くれ
費やせる	費やせ
たてまつる	たてまつっ
つかう	つかっ
引き去る	引き去っ
推める	推め
引きずり込む	引きずり込ん
乗り越える	乗り越え
指し示せる	指し示せ
ほおえむ	ほおえん
払い込める	払い込め
乾す	乾し
ねざす	ねざし
掘りだす	掘りだし
通わす	通わし
抱き締める	抱き締め
堪へる	堪へ
駆け回る	駆け回っ
攻めかける	攻めかけ
いさみたつ	いさみたっ
讚える	讚え
もちかえれる	もちかえれ
響く	響い
引っ担ぐ	引っ担い
待ちあわせる	待ちあわせ
活かる	活かっ
検める	検め
呑む	呑ん
しだす	しだし
取りさばく	取りさばい
おきなおる	おきなおっ
連添う	連添っ
脱ぎ捨てる	脱ぎ捨て
ふきすさぶ	ふきすさん
噛み砕く	噛み砕い
使い慣れる	使い慣れ
とどく	とどい
入れちがう	入れちがっ
ひっくりかえせる	ひっくりかえせ
くみなおせる	くみなおせ
走り出せる	走り出せ
みくだす	みくだし
かけずりまわる	かけずりまわっ
噛みしだく	噛みしだい
おくりこめる	おくりこめ
位する	おくりこめ
貰える	貰え
意味付ける	意味付け
かくする	意味付け
別ける	別け
下りる	下り
引き摺る	引き摺っ
とりきめる	とりきめ
打勝てる	打勝て
なぞる	なぞっ
急き立てる	急き立て
逃げ失せる	逃げ失せ
嘗める	嘗め
だまる	だまっ
助く	助け
うつれる	うつれ
さししめす	さししめし
逃げ帰る	逃げ帰っ
そそりたてる	そそりたて
よみこなす	よみこなし
ちりのこる	ちりのこっ
いそぐ	いそい
吊り上げる	吊り上げ
償える	償え
うやまう	うやまっ
あげる	あげ
振り起す	振り起し
食い詰める	食い詰め
尊べる	尊べ
傭う	傭っ
おりる	おり
乗り捨てる	乗り捨て
書きためる	書きため
見透かす	見透かし
突刺す	突刺し
頷ける	頷け
つむ	つん
つかみあげる	つかみあげ
見放す	見放し
染め出せる	染め出せ
からびる	からび
差し押さえる	差し押さえ
面食らう	面食らっ
締め切る	締め切っ
切れる	切れ
食い散らす	食い散らし
潤う	潤っ
追いつける	追いつけ
見取る	見取っ
申送る	申送っ
はぎあわせる	はぎあわせ
努める	努め
おおせつける	おおせつけ
向く	向い
乗上げる	乗上げ
足りる	足り
縛める	縛め
歌わす	歌わし
おもんみる	おもんみ
照る	照っ
覚ます	覚まし
見ほれる	見ほれ
より抜く	より抜い
駆集める	駆集め
とめおく	とめおい
逞しゅうする	とめおい
とりはずす	とりはずし
睨みつける	睨みつけ
聞きただせる	聞きただせ
はいずる	はいずっ
ゆきかう	ゆきかっ
比する	ゆきかっ
けちがえる	けちがえ
まさぐる	まさぐっ
示し合わす	示し合わし
植え込む	植え込ん
諮る	諮っ
よじのぼれる	よじのぼれ
預る	預っ
打ちすえる	打ちすえ
はだける	はだけ
写し出せる	写し出せ
ききだす	ききだし
あばきだす	あばきだし
投げ付ける	投げ付け
あまやかす	あまやかし
譬える	譬え
難ずる	譬え
のみくだす	のみくだし
つむぐ	つむい
飛び退く	飛び退い
える	え
ひったてる	ひったて
みがける	みがけ
はさむ	はさん
ほこれる	ほこれ
譲る	譲っ
行き違う	行き違っ
落とし込む	落とし込ん
懸る	懸っ
尋ねあわせる	尋ねあわせ
添い遂げる	添い遂げ
踏み締める	踏み締め
飛下りる	飛下り
落くぼむ	落くぼん
呑みつぶす	呑みつぶし
立ち回る	立ち回っ
降注ぐ	降注い
とりもつ	とりもっ
跳べる	跳べ
乗合せる	乗合せ
呑みつぶれる	呑みつぶれ
遣り返す	遣り返し
能う	能っ
きりふせる	きりふせ
呑める	呑め
へしおる	へしおっ
まいもどる	まいもどっ
示す	示し
とびかかれる	とびかかれ
つまされる	つまされ
統べくくる	統べくくっ
積み替える	積み替え
召し上がる	召し上がっ
はりさける	はりさけ
起こせる	起こせ
抜かる	抜かっ
はしらす	はしらし
へばる	へばっ
ふみしめる	ふみしめ
しにおくれる	しにおくれ
和える	和え
巻く	巻い
溶け合う	溶け合っ
墜ちる	墜ち
ふんぎる	ふんぎっ
焼切る	焼切っ
駄べる	駄べっ
ゆきくらす	ゆきくらし
収める	収め
道行く	道行き
わび入る	わび入っ
とじこめる	とじこめ
もたれる	もたれ
よなれる	よなれ
ける	けっ
解せる	解せ
なだれこむ	なだれこん
讀む	讀ん
とりもてる	とりもて
寝る	寝
ほろぼす	ほろぼし
臥す	臥し
すごむ	すごん
威かす	威かし
見返せる	見返せ
めでる	めで
商う	商っ
まびく	まびい
付き合う	付き合っ
親しむ	親しん
解き明かす	解き明かし
しいる	しい
切り苛む	切り苛ん
ゆるす	ゆるし
掘る	掘っ
怖気立つ	怖気立っ
はりつく	はりつい
擦れ合う	擦れ合っ
見晴かす	見晴かし
やとう	やとっ
吹き掛ける	吹き掛け
くりのべる	くりのべ
浮かれ出す	浮かれ出し
漏らす	漏らし
支払える	支払え
蹴破る	蹴破っ
せりあう	せりあっ
投捨てる	投捨て
固まる	固まっ
届出る	届出
卸す	卸し
吟じる	吟じ
よたる	よたっ
乗りこえる	乗りこえ
憩う	憩う
しらばくれる	しらばくれ
出合える	出合え
付入る	付入っ
均す	均し
元気づける	元気づけ
打ち明ける	打ち明け
言いあわせる	言いあわせ
ほどける	ほどけ
浮かび上がれる	浮かび上がれ
つけ廻す	つけ廻し
どくづく	どくづい
おっしゃれる	おっしゃれ
啀み合う	啀み合っ
押しつぶす	押しつぶし
ひからす	ひからし
押し黙る	押し黙っ
ねじ込める	ねじ込め
くりさげる	くりさげ
たちあえる	たちあえ
思し召す	思し召し
かかわる	かかわっ
群だつ	群だち
ありえる	ありえ
かぞえあげる	かぞえあげ
来る	来っ
見合う	見合っ
取巻く	取巻い
切りぬく	切りぬい
いそげる	いそげ
時化る	時化
召し出す	召し出し
うけひく	うけひい
切りはずせる	切りはずせ
奮いたつ	奮いたっ
扼する	奮いたっ
生まれ落ちる	生まれ落ち
かなえる	かなえ
なげる	なげ
あてはめる	あてはめ
冠する	あてはめ
ゆきすぎる	ゆきすぎ
よりかかる	よりかかっ
とべる	とべ
取り計らう	取り計らっ
見違える	見違え
立つくす	立つくし
成る	成っ
ボヤく	ボヤい
持ちかける	持ちかけ
煙たがる	煙たがっ
読みこなせる	読みこなせ
書き流す	書き流し
沁みる	沁み
押しわける	押しわけ
切り崩す	切り崩し
慣れる	慣れ
学び取れる	学び取れ
かつぎ込める	かつぎ込め
借り切る	借り切っ
とりしきる	とりしきっ
起き出す	起き出し
にらみ合せる	にらみ合せ
せっする	にらみ合せ
曲がりくねる	曲がりくねっ
ひらつく	ひらつい
みこす	みこし
暈ける	暈け
編み上げる	編み上げ
かけぬける	かけぬけ
ふるいおとす	ふるいおとし
かじかむ	かじかん
せがむ	せがん
奥まる	奥まっ
ゆみひく	ゆみひい
備付ける	備付け
かかす	かかし
うつぶす	うつぶし
はやりたつ	はやりたっ
見合わす	見合わし
染み渡る	染み渡っ
綯う	綯っ
そめだす	そめだし
ふっかける	ふっかけ
埋め合す	埋め合し
かくしきばる	かくしきばっ
押し詰まる	押し詰まっ
蹴躓く	蹴躓い
ぬぐいさる	ぬぐいさっ
まごう	まごっ
外せる	外せ
承る	承っ
抜き取れる	抜き取れ
のっける	のっけ
どる	どっ
出遅れる	出遅れ
たくしこむ	たくしこん
産気づく	産気づい
みとどける	みとどけ
振り回す	振り回し
例える	例え
すいとれる	すいとれ
脇挟む	脇挟ん
差し支える	差し支え
浮ぶ	浮ん
動ける	動け
吹き払う	吹き払っ
やくす	やくし
言渡す	言渡し
ほっとく	ほっとい
仕込む	仕込ん
立ち至る	立ち至っ
折れ合う	折れ合っ
燻べる	燻べ
誘う	誘っ
あらたまる	あらたまっ
造り出す	造り出し
あそびまわる	あそびまわっ
計らえる	計らえ
ため込む	ため込ん
きおいたつ	きおいたっ
たまう	たまっ
死に損なう	死に損なっ
わるびれる	わるびれ
ひねこびる	ひねこび
よりぬける	よりぬけ
まちぶせる	まちぶせ
銜える	銜え
のぞく	のぞい
うらがえせる	うらがえせ
瘠せる	瘠せ
手懸ける	手懸け
はじめる	はじめ
いとおしむ	いとおしん
奮い起こせる	奮い起こせ
わけあたえる	わけあたえ
取混ぜる	取混ぜ
突き進める	突き進め
生ながらえる	生ながらえ
でしゃばる	でしゃばっ
ぞめく	ぞめい
しばたく	しばたい
立て込める	立て込め
かけあえる	かけあえ
ふりみだす	ふりみだし
抱き起こす	抱き起こし
行き悩む	行き悩ん
咲き匂う	咲き匂っ
おそわる	おそわっ
やかす	やかし
濯う	濯っ
ねりなおせる	ねりなおせ
いいかわす	いいかわし
隣り合わす	隣り合わし
飛びつく	飛びつい
泊まる	泊まっ
悔やむ	悔やん
探す	探し
やりなおせる	やりなおせ
おしだせる	おしだせ
閉じる	閉じ
出っぱる	出っぱっ
掠れる	掠れ
せく	せい
弾き返せる	弾き返せ
くだせる	くだせ
召しあがる	召しあがっ
傳える	傳え
もちよる	もちよっ
立向かう	立向かっ
春めく	春めい
ころす	ころし
嗅ぎ出す	嗅ぎ出し
培う	培っ
降り掛かる	降り掛かっ
剽げる	剽げ
造りあげる	造りあげ
ときはなす	ときはなし
取下げる	取下げ
おもる	おもっ
つめる	つめ
ほうむる	ほうむっ
刻み込む	刻み込ん
廃する	刻み込ん
遅れる	遅れ
つけあわせる	つけあわせ
撲り付ける	撲り付け
いいおく	いいおい
荒す	荒し
書き記せる	書き記せ
揃う	揃っ
しのびこむ	しのびこん
投じる	投じ
填め込む	填め込ん
もてる	もて
うりわたす	うりわたし
銜める	銜め
買い上げる	買い上げ
寝つける	寝つけ
染みつく	染みつい
取り集める	取り集め
すぎゆく	すぎゆき
耳馴れる	耳馴れ
ゆるまる	ゆるまっ
練り合せる	練り合せ
途切れる	途切れ
かいすすむ	かいすすん
狂わせる	狂わせ
興せる	興せ
停める	停め
け落とす	け落とし
燃す	燃し
のぼる	のぼっ
のぼりつめる	のぼりつめ
うれのこる	うれのこっ
酔っ払う	酔っ払っ
嘆ずる	酔っ払っ
あけくれる	あけくれ
たちまじる	たちまじっ
くりあげる	くりあげ
攻懸ける	攻懸け
言い交す	言い交し
かぞえたてる	かぞえたて
ふさぎこむ	ふさぎこん
伝へる	伝へ
冲する	伝へ
むき出す	むき出し
きりおとせる	きりおとせ
とじる	とじ
着せる	着せ
怨する	着せ
かいま見る	かいま見
いいふくめる	いいふくめ
けむたがる	けむたがっ
紛れる	紛れ
取付ける	取付け
築く	築い
拓ける	拓け
引き離す	引き離し
凝固まる	凝固まっ
焼き付く	焼き付い
痛めつける	痛めつけ
着替える	着替え
かためる	かため
気構える	気構え
突っつく	突っつい
すりあがる	すりあがっ
引下がる	引下がっ
いこう	いこう
かぎ出す	かぎ出し
ぼやかす	ぼやかし
みつける	みつけ
綾取る	綾取っ
申し出る	申し出
すっぱぬく	すっぱぬい
降らす	降らし
すっぱ抜く	すっぱ抜い
迂る	迂っ
すき通る	すき通っ
献じる	献じ
ぶっ殺す	ぶっ殺し
支払う	支払っ
打破れる	打破れ
産み落す	産み落し
ふりかえる	ふりかえ
出尽くす	出尽くし
つけいる	つけいっ
もてはやす	もてはやし
含める	含め
困じる	困じ
かりる	かり
救い出す	救い出し
気に入る	気に入っ
窮する	気に入っ
ばる	ばっ
はしりぬく	はしりぬい
捲く	捲い
てりはえる	てりはえ
おもてだつ	おもてだっ
ちかよれる	ちかよれ
零す	零し
膿む	膿ん
鋤く	鋤い
せおう	せおっ
はりきる	はりきっ
入れ忘れる	入れ忘れ
きずきあげる	きずきあげ
決込む	決込ん
落ち行く	落ち行き
危惧す	危惧し
おいこせる	おいこせ
貸し付ける	貸し付け
連立つ	連立っ
むすぼれる	むすぼれ
差越す	差越し
芽ばえる	芽ばえ
まぜあわせる	まぜあわせ
汲み干す	汲み干し
執り行う	執り行っ
領する	執り行っ
走り去る	走り去っ
やり合う	やり合っ
見守る	見守っ
取鎮める	取鎮め
りょうする	取鎮め
ほる	ほっ
条件付ける	条件付け
時めく	時めい
ともなえる	ともなえ
たいおうづける	たいおうづけ
つりだす	つりだし
障る	障っ
ぞうする	障っ
投げかける	投げかけ
たれこむ	たれこん
およぎつく	およぎつい
捕らえる	捕らえ
つみこめる	つみこめ
たすけだせる	たすけだせ
待受ける	待受け
おびきよせる	おびきよせ
順序づける	順序づけ
あまったれる	あまったれ
とおす	とおし
空嘯く	空嘯い
追い抜ける	追い抜け
夏めく	夏めい
乗掛ける	乗掛け
請け負える	請け負え
据える	据え
毀す	毀し
笑う	笑っ
なみいる	なみい
笑いこける	笑いこけ
差しかかる	差しかかっ
引っ下げる	引っ下げ
そそる	そそっ
殺る	殺っ
おびき出す	おびき出し
おっぽりだす	おっぽりだし
乗れる	乗れ
延びる	延び
つりあげる	つりあげ
やきつく	やきつい
はにかむ	はにかん
向き合える	向き合え
研く	研い
探しあてる	探しあて
捩じ切る	捩じ切っ
先ばしる	先ばしっ
請け合える	請け合え
いかす	いかし
名乗り出る	名乗り出
混む	混ん
すっぱ抜ける	すっぱ抜け
揉める	揉め
まよいこむ	まよいこん
乱れ飛ぶ	乱れ飛ん
則す	則し
当たる	当たっ
焼け死ぬ	焼け死ん
浮足立つ	浮足立っ
はずせる	はずせ
死そこなう	死そこなっ
寄り合う	寄り合っ
つつめる	つつめ
取調べる	取調べ
列なる	列なっ
題する	列なっ
はらいのける	はらいのけ
なげとばせる	なげとばせ
えきする	なげとばせ
督する	なげとばせ
振り向ける	振り向け
ならす	ならし
はさみこむ	はさみこん
とりのける	とりのけ
たっとぶ	たっとん
付く	付い
寄り倒せる	寄り倒せ
嫉む	嫉ん
くたばる	くたばっ
加わる	加わっ
汲み上げる	汲み上げ
乗りはずす	乗りはずし
はらむ	はらん
絞りあげる	絞りあげ
出食わす	出食わし
くんずる	出食わし
済ませる	済ませ
なしとげる	なしとげ
釣る	釣っ
富む	富ん
取計らう	取計らっ
そばだてる	そばだて
ほつす	ほつし
切り出せる	切り出せ
流れ着ける	流れ着け
言い終わる	言い終わっ
駆けつける	駆けつけ
みなせる	みなせ
のく	のい
くぼむ	くぼん
読み取る	読み取っ
うたえる	うたえ
にげまわれる	にげまわれ
類する	にげまわれ
立つ	立っ
おっしゃる	おっしゃっ
弱る	弱っ
サジェストする	弱っ
写し取る	写し取っ
泣き暮す	泣き暮し
受け流す	受け流し
サボる	サボっ
張合う	張合っ
絆される	絆され
張り替える	張り替え
引き渡せる	引き渡せ
掻い潜る	掻い潜っ
もれる	もれ
ききあわす	ききあわし
もらえる	もらえ
差し迫る	差し迫っ
撲る	撲っ
擲つ	擲っ
割り振る	割り振っ
鳴りわたる	鳴りわたっ
ちがえる	ちがえ
しだれる	しだれ
くるめる	くるめ
いざなう	いざなっ
ごまかせる	ごまかせ
囁く	囁い
ずれる	ずれ
あけのこる	あけのこっ
ひきつげる	ひきつげ
すべらす	すべらし
ぶん殴る	ぶん殴っ
言い古す	言い古し
ついて行く	ついて行っ
立直す	立直し
まにあう	まにあっ
下がる	下がっ
吹かす	吹かし
住み馴れる	住み馴れ
はじる	はじ
見せ掛ける	見せ掛け
ぶった斬る	ぶった斬っ
こたえる	こたえ
蒸返す	蒸返し
踏み倒せる	踏み倒せ
鳴き頻る	鳴き頻っ
たどる	たどっ
時代掛る	時代掛っ
踊りあかす	踊りあかし
踏みこむ	踏みこん
吹きこぼれる	吹きこぼれ
頭立つ	頭立っ
おびきだす	おびきだし
もの問う	もの問っ
つぎこめる	つぎこめ
そくする	つぎこめ
貯まる	貯まっ
すりぬける	すりぬけ
比える	比え
くり貫ける	くり貫け
かすれる	かすれ
格式張る	格式張っ
ふくらす	ふくらし
なんずる	ふくらし
踏こたえる	踏こたえ
踊れる	踊れ
書き残せる	書き残せ
なきふせる	なきふせ
逃うせる	逃うせ
たせる	たせ
休める	休め
いわう	いわっ
攻寄る	攻寄っ
そびれる	そびれ
ねすごす	ねすごし
聞き漏らす	聞き漏らし
溶ける	溶け
うつりすむ	うつりすん
贈る	贈っ
受け引く	受け引い
上回る	上回っ
とびこす	とびこし
あぐむ	あぐん
もうける	もうけ
ありふれる	ありふれ
はみでる	はみで
起こる	起こっ
裏付ける	裏付け
こくする	裏付け
とりたてる	とりたて
馴らす	馴らし
たける	たけっ
くみしく	くみしい
隔たる	隔たっ
つぎ足す	つぎ足し
みそれる	みそれ
ちぬる	ちぬっ
にせる	にせ
鳴かせる	鳴かせ
裏づける	裏づけ
こぎつける	こぎつけ
絡み合う	絡み合っ
鳴ける	鳴け
賑わわす	賑わわし
いいあてる	いいあて
解ける	解け
差かかる	差かかっ
住み荒らす	住み荒らし
ねしずまる	ねしずまっ
染める	染め
打ちきる	打ちきっ
とりあつかう	とりあつかっ
先んじる	先んじ
世馴れる	世馴れ
はぶく	はぶい
写し取れる	写し取れ
うえこむ	うえこん
泣き込む	泣き込ん
突っ張る	突っ張っ
すいこむ	すいこん
まぬがれる	まぬがれ
引替える	引替え
とおりぬける	とおりぬけ
適する	とおりぬけ
打明ける	打明け
思いこむ	思いこん
博する	思いこん
満ちる	満ち
むけなおす	むけなおし
白ける	白け
申しつける	申しつけ
すすばむ	すすばん
ゆきつく	ゆきつい
いいくらす	いいくらし
はい出す	はい出し
生み出す	生み出し
たのみいる	たのみいっ
まぎれこめる	まぎれこめ
はばたける	はばたけ
差し掛る	差し掛っ
かきあらわせる	かきあらわせ
こめる	こめ
とりだす	とりだし
せめあう	せめあっ
きる	き
こまねく	こまねい
信じる	信じ
込入る	込入っ
ほろぶ	ほろん
論ずる	ほろん
うちかてる	うちかて
おりかさねる	おりかさね
ぶり返す	ぶり返し
広まる	広まっ
引きちぎる	引きちぎっ
突ける	突け
がさつく	がさつい
恋いこがれる	恋いこがれ
ふっきる	ふっきっ
頼れる	頼れ
召寄せる	召寄せ
ひえこむ	ひえこん
顰める	顰め
踏みにじれる	踏みにじれ
食いつなぐ	食いつない
そうけだつ	そうけだっ
取り付く	取り付い
たてかける	たてかけ
かきわける	かきわけ
聴き込む	聴き込ん
あやかる	あやかっ
説きあるく	説きあるい
ふりきる	ふりきっ
せめよる	せめよっ
蒸れる	蒸れ
あらいおとせる	あらいおとせ
連れ出す	連れ出し
よりきれる	よりきれ
言いくらす	言いくらし
のっとる	のっとっ
抱える	抱え
へし合う	へし合っ
とりはらう	とりはらっ
冷やかせる	冷やかせ
嘆き明かす	嘆き明かし
刈取る	刈取っ
ともる	ともっ
称する	ともっ
ほっつく	ほっつい
撃ちまくる	撃ちまくっ
ほろびる	ほろび
みまわれる	みまわれ
かさむ	かさん
融ける	融け
申し送る	申し送っ
売り付ける	売り付け
だしぬける	だしぬけ
ひっくりかえる	ひっくりかえっ
詰め替える	詰め替え
問える	問え
刻する	問え
踏みつける	踏みつけ
信じ込む	信じ込ん
照り返す	照り返し
選り分ける	選り分け
くいる	くい
ゆうする	くい
乗入れる	乗入れ
注する	乗入れ
ゆるぐ	ゆるい
断ち割れる	断ち割れ
受け持てる	受け持て
吹き荒れる	吹き荒れ
見えすく	見えすい
となりあわせる	となりあわせ
あいなる	あいなっ
求める	求め
置き換わる	置き換わっ
たれる	たれ
うら枯れる	うら枯れ
沸き起こる	沸き起こっ
ねぐる	ねぐっ
押し広める	押し広め
みすます	みすまし
樵る	樵っ
寝せる	寝せ
吹き返す	吹き返し
ささえる	ささえ
染めあげる	染めあげ
とりかえせる	とりかえせ
もりつける	もりつけ
索く	索い
ちぎれる	ちぎれ
脂ぎる	脂ぎっ
思い描く	思い描い
ぬかる	ぬかっ
かいとる	かいとっ
かもす	かもし
くつろげる	くつろげ
そびえる	そびえ
遮る	遮っ
くつろぐ	くつろい
遊び呆ける	遊び呆け
明ける	明け
につく	につい
せき入る	せき入っ
澄み渡る	澄み渡っ
ひきだす	ひきだし
言う	言う
のさばる	のさばっ
みちる	みち
ひらける	ひらけ
鼻白む	鼻白ん
いてる	いて
馴れる	馴れ
なまめく	なまめい
くれる	くれ
おしかぶさる	おしかぶさっ
まくし立てる	まくし立て
接ぎ合わせる	接ぎ合わせ
かきおろす	かきおろし
差止める	差止め
きりかける	きりかけ
絶え入る	絶え入っ
浮き上がれる	浮き上がれ
持ち切る	持ち切っ
拵える	拵え
かみころせる	かみころせ
あきれかえる	あきれかえっ
はげ上がる	はげ上がっ
とり成す	とり成し
慨する	とり成し
飲み干せる	飲み干せ
揺出る	揺出
付け入る	付け入っ
かぎだせる	かぎだせ
おもねる	おもねっ
拐かす	拐かし
ねむらせる	ねむらせ
しゃべれる	しゃべれ
云う	云っ
さしまわす	さしまわし
噴く	噴い
呼び交す	呼び交し
あなどれる	あなどれ
ぶっつかる	ぶっつかっ
立ち添う	立ち添っ
重る	重っ
くみだせる	くみだせ
すすみでる	すすみで
架する	すすみで
復す	復し
ふける	ふけっ
嗅ぎ付ける	嗅ぎ付け
事える	事え
希う	希っ
酌み交す	酌み交し
聞かす	聞かし
進み出る	進み出
さまよう	さまよう
敷ける	敷け
吸う	吸う
みじろぐ	みじろい
もりあわす	もりあわし
ぶったくる	ぶったくっ
ついてる	ついて
ばらまく	ばらまい
かぎあてる	かぎあて
かち取る	かち取っ
つなぐ	つない
漬込む	漬込ん
引き続ける	引き続け
追使う	追使っ
乗り遅れる	乗り遅れ
放り込む	放り込ん
差し当る	差し当っ
讒する	差し当っ
見える	見え
見越せる	見越せ
聴き入る	聴き入っ
仕掛る	仕掛
混じえる	混じえ
しぼりとれる	しぼりとれ
ふきとれる	ふきとれ
剃り忘れる	剃り忘れ
こんずる	剃り忘れ
たわめる	たわめ
創れる	創れ
締める	締め
取りはずす	取りはずし
談じ込む	談じ込ん
決定づける	決定づけ
出し抜ける	出し抜け
だきおこせる	だきおこせ
言い落す	言い落し
吹き抜ける	吹き抜け
あざむく	あざむい
言い合う	言い合っ
うぬぼれる	うぬぼれ
浮き出る	浮き出
埋めあわせる	埋めあわせ
かき揚げる	かき揚げ
はぐくむ	はぐくん
取り残す	取り残し
見澄ます	見澄まし
うちだせる	うちだせ
ことなる	ことなっ
捕える	捕え
空うそぶく	空うそぶい
遠のく	遠のい
先立てる	先立て
練れる	練れ
さとせる	さとせ
いりまじる	いりまじっ
留まれる	留まれ
突き破れる	突き破れ
取り逃す	取り逃し
よじる	よじ
お目にかかる	お目にかかっ
じゃらす	じゃらし
濁らす	濁らし
聞出す	聞出し
促す	促し
飲み乾す	飲み乾し
深ける	深け
うなづく	うなづい
とびあがる	とびあがっ
寄添う	寄添っ
拝み倒す	拝み倒し
とおざかる	とおざかっ
映し出せる	映し出せ
行暮れる	行暮れ
買い付ける	買い付け
ひきいる	ひきい
くりかえる	くりかえ
ハヤる	ハヤっ
呑み潰れる	呑み潰れ
あらいあげる	あらいあげ
焼き捨てる	焼き捨て
しにそこなう	しにそこなっ
伸びる	伸び
乗る	乗っ
睨み付ける	睨み付け
しなだれる	しなだれ
取り込む	取り込ん
引き締る	引き締っ
差換える	差換え
捩じ込む	捩じ込ん
払いのける	払いのけ
煮立つ	煮立っ
さそいかける	さそいかけ
被せる	被せ
くつがえせる	くつがえせ
そぼふる	そぼふっ
はげあがる	はげあがっ
聞く	聞い
あたれる	あたれ
懲らしめる	懲らしめ
そめわける	そめわけ
差掛る	差掛っ
折合う	折合っ
託する	折合っ
ぬいあげる	ぬいあげ
乗り合せる	乗り合せ
うたいあげる	うたいあげ
なきわめく	なきわめい
書きつける	書きつけ
締出す	締出し
無くする	締出し
けいする	締出し
にじり寄る	にじり寄っ
辿れる	辿れ
苦りきる	苦りきっ
ひやかす	ひやかし
愚痴る	愚痴っ
毟る	毟っ
打ち倒す	打ち倒し
てきする	打ち倒し
えがきだせる	えがきだせ
遣り遂げる	遣り遂げ
稔る	稔っ
きりこめる	きりこめ
よみあげる	よみあげ
いつわる	いつわっ
たれこめる	たれこめ
飛かける	飛かけっ
取り締まる	取り締まっ
ずらせる	ずらせ
とりされる	とりされ
買いたたける	買いたたけ
いこぼれる	いこぼれ
くみする	いこぼれ
浮かせる	浮かせ
応える	応え
侵せる	侵せ
そそりたつ	そそりたっ
探り出す	探り出し
言い交わす	言い交わし
ぬくもる	ぬくもっ
持崩す	持崩し
ちぢみあがる	ちぢみあがっ
窄む	窄ん
厭う	厭っ
はやらす	はやらし
おっぱじめる	おっぱじめ
望める	望め
なりひびく	なりひびい
証する	なりひびい
省ける	省け
たまる	たまっ
あらいたてる	あらいたて
逃げ回れる	逃げ回れ
うちころす	うちころし
張付ける	張付け
すすめる	すすめ
懲らす	懲らし
涌く	涌い
しょうする	涌い
はしりだす	はしりだし
しわばむ	しわばん
心がける	心がけ
突抜ける	突抜け
為さる	為さっ
擦りむく	擦りむい
売り抜ける	売り抜け
つうがる	つうがっ
すみかえる	すみかえ
あらせる	あらせ
さわぎたてる	さわぎたて
得る	さわぎたて
なつける	なつけ
染返す	染返し
立ち上る	立ち上っ
あわだてる	あわだて
よみながす	よみながし
下びる	下び
おさめる	おさめ
張り巡らせる	張り巡らせ
ひろがる	ひろがっ
ぎむづける	ぎむづけ
かりあつめる	かりあつめ
行き逢う	行き逢っ
闌ける	闌け
溜まる	溜まっ
心する	溜まっ
修める	修め
みほれる	みほれ
でっちあげる	でっちあげ
すくいだす	すくいだし
困り果てる	困り果て
受け付ける	受け付け
申し述べる	申し述べ
問い質す	問い質し
捧ぐ	捧げ
燃え盛る	燃え盛っ
寄せつける	寄せつけ
篭もれる	篭もれ
鳴り響く	鳴り響い
蹴っ飛ばす	蹴っ飛ばし
いきづく	いきづい
こまりぬく	こまりぬい
沁む	沁ん
うちたおす	うちたおし
触れ合う	触れ合っ
持ちこたえる	持ちこたえ
馳せる	馳せ
おりこむ	おりこん
ふく	ふい
振回す	振回し
ねがえる	ねがえっ
こづきまわす	こづきまわし
火取る	火取っ
履違える	履違え
とりもどす	とりもどし
乗じる	乗じ
切る	切っ
ひろめる	ひろめ
引き出せる	引き出せ
弥立つ	弥立っ
かち得る	かち得
啄める	啄め
かきくどく	かきくどい
取り捨てる	取り捨て
めぐらす	めぐらし
差しかざす	差しかざし
よる	よっ
召抱える	召抱え
ひかえる	ひかえ
きかざる	きかざっ
下押す	下押し
押し下げる	押し下げ
ねとぼける	ねとぼけ
やじれる	やじれ
急く	急い
しかれる	しかれ
いきりたつ	いきりたっ
細る	細っ
とろかす	とろかし
取り計らえる	取り計らえ
刺せる	刺せ
聞きあわせる	聞きあわせ
くずれおちる	くずれおち
はげむ	はげん
ほうこうづける	ほうこうづけ
語り掛ける	語り掛け
埋ける	埋け
這出る	這出
跳あがる	跳あがっ
もげる	もげ
アガる	アガっ
落ちつく	落ちつい
しぼりあげる	しぼりあげ
込む	込ん
踏込む	踏込ん
めくれる	めくれ
飛付く	飛付い
引渡す	引渡し
絞まる	絞まっ
寝転がる	寝転がっ
ぬけあがる	ぬけあがっ
示し合わせる	示し合わせ
漬けこむ	漬けこん
実る	実っ
いく	いい
特徴付ける	特徴付け
送りだす	送りだし
住める	住め
縮みあがる	縮みあがっ
よみこめる	よみこめ
買い尽くす	買い尽くし
衝ける	衝け
またがる	またがっ
はぜる	はぜ
まなびとる	まなびとっ
乗り過ごす	乗り過ごし
並ぶ	並ん
取り離せる	取り離せ
孕む	孕ん
いりこむ	いりこん
いきごむ	いきごん
よみあわせる	よみあわせ
くらえる	くらえ
吹き出す	吹き出し
ひきずりこめる	ひきずりこめ
おきだす	おきだし
呈す	呈し
起き上がる	起き上がっ
降り頻る	降り頻っ
さえぎれる	さえぎれ
ためせる	ためせ
委ねる	委ね
引き繕う	引き繕っ
ひびく	ひびい
殖やす	殖やし
連れ添う	連れ添っ
いばる	いばっ
もりあげる	もりあげ
立て替える	立て替え
甘んじる	甘んじ
掃ける	掃け
浮かれ出でる	浮かれ出で
底知る	底知っ
散りばめる	散りばめ
乗切る	乗切っ
ぬいこめる	ぬいこめ
いんする	ぬいこめ
鳴く	鳴い
通す	通し
ひろいあげる	ひろいあげ
稼げる	稼げ
待ち望む	待ち望ん
登る	登っ
超せる	超せ
みむく	みむい
寝つく	寝つい
言合う	言合っ
なずむ	なずん
臨む	臨ん
押し倒す	押し倒し
飛歩く	飛歩い
駈ける	駈け
引き摺り込む	引き摺り込ん
悄げる	悄げ
でまわる	でまわっ
織り成す	織り成し
つっつく	つっつい
致す	致し
根付く	根付い
きりかえる	きりかえ
はぎあわす	はぎあわし
言含める	言含め
うとむ	うとん
寄すがる	寄すがっ
謗る	謗っ
閉こもる	閉こもっ
みあげる	みあげ
追いたてる	追いたて
うかる	うかっ
攻立てる	攻立て
抱きすくめる	抱きすくめ
間ぎる	間ぎっ
ながれだす	ながれだし
払い出せる	払い出せ
蒸し返す	蒸し返し
回れる	回れ
みなぎる	みなぎっ
曝せる	曝せ
まぜる	まぜ
こぼれ落ちる	こぼれ落ち
頼み込める	頼み込め
まちわびる	まちわび
引止める	引止め
寸たる	寸たっ
薦める	薦め
押す	押し
合わさる	合わさっ
歩む	歩ん
如く	如い
鞘走る	鞘走っ
まんずる	鞘走っ
こごめる	こごめ
ふらせる	ふらせ
すわれる	すわれ
連込む	連込ん
在す	在し
みだす	みだし
こわれる	こわれ
磨り潰す	磨り潰し
あぶる	あぶっ
利かす	利かし
売りとばす	売りとばし
そんする	売りとばし
つみかさなる	つみかさなっ
仕える	仕え
拗る	拗っ
買受ける	買受け
透く	透い
怒鳴る	怒鳴っ
萎びる	萎び
扱う	扱っ
ながれつく	ながれつい
られる	られ
切込む	切込ん
差し置く	差し置い
見返る	見返っ
まさる	まさっ
鎧う	鎧っ
早まる	早まっ
隠せる	隠せ
熟む	熟ん
しがみつける	しがみつけ
ついえる	ついえ
かむる	かむっ
呵する	かむっ
討ちとる	討ちとっ
しるせる	しるせ
血塗る	血塗っ
降り敷く	降り敷い
書く	書い
嵩じる	嵩じ
もちあがる	もちあがっ
吸う	吸っ
もだえる	もだえ
追い回せる	追い回せ
食わす	食わし
思す	思し
書きいれる	書きいれ
ふきとばす	ふきとばし
感じ取れる	感じ取れ
いいふらす	いいふらし
散り敷く	散り敷い
奪う	奪っ
ねぎらう	ねぎらっ
働く	働い
競える	競え
たかまる	たかまっ
捻れる	捻れ
そだてあげる	そだてあげ
縺れる	縺れ
亙れる	亙れ
よみとる	よみとっ
あかじみる	あかじみ
はりたおす	はりたおし
取揃える	取揃え
くくめる	くくめ
差しかける	差しかけ
とどろかす	とどろかし
もやす	もやし
伸す	伸し
討ち果す	討ち果し
むかえうつ	むかえうっ
もつれこむ	もつれこん
寄付く	寄付い
あげつらう	あげつらっ
しゃする	あげつらっ
偲べる	偲べ
てらせる	てらせ
移り住む	移り住ん
延す	延し
そらす	そらし
惘れる	惘れ
言い替える	言い替え
屈す	屈し
寿ぐ	寿い
際立つ	際立っ
違える	違え
そそのかす	そそのかし
来す	来し
並べたてる	並べたて
相せっする	並べたて
盾突く	盾突い
くすべる	くすべ
突っこむ	突っこん
はれわたる	はれわたっ
あぶれる	あぶれ
組みいれる	組みいれ
つどう	つどっ
めばえる	めばえ
蓄える	蓄え
いつく	いつい
見渡す	見渡し
たとえる	たとえ
とけこむ	とけこん
赤茶ける	赤茶け
背負い込める	背負い込め
切掛ける	切掛け
おびく	おびい
漲る	漲っ
背負い込む	背負い込ん
落ち合える	落ち合え
かりたおす	かりたおし
ふりまける	ふりまけ
とける	とけ
差出る	差出
おいこめる	おいこめ
なめる	なめ
たくれる	たくれ
騒ぎ立てる	騒ぎ立て
繋ぐ	繋い
にこめる	にこめ
おもいおこせる	おもいおこせ
遂せる	遂せ
煮込む	煮込ん
つっかえる	つっかえ
横切る	横切っ
勘ぐる	勘ぐっ
遊び回る	遊び回っ
外れる	外れ
切結ぶ	切結ん
かずく	かずい
つけだす	つけだし
あいつづく	あいつづい
守立てる	守立て
のたまう	のたまっ
窮める	窮め
落とす	落とし
うけとめる	うけとめ
行き交う	行き交っ
降る	降っ
買いかぶる	買いかぶっ
思い出す	思い出し
受かる	受かっ
はりあわせる	はりあわせ
くみあわせる	くみあわせ
絶やす	絶やし
齧り付く	齧り付い
おこないすます	おこないすまし
呑みこむ	呑みこん
具わる	具わっ
送り出せる	送り出せ
いっする	送り出せ
塞く	塞い
仕る	仕っ
突っぷす	突っぷし
もみけせる	もみけせ
吸える	吸え
つきあう	つきあっ
きざむ	きざん
敬する	きざん
しゃちこばる	しゃちこばっ
弾き出せる	弾き出せ
宛てる	宛て
選りすぐる	選りすぐっ
思い止まる	思い止まっ
ふりあてる	ふりあて
打ち立てる	打ち立て
欲する	打ち立て
なめす	なめし
食む	食ん
即ける	即け
駆け抜ける	駆け抜け
染み着く	染み着い
増す	増し
沸き立つ	沸き立っ
駆ける	駆け
すう	すっ
受け取る	受け取っ
たくる	たくっ
蒸す	蒸し
透通る	透通っ
老け込む	老け込ん
見倣う	見倣っ
持出す	持出し
限る	限っ
しにわかれる	しにわかれ
つっころばす	つっころばし
図る	図っ
手なれる	手なれ
あるきつめる	あるきつめっ
忘れ去る	忘れ去っ
忍べる	忍べ
交わせる	交わせ
取払う	取払っ
くゆらす	くゆらし
打ち消す	打ち消し
厭きる	厭き
行きかかる	行きかかっ
覆う	覆っ
読み比べる	読み比べ
役に立つ	役に立っ
滑り降ちる	滑り降ち
おがみたおす	おがみたおし
盛り合わせる	盛り合わせ
なぐれる	なぐれ
突き戻す	突き戻し
あり	あり
追抜く	追抜い
ひやす	ひやし
ひきつづく	ひきつづい
響かす	響かし
駆り催す	駆り催し
送り付ける	送り付け
仕組む	仕組ん
磨きあげる	磨きあげ
湿る	湿っ
ぱらつく	ぱらつい
攫む	攫ん
先立つ	先立っ
分かる	分かっ
股がる	股がっ
倒れ込む	倒れ込ん
ひるがえる	ひるがえっ
見つける	見つけ
褒めちぎる	褒めちぎっ
取り払う	取り払っ
駆出す	駆出し
取り押さえる	取り押さえ
釣り込む	釣り込ん
けしとめる	けしとめ
上廻る	上廻っ
転がれる	転がれ
とりのぞく	とりのぞい
打勝つ	打勝っ
寄りかかる	寄りかかっ
溶けだす	溶けだし
せいだす	せいだし
さそいだす	さそいだし
かきさす	かきさし
飲みこむ	飲みこん
蘇る	蘇っ
掛け合う	掛け合っ
かいだす	かいだし
打ち落す	打ち落し
穫る	穫っ
妻せる	妻せ
じらす	じらし
あふる	あふっ
ムキになる	ムキになっ
食入る	食入っ
言い聞かす	言い聞かし
聞き咎める	聞き咎め
よみきる	よみきっ
取らせる	取らせ
ねむりこける	ねむりこけ
名乗る	名乗っ
過ぎる	過ぎっ
とりはなす	とりはなし
いいそびれる	いいそびれ
ぎんじる	ぎんじ
絞り出す	絞り出し
乗り越す	乗り越し
おしたおせる	おしたおせ
かどだてる	かどだて
染直す	染直し
こしかける	こしかけ
にげこめる	にげこめ
ぬりつぶせる	ぬりつぶせ
よごれる	よごれ
ゆるむ	ゆるん
突き上げる	突き上げ
ふれこめる	ふれこめ
据え置く	据え置い
灯す	灯し
入り替る	入り替っ
投げ入れる	投げ入れ
居こぼれる	居こぼれ
外らす	外らし
もりこむ	もりこん
腫らす	腫らし
繰りかえす	繰りかえし
誉めそやす	誉めそやし
ききとどける	ききとどけ
すっぱぬける	すっぱぬけ
ぼやく	ぼやい
掻き合せる	掻き合せ
そがれる	そがれ
食い足りる	食い足り
荒し回る	荒し回っ
解く	解い
ぶれる	ぶれ
つめこむ	つめこん
ちかよる	ちかよっ
仕付ける	仕付け
拘る	拘っ
投げ掛ける	投げ掛け
遣り過す	遣り過し
揺る	揺っ
薙ぎ倒す	薙ぎ倒し
かき曇る	かき曇っ
うそぶく	うそぶい
せきとめる	せきとめ
浮きでる	浮きで
ひかる	ひかっ
突きつける	突きつけ
掛かれる	掛かれ
ふり合う	ふり合っ
みつ	みっ
換える	換え
とりなす	とりなし
張切る	張切っ
渋る	渋っ
啓する	渋っ
蠢かす	蠢かし
おしかえせる	おしかえせ
堪える	堪え
遣える	遣え
すみこめる	すみこめ
貸せる	貸せ
飛びのれる	飛びのれ
仰せ付ける	仰せ付け
毳立つ	毳立っ
よぎる	よぎっ
黙りこくる	黙りこくっ
る	黙りこくっ
沸き返る	沸き返っ
往ける	往け
張り合わせる	張り合わせ
ぶらさがる	ぶらさがっ
すくう	すくっ
狩り出す	狩り出し
取り掛る	取り掛っ
申渡す	申渡し
称える	称え
入り込む	入り込ん
すりへる	すりへっ
装う	装っ
立てる	立て
おもいあまる	おもいあまっ
もやう	もやっ
もちよれる	もちよれ
いいかえせる	いいかえせ
とじ込む	とじ込ん
入り切る	入り切っ
陰る	陰っ
塞き止める	塞き止め
はずむ	はずん
染め付ける	染め付け
ねりなおす	ねりなおし
取かかる	取かかっ
ぐらつく	ぐらつい
押分ける	押分け
なごむ	なごん
いのこれる	いのこれ
劣る	劣っ
吹出す	吹出し
とぼける	とぼけ
とびつける	とびつけ
酌み交わす	酌み交わし
掻ける	掻け
立返る	立返っ
違う	違っ
ムシる	ムシっ
する	すっ
おもいつめる	おもいつめ
解き放す	解き放し
言い切る	言い切っ
参る	参っ
要す	要し
病ほうける	病ほうけ
かみしずまる	かみしずまっ
すわる	すわっ
微笑む	微笑ん
刷込む	刷込ん
延ばせる	延ばせ
在り合わせる	在り合わせ
組みあわせる	組みあわせ
挿す	挿し
探し当てる	探し当て
絶える	絶え
つぶやく	つぶやい
練り合わす	練り合わし
おぢゃる	おぢゃっ
ゆめみる	ゆめみ
みそこなう	みそこなっ
まぜっ返す	まぜっ返し
つみこむ	つみこん
誦する	つみこん
截つ	截っ
うめあわせる	うめあわせ
しこなす	しこなし
織り込む	織り込ん
押え込む	押え込ん
ささやく	ささやい
うつむく	うつむい
積み立てる	積み立て
差繰る	差繰っ
たちよれる	たちよれ
死に別れる	死に別れ
掘り起こす	掘り起こし
とざす	とざし
あまる	あまっ
合せる	合せ
組敷く	組敷い
接ぎ合わす	接ぎ合わし
哭する	接ぎ合わし
待ちわびる	待ちわび
とびおりる	とびおり
斎く	斎い
彫りつける	彫りつけ
なる	なっ
とくせいづける	とくせいづけ
張り出せる	張り出せ
課する	張り出せ
持ち替える	持ち替え
むし返す	むし返し
背負える	背負え
下り立つ	下り立っ
みがきこむ	みがきこん
ひっぱたく	ひっぱたい
かり出す	かり出し
もえでる	もえで
潜り込む	潜り込ん
いれちがう	いれちがっ
浮かされる	浮かされ
べんする	浮かされ
摺る	摺っ
見送る	見送っ
いいわたす	いいわたし
尖る	尖っ
おとなう	おとなっ
でっぱる	でっぱっ
いけどる	いけどっ
打殺す	打殺し
うつぶせる	うつぶせ
きせる	きせ
昇る	昇っ
突き抜く	突き抜い
たたる	たたっ
追い廻す	追い廻し
黒める	黒め
かじる	かじっ
きりたてる	きりたて
蒔ける	蒔け
しめ殺す	しめ殺し
読みとる	読みとっ
定める	定め
抜け出せる	抜け出せ
焚き付ける	焚き付け
うやまえる	うやまえ
といかける	といかけ
切りあげる	切りあげ
準ずる	切りあげ
守れる	守れ
処する	守れ
差し控える	差し控え
いやしめる	いやしめ
うばいとれる	うばいとれ
きりかえす	きりかえし
懐かしむ	懐かしん
凪ぐ	凪い
得	得
撰べる	撰べ
発つ	発っ
晦ます	晦まし
繰りあわせる	繰りあわせ
熬る	熬っ
掴む	掴ん
うしなう	うしなっ
もらう	もらっ
恥じ入る	恥じ入っ
のりいれる	のりいれ
きらわれる	きらわれ
ふかまる	ふかまっ
恕する	ふかまっ
悪びれる	悪びれ
聞きかじる	聞きかじっ
咲き残る	咲き残っ
言ひ現す	言ひ現し
そばめる	そばめ
絡みつく	絡みつい
包み込む	包み込ん
うかされる	うかされ
ひっこむ	ひっこん
魅する	ひっこん
引っ括る	引っ括っ
飛びつける	飛びつけ
差し翳す	差し翳し
とりむすぶ	とりむすん
朽果てる	朽果て
温まる	温まっ
振り出せる	振り出せ
のしあがれる	のしあがれ
たちこめる	たちこめ
掻きむしる	掻きむしっ
引継ぐ	引継い
こんがらかる	こんがらかっ
堪忍ぶ	堪忍ん
建て替える	建て替え
抱着く	抱着い
ぶらつく	ぶらつい
申し渡す	申し渡し
よろける	よろけ
たたく	たたい
映せる	映せ
まかりまちがう	まかりまちがっ
かせぐ	かせい
冷え込む	冷え込ん
せる	せ
きりだせる	きりだせ
植え付ける	植え付け
舞う	舞っ
染分ける	染分け
分つ	分っ
行詰る	行詰っ
嗄らす	嗄らし
越す	越し
丸まる	丸まっ
書付ける	書付け
いく	いっ
請合う	請合っ
ひろえる	ひろえ
脱げる	脱げ
討果す	討果し
つかいふるす	つかいふるし
扱き使う	扱き使っ
入浸る	入浸っ
焦らす	焦らし
覚る	覚っ
ぬる	ぬっ
すみつく	すみつい
繰替える	繰替え
きりはずす	きりはずし
建て込む	建て込ん
騒ぐ	騒い
おしだす	おしだし
おしつまる	おしつまっ
まいおりる	まいおり
ガンバる	ガンバっ
おどる	おどっ
向う	向っ
付けかえる	付けかえ
慶する	付けかえ
見計らえる	見計らえ
視る	視
引っこめる	引っこめ
こころする	引っこめ
語りこむ	語りこん
否める	否め
おとなびる	おとなび
ひっ込む	ひっ込ん
くばる	くばっ
のりすてる	のりすて
でむける	でむけ
攻め寄せる	攻め寄せ
はめ込む	はめ込ん
聞きそこなう	聞きそこなっ
貪る	貪っ
みこせる	みこせ
許す	許し
薄める	薄め
抜け落ちる	抜け落ち
届く	届い
狭める	狭め
出掛ける	出掛け
ことよせる	ことよせ
ほっぽらかす	ほっぽらかし
併せ持つ	併せ持っ
投げつける	投げつけ
落籍す	落籍し
ぱくる	ぱくっ
踏み均す	踏み均し
たぐう	たぐっ
ざわつく	ざわつい
突きあわす	突きあわし
構う	構っ
ねじあげる	ねじあげ
終わる	終わっ
育くむ	育くん
さぐれる	さぐれ
繕える	繕え
諾う	諾っ
切り下げる	切り下げ
みおくれる	みおくれ
生まれる	生まれ
しゃしゃりでる	しゃしゃりで
見守れる	見守れ
ひきたてる	ひきたて
祝う	祝っ
打ち砕ける	打ち砕け
問う	問う
くみふせる	くみふせ
かいもとめる	かいもとめ
ひしゃげる	ひしゃげ
ふきとぶ	ふきとん
濡らす	濡らし
踏みならす	踏みならし
位置づける	位置づけ
ああなる	ああなっ
静まりかえる	静まりかえっ
迫れる	迫れ
吸い上げる	吸い上げ
呼び出す	呼び出し
落ち込む	落ち込ん
しゅくする	落ち込ん
食延す	食延し
仕切る	仕切っ
宣う	宣っ
ふりまわす	ふりまわし
置きかわる	置きかわっ
代わる	代わっ
すなどる	すなどっ
問い合せる	問い合せ
いいおとす	いいおとし
つっぱしれる	つっぱしれ
ほうりこむ	ほうりこん
参する	ほうりこん
労う	労っ
とらえる	とらえ
泡立つ	泡立っ
とおのける	とおのけ
まがえる	まがえ
こうじる	こうじ
かき落とす	かき落とし
やり返す	やり返し
にたてる	にたて
くすねる	くすね
ないまぜる	ないまぜ
織りあげる	織りあげ
さそえる	さそえ
塗りつける	塗りつけ
弄する	塗りつけ
揮う	揮っ
下げ渡す	下げ渡し
怒る	怒っ
逃げ惑う	逃げ惑っ
飼える	飼え
騒げる	騒げ
だぶる	だぶっ
あたためる	あたため
ものがたる	ものがたっ
たのめる	たのめ
伴える	伴え
追い出す	追い出し
きれこむ	きれこん
ひっこめる	ひっこめ
めいする	ひっこめ
入込む	入込ん
檄する	入込ん
貯える	貯え
聞ほれる	聞ほれ
与太る	与太っ
隣る	隣っ
いぶす	いぶし
ゆずりわたせる	ゆずりわたせ
かみあう	かみあっ
為し遂げる	為し遂げ
突き落とす	突き落とし
駆る	駆っ
歌いまくる	歌いまくっ
積み重なる	積み重なっ
うちはらう	うちはらっ
餓える	餓え
染め分ける	染め分け
囲める	囲め
食い切る	食い切っ
気取る	気取っ
わずらわす	わずらわし
生茂る	生茂っ
有りあわせる	有りあわせ
しいれる	しいれ
とりこわせる	とりこわせ
ながびく	ながびい
こみ上げる	こみ上げ
閉じこもる	閉じこもっ
きめる	きめ
おしつぶす	おしつぶし
刺通す	刺通し
うばう	うばっ
気ばる	気ばっ
勇む	勇ん
謹む	謹ん
でおくれる	でおくれ
まとう	まとっ
ちる	ちっ
煩わせる	煩わせ
よみかえる	よみかえ
かきこめる	かきこめ
たきあげる	たきあげ
通り過ぎる	通り過ぎ
なりかわる	なりかわっ
偏る	偏っ
振る	振っ
なで上げる	なで上げ
相手取る	相手取っ
まかす	まかし
裏切れる	裏切れ
刻む	刻ん
梱る	梱っ
こぞる	こぞっ
さかだてる	さかだて
見交す	見交し
降りる	降り
遂げる	遂げ
書き抜ける	書き抜け
鳴かす	鳴かし
かこめる	かこめ
仕うまつる	仕うまつっ
やどす	やどし
揺らぐ	揺らい
鳴り出す	鳴り出し
かりもよおす	かりもよおし
縫い上げる	縫い上げ
さきこぼれる	さきこぼれ
よこぎれる	よこぎれ
向き合う	向き合っ
導き出せる	導き出せ
届け出る	届け出
となえる	となえ
成り代る	成り代っ
削れる	削れ
乾びる	乾び
叫べる	叫べ
なさる	なさっ
気張れる	気張れ
べた付く	べた付い
ちぎる	ちぎっ
やり過ごす	やり過ごし
すわりこむ	すわりこん
はこびだす	はこびだし
叩きつける	叩きつけ
ほろぼせる	ほろぼせ
宣る	宣っ
甲ばしる	甲ばしっ
便する	甲ばしっ
通ぶる	通ぶっ
眠らせる	眠らせ
くり広げる	くり広げ
醸し出す	醸し出し
話し合える	話し合え
まかり出る	まかり出
脅しつける	脅しつけ
解す	解し
いらだつ	いらだっ
呼び掛ける	呼び掛け
いいつたえる	いいつたえ
訊ねる	訊ね
聞き澄ます	聞き澄まし
差し替える	差し替え
窄まる	窄まっ
更かす	更かし
言募る	言募っ
輝かす	輝かし
いすくまる	いすくまっ
生まれつく	生まれつい
威ばる	威ばっ
まきかえす	まきかえし
失せる	失せ
追い越す	追い越し
染抜く	染抜い
打ち払える	打ち払え
はぎ取れる	はぎ取れ
示せる	示せ
抱取る	抱取っ
ほねおる	ほねおっ
当て込む	当て込ん
待ち兼ねる	待ち兼ね
つづれる	つづれ
うちくだく	うちくだい
出直せる	出直せ
取り持てる	取り持て
つられる	つられ
曝す	曝し
有余る	有余っ
ふけこむ	ふけこん
染め抜く	染め抜い
譲り受ける	譲り受け
罰する	譲り受け
じぶくる	じぶくっ
あらだてる	あらだて
戻す	戻し
建て直せる	建て直せ
沸あがる	沸あがっ
言消す	言消し
順序付ける	順序付け
凍える	凍え
活気づく	活気づい
ぎする	活気づい
えらぶ	えらん
謝する	えらん
押し進める	押し進め
しずまりかえる	しずまりかえっ
はじき飛ばす	はじき飛ばし
荷なう	荷なっ
感じ入る	感じ入っ
そぼ濡れる	そぼ濡れ
掻き回す	掻き回し
こまりきる	こまりきっ
だましとる	だましとっ
はらいきよめる	はらいきよめ
取すます	取すまし
だきあげる	だきあげ
なぎたおす	なぎたおし
殴りつける	殴りつけ
備えつける	備えつけ
酔う	酔っ
感じとる	感じとっ
とりすてる	とりすて
抽んでる	抽んで
震いつく	震いつい
乗付ける	乗付け
奮い起こす	奮い起こし
逃げ込む	逃げ込ん
しめる	しめ
おっかける	おっかけ
乗りこむ	乗りこん
評す	評し
馴染む	馴染ん
まばたく	まばたい
つかまえる	つかまえ
おくらせる	おくらせ
ではらう	ではらっ
垂んとする	ではらっ
そそぎ込む	そそぎ込ん
叢る	叢っ
取りはからう	取りはからっ
深まる	深まっ
よみながせる	よみながせ
くださる	くださっ
あける	あけ
ねぶる	ねぶっ
力つきる	力つき
貶める	貶め
つづり合す	つづり合し
散ずる	つづり合し
かきおこす	かきおこし
まつる	まつっ
煎じ詰める	煎じ詰め
差上げる	差上げ
取り締る	取り締っ
あんじる	あんじ
ちぢれる	ちぢれ
急げる	急げ
慣わす	慣わし
任せる	任せ
めだつ	めだっ
たっとべる	たっとべ
たてなおせる	たてなおせ
盛れる	盛れ
さわぎだす	さわぎだし
ゆさぶれる	ゆさぶれ
書き落す	書き落し
謹しむ	謹しん
架る	架っ
吸込む	吸込ん
見飽きる	見飽き
捜しあてる	捜しあて
にらみつける	にらみつけ
伸ばせる	伸ばせ
ききいれる	ききいれ
駆ける	駆けっ
揉みほぐす	揉みほぐし
かかずらう	かかずらっ
逃げのびる	逃げのび
練りあわせる	練りあわせ
つらぬきとおす	つらぬきとおし
続ける	続け
飛びかかれる	飛びかかれ
匿う	匿っ
つきはなす	つきはなし
わらう	わらっ
渇く	渇い
才ばしる	才ばしっ
とおざける	とおざけ
立行く	立行き
ゆらめく	ゆらめい
ぶっとばす	ぶっとばし
頬張る	頬張っ
衒う	衒っ
薙ぐ	薙い
念ずる	薙い
勘繰る	勘繰っ
逃げ込める	逃げ込め
気づかう	気づかっ
すき返す	すき返し
ひっ掴む	ひっ掴ん
なみする	ひっ掴ん
買い切れる	買い切れ
さされる	さされ
結びつける	結びつけ
つっ返す	つっ返し
火照る	火照っ
沮む	沮ん
解る	解っ
見逸れる	見逸れ
芽吹く	芽吹い
こじ開ける	こじ開け
捏ねくる	捏ねくっ
かいあたえる	かいあたえ
乾上がる	乾上がっ
もぎ取る	もぎ取っ
描き出せる	描き出せ
詠込む	詠込ん
成り立つ	成り立っ
嗣ぐ	嗣い
みあわせる	みあわせ
にげる	にげ
治せる	治せ
乗っかる	乗っかっ
ほくそ笑む	ほくそ笑ん
煎り付ける	煎り付け
ものいう	ものいっ
出くわす	出くわし
あらいながせる	あらいながせ
引っかく	引っかい
ふくまる	ふくまっ
たちわれる	たちわれ
いいなおす	いいなおし
思い過ごす	思い過ごし
つるしあげる	つるしあげ
切り放せる	切り放せ
おもいつく	おもいつい
ゑむ	ゑん
おもむく	おもむい
目だつ	目だっ
通り越す	通り越し
染付く	染付い
とる	とっ
打ちだす	打ちだし
だんじこめる	だんじこめ
けっていづける	けっていづけ
とかす	とかし
うちすてる	うちすて
折り返す	折り返し
話し合う	話し合っ
老いぼれる	老いぼれ
責めたてる	責めたて
序する	責めたて
彫りこむ	彫りこん
麾く	麾い
拓く	拓い
書き写す	書き写し
取抑える	取抑え
貸す	貸し
切り落す	切り落し
耳立つ	耳立っ
取扱う	取扱っ
関す	関し
ひっかける	ひっかけ
とうとぶ	とうとん
平らげる	平らげ
振りわける	振りわけ
打ち続く	打ち続い
侘びる	侘び
副える	副え
付け回す	付け回し
なきじゃくる	なきじゃくっ
すさぶ	すさん
いからす	いからし
切り倒す	切り倒し
もくろむ	もくろん
くりかえせる	くりかえせ
はなつ	はなっ
仕立てる	仕立て
手放す	手放し
糾す	糾し
もみ合う	もみ合っ
初める	初め
立通す	立通し
毀つ	毀っ
がっつく	がっつい
みちびける	みちびけ
うけおう	うけおっ
遣る	遣っ
えぐる	えぐっ
早める	早め
隣り合わせる	隣り合わせ
差し招く	差し招い
はねかえせる	はねかえせ
遣わす	遣わし
そげる	そげ
ひん曲げる	ひん曲げ
綴りあわせる	綴りあわせ
取囲む	取囲ん
泳ぎ着ける	泳ぎ着け
撃ち止める	撃ち止め
折り込む	折り込ん
むかいあえる	むかいあえ
かきよせる	かきよせ
噛み殺す	噛み殺し
取り返せる	取り返せ
睨みあわせる	睨みあわせ
すずむ	すずん
あたいする	すずん
ほりだせる	ほりだせ
しらげる	しらげ
思い直す	思い直し
きこなせる	きこなせ
うらむ	うらん
揉み消す	揉み消し
基く	基い
いいまくる	いいまくっ
あとずさる	あとずさっ
映ずる	あとずさっ
のる	のっ
かぞえる	かぞえ
放り出す	放り出し
のばせる	のばせ
釣りあう	釣りあっ
ねかせる	ねかせ
売れる	売れ
灯る	灯っ
眠れる	眠れ
なやませる	なやませ
かかる	かかっ
使う	使う
のりこす	のりこし
干涸らびる	干涸らび
抜きん出る	抜きん出
踏み入れる	踏み入れ
たてこもる	たてこもっ
渇れる	渇れ
訴える	訴え
喜ばす	喜ばし
突き詰める	突き詰め
いのれる	いのれ
つき抜ける	つき抜け
耕す	耕し
こじらせる	こじらせ
あざわらう	あざわらっ
ぞくす	ぞくし
かげる	かげ
響かせる	響かせ
いきのこれる	いきのこれ
まきおこす	まきおこし
おもえる	おもえ
運び出せる	運び出せ
詠う	詠っ
俯せる	俯せ
染透る	染透っ
見交わす	見交わし
汗じみる	汗じみ
蒙る	蒙っ
おいたつ	おいたっ
持ち出せる	持ち出せ
にえくりかえる	にえくりかえっ
湧かす	湧かし
取り止める	取り止め
叩ける	叩け
接す	接し
おぶう	おぶっ
被う	被っ
絡む	絡ん
ふう	ふっ
すえおく	すえおい
跳ねる	跳ね
引っ付く	引っ付い
襲う	襲っ
纏わる	纏わっ
にらむ	にらん
おぼえる	おぼえ
打ちかえす	打ちかえし
れっする	打ちかえし
推量る	推量っ
ゆれる	ゆれ
なげこむ	なげこん
濯ぐ	濯い
ひきずりこむ	ひきずりこん
なみはずれる	なみはずれ
負う	負っ
もぎ取れる	もぎ取れ
聞き合わす	聞き合わし
吸い付ける	吸い付け
感ずる	吸い付け
搾り取る	搾り取っ
おちぶれる	おちぶれ
轟く	轟い
不貞腐る	不貞腐っ
保する	不貞腐っ
鋏める	鋏め
名づける	名づけ
逸する	名づけ
置ける	置け
のりあわせる	のりあわせ
尽きる	尽き
えんづける	えんづけ
差し延べる	差し延べ
かえる	かえっ
なす	なし
うちはらえる	うちはらえ
舞い込む	舞い込ん
おもんぱかる	おもんぱかっ
ぬぐいされる	ぬぐいされ
行い澄ます	行い澄まし
うち捨てる	うち捨て
おいまくる	おいまくっ
見すえる	見すえ
極まる	極まっ
切る	切っ
はねかえす	はねかえし
すっとぼける	すっとぼけ
きえいる	きえいっ
取りかたづける	取りかたづけ
駆けだす	駆けだし
擬す	擬し
踏外す	踏外し
争う	争っ
散敷く	散敷い
付出す	付出し
込める	込め
立て通す	立て通し
加われる	加われ
引き当てる	引き当て
足掻く	足掻い
纏まる	纏まっ
ふれあう	ふれあっ
愛し合う	愛し合っ
ゆえる	ゆえ
形作れる	形作れ
鎖す	鎖し
盛り返せる	盛り返せ
兼ね備える	兼ね備え
ふりしく	ふりしい
うりきれる	うりきれ
跳ね返せる	跳ね返せ
せり上げる	せり上げ
うちおとせる	うちおとせ
まう	まっ
よそおえる	よそおえ
飼い慣らす	飼い慣らし
しゅくす	しゅくし
とくちょうづける	とくちょうづけ
遡る	遡っ
みきれる	みきれ
とりいれる	とりいれ
寄かかる	寄かかっ
あつかふ	あつかひ
跡付ける	跡付け
不貞腐れる	不貞腐れ
遣れる	遣れ
睨める	睨め
だくする	睨め
並居る	並居
こときれる	こときれ
とりかわす	とりかわし
いいきかす	いいきかし
ねじれる	ねじれ
怯える	怯え
見比べる	見比べ
おしとおせる	おしとおせ
みまわせる	みまわせ
ちぢまる	ちぢまっ
いさみたてる	いさみたて
聞過す	聞過し
鏤める	鏤め
浮き出す	浮き出し
うち連れる	うち連れ
納まる	納まっ
聞きとがめる	聞きとがめ
言い出す	言い出し
狎れる	狎れ
詠ずる	狎れ
飲みつぶれる	飲みつぶれ
引き付ける	引き付け
ひきはなせる	ひきはなせ
落っこちる	落っこち
戻せる	戻せ
保ち合う	保ち合っ
つみわける	つみわけ
頷く	頷い
捩じ合う	捩じ合っ
積み出す	積み出し
ちぢくれる	ちぢくれ
押入る	押入っ
つきぬける	つきぬけ
言い聞かせる	言い聞かせ
つみだす	つみだし
うまれでる	うまれで
売り出せる	売り出せ
しこる	しこっ
めいずる	しこっ
かいこめる	かいこめ
つみする	かいこめ
とりつくろう	とりつくろっ
諦める	諦め
みがまえる	みがまえ
勇み立てる	勇み立て
釈く	釈い
死ぬ	死ん
かる	かっ
廻る	廻っ
繕う	繕っ
祝す	祝し
つれだつ	つれだっ
染め直せる	染め直せ
散り急ぐ	散り急い
干あがる	干あがっ
擁する	干あがっ
はかりこむ	はかりこん
取りしまる	取りしまっ
説き伏せる	説き伏せ
みつもれる	みつもれ
かけ隔たる	かけ隔たっ
よびつける	よびつけ
突ぱしる	突ぱしっ
降り積もる	降り積もっ
拭う	拭っ
たたき起す	たたき起し
若やぐ	若やい
溶かす	溶かし
まよう	まよっ
とびわたる	とびわたっ
うけおえる	うけおえ
芽立つ	芽立っ
催す	催し
降ろす	降ろし
泣濡れる	泣濡れ
讀める	讀め
たちきれる	たちきれ
失くなる	失くなっ
いろあせる	いろあせ
くるむ	くるん
撮る	撮っ
出逢う	出逢っ
恤む	恤ん
吹おろす	吹おろし
抜きんでる	抜きんで
防ぐ	防い
下さる	下さっ
おぼしめす	おぼしめし
かすめとる	かすめとっ
くみあげる	くみあげ
むしり取る	むしり取っ
さしまねく	さしまねい
洗い落とす	洗い落とし
かけまわれる	かけまわれ
誑かす	誑かし
つれさる	つれさっ
食合う	食合っ
打ちみる	打ちみ
すませる	すませ
踏ん張る	踏ん張っ
燃えつく	燃えつい
もみけす	もみけし
やりこめる	やりこめ
申す	申し
しする	申し
りかいしあう	りかいしあっ
ほころびる	ほころび
くだる	くだっ
読み合わす	読み合わし
丸めこむ	丸めこん
言い消す	言い消し
こき使う	こき使っ
突通る	突通っ
押し詰る	押し詰っ
せおえる	せおえ
うく	うい
献ずる	うい
劈く	劈い
敵する	劈い
始まる	始まっ
ひねくる	ひねくっ
撫で付ける	撫で付け
洩らす	洩らし
愛す	愛し
ひっ被る	ひっ被っ
いらせられる	いらせられ
取り巻ける	取り巻け
照れる	照れ
指し示す	指し示し
下立つ	下立っ
かさねあわす	かさねあわし
引きちぎれる	引きちぎれ
取り消せる	取り消せ
きれる	きれ
おもいみだれる	おもいみだれ
笑い飛ばせる	笑い飛ばせ
かけ離れる	かけ離れ
さしかける	さしかけ
みみだつ	みみだっ
奉ずる	みみだっ
択ぶ	択ん
こぼす	こぼし
わかがえる	わかがえっ
ふくめる	ふくめ
生け捕る	生け捕っ
署する	生け捕っ
組み立る	組み立
ぬくまる	ぬくまっ
おろす	おろし
立入る	立入っ
ひっくり返れる	ひっくり返れ
もりわける	もりわけ
置き換える	置き換え
投げ勝つ	投げ勝っ
みづく	みづい
えりすぐる	えりすぐっ
威張れる	威張れ
聴こえる	聴こえ
産める	産め
むかう	むかっ
かれる	かれ
ねらいうつ	ねらいうっ
ふりかざす	ふりかざし
酌める	酌め
弾ける	弾け
もよおす	もよおし
食う	食っ
ブッ殺す	ブッ殺し
いやがる	いやがっ
僭する	いやがっ
撒く	撒い
持ち帰る	持ち帰っ
きざす	きざし
おしよせる	おしよせ
おくらす	おくらし
歩ます	歩まし
ふうきる	ふうきっ
転げる	転げ
かきだす	かきだし
しょげこむ	しょげこん
突き当たる	突き当たっ
ほきだす	ほきだし
かりあげる	かりあげ
すごせる	すごせ
こねる	こね
差し出る	差し出
狙い打つ	狙い打っ
得る	得
粒だつ	粒だっ
きりひらく	きりひらい
揺ぎ出でる	揺ぎ出で
遺る	遺っ
やりなおす	やりなおし
めんする	やりなおし
真似る	真似
ちりしく	ちりしい
出盛る	出盛っ
減り込む	減り込ん
いやせる	いやせ
役する	いやせ
なける	なけ
立ち尽くす	立ち尽くし
舞い戻る	舞い戻っ
強いる	強い
ぬりつける	ぬりつけ
ひそめる	ひそめ
おもいしる	おもいしっ
乗っける	乗っけ
結えつける	結えつけ
おどり出る	おどり出
もうしこむ	もうしこん
惚れこむ	惚れこん
うずまく	うずまい
いのこる	いのこっ
異なる	異なっ
詣れる	詣れ
積上げる	積上げ
撓る	撓っ
すぼめる	すぼめ
ことほぐ	ことほい
経あがる	経あがっ
煮詰める	煮詰め
ひやせる	ひやせ
打沈む	打沈ん
しゃくう	しゃくっ
拡げる	拡げ
撫ぜる	撫ぜ
かたげる	かたげ
轢き殺す	轢き殺し
だく	だい
差延べる	差延べ
令する	差延べ
身篭る	身篭っ
あらがう	あらがっ
罷りでる	罷りで
こまぬく	こまぬい
ぬれる	ぬれ
堪り兼ねる	堪り兼ね
釣れる	釣れ
差し障る	差し障っ
すれちがう	すれちがっ
はせ回る	はせ回っ
飛びまわる	飛びまわっ
煙る	煙っ
満たす	満たし
騙る	騙っ
反れる	反れ
呼ばれる	呼ばれ
でなおせる	でなおせ
つけたせる	つけたせ
登り詰める	登り詰め
寝込む	寝込ん
坐する	寝込ん
とりあわす	とりあわし
耐え忍ぶ	耐え忍ん
捻じる	捻じっ
駆け回れる	駆け回れ
攻上る	攻上っ
打かさなる	打かさなっ
いきちがう	いきちがっ
対応付ける	対応付け
踏み分ける	踏み分け
掘出す	掘出し
止める	止め
断切る	断切っ
在り合せる	在り合せ
盛りかえす	盛りかえし
たおる	たおっ
ひにくる	ひにくっ
摩する	ひにくっ
かたりつぐ	かたりつい
おりかさなる	おりかさなっ
かいかぶる	かいかぶっ
むきかわる	むきかわっ
醒ます	醒まし
打つ	打っ
あやめる	あやめ
執る	執っ
つっぱる	つっぱっ
組みこめる	組みこめ
とんがる	とんがっ
埋まる	埋まっ
活きる	活き
ぶちのめす	ぶちのめし
へきする	ぶちのめし
つめかける	つめかけ
言い含める	言い含め
敲く	敲い
ただよう	ただよっ
掛け持つ	掛け持っ
いりみだれる	いりみだれ
きたる	きたっ
押え付ける	押え付け
賜る	賜っ
並べ換える	並べ換え
ひえる	ひえ
取り次げる	取り次げ
撮み出す	撮み出し
のめりこむ	のめりこん
あいしあえる	あいしあえ
じみる	じみ
しずまる	しずまっ
あやなす	あやなし
笑いとばす	笑いとばし
取り合う	取り合っ
なきすがる	なきすがっ
ひとはだぬぐ	ひとはだぬい
取って返す	取って返し
取入れる	取入れ
乳繰る	乳繰っ
煮染める	煮染め
なぎはらう	なぎはらっ
たく	たい
ふうする	たい
果たせる	果たせ
刈入れる	刈入れ
まかる	まかっ
突っぱなす	突っぱなし
全うする	突っぱなし
書きぬく	書きぬい
起きあがる	起きあがっ
書き添える	書き添え
ふるわす	ふるわし
であるける	であるけ
飛び付く	飛び付い
さしはさむ	さしはさん
撞く	撞い
掛離れる	掛離れ
とびこえる	とびこえ
達する	とびこえ
みる	み
謀る	謀っ
食詰める	食詰め
探し回る	探し回っ
かわいがれる	かわいがれ
とまれる	とまれ
立ち入る	立ち入っ
転ける	転け
当てこする	当てこすっ
こする	こすっ
抜き出せる	抜き出せ
とびあがれる	とびあがれ
そそける	そそけ
頂く	頂い
おちあえる	おちあえ
おちこぼれる	おちこぼれ
皮肉る	皮肉っ
言いきる	言いきっ
乗り換える	乗り換え
さしもどす	さしもどし
つくりなす	つくりなし
搾り上げる	搾り上げ
急ぐ	急い
立ち尽す	立ち尽し
住み込める	住み込め
おろせる	おろせ
震える	震え
ぞくする	震え
飛びこむ	飛びこん
見いだせる	見いだせ
蔓延る	蔓延っ
かき出す	かき出し
すごす	すごし
わずらう	わずらっ
合わせる	合わせ
踏切る	踏切っ
かわかす	かわかし
背負う	背負っ
拭ける	拭け
手向かえる	手向かえ
付廻す	付廻し
くちはてる	くちはて
果せる	果せ
あおざめる	あおざめ
遅なわる	遅なわっ
ごてつく	ごてつい
だきしめる	だきしめ
詠む	詠ん
あめる	あめ
罷り出でる	罷り出で
相つぐ	相つい
ねらえる	ねらえ
かりいれる	かりいれ
そねむ	そねん
きりひらける	きりひらけ
触る	触っ
つのる	つのっ
まきこめる	まきこめ
つれこむ	つれこん
寝転ぶ	寝転ん
亡くなる	亡くなっ
ばら蒔く	ばら蒔い
あかしくらす	あかしくらし
もえさかる	もえさかっ
くわえる	くわえ
借り出す	借り出し
くちすすぐ	くちすすい
もたつく	もたつい
でんぐりがえる	でんぐりがえっ
弄る	弄っ
もちきる	もちきっ
額づく	額づい
盛込む	盛込ん
巻上げる	巻上げ
殴り付ける	殴り付け
若返る	若返っ
行き渡る	行き渡っ
搾る	搾っ
ほりおこせる	ほりおこせ
魅入る	魅入っ
売り込める	売り込め
秘める	秘め
潜り込める	潜り込め
引き下ろす	引き下ろし
よりぬく	よりぬい
ひき込む	ひき込ん
たじろぐ	たじろい
弾き出す	弾き出し
映す	映し
さだめる	さだめ
せかす	せかし
よごす	よごし
わびいる	わびいっ
くえる	くえ
いなかびる	いなかび
見廻る	見廻っ
いかれる	いかれ
敗れる	敗れ
苔むす	苔むし
ぬけだせる	ぬけだせ
いいまるめる	いいまるめ
なびく	なびい
落着き払う	落着き払っ
とばす	とばし
議する	とばし
靡かす	靡かし
たためる	たため
振り切る	振り切っ
積む	積ん
いえる	いえ
みはるかす	みはるかし
のし歩く	のし歩い
刃向かう	刃向かっ
薄まる	薄まっ
薄れる	薄れ
引留める	引留め
暴き出す	暴き出し
抱え込む	抱え込ん
わななく	わなない
改む	改め
すてる	すて
なげだす	なげだし
踏付ける	踏付け
設える	設え
看做す	看做し
ひきこむ	ひきこん
くりぬく	くりぬい
売込む	売込ん
つうじる	つうじ
ふるびる	ふるび
ぬりつぶす	ぬりつぶし
踏み込める	踏み込め
ばれる	ばれ
もりつぶす	もりつぶし
のみほせる	のみほせ
反り返る	反り返っ
毛羽立つ	毛羽立っ
どくする	毛羽立っ
あふれでる	あふれで
反す	反し
やりすごせる	やりすごせ
游ぐ	游い
うちたてる	うちたて
遭う	遭っ
どよもす	どよもし
塞ぐ	塞い
引き合える	引き合え
貫き通す	貫き通し
かしきる	かしきっ
打消す	打消し
ねぎる	ねぎっ
ふりかぶる	ふりかぶっ
いきがる	いきがっ
更す	更し
呼戻す	呼戻し
教える	教え
ほりかえせる	ほりかえせ
映る	映っ
疲らせる	疲らせ
さかえる	さかえ
貫ける	貫け
流れ落ちる	流れ落ち
呼び覚ます	呼び覚まし
揺ぐ	揺い
張りとばす	張りとばし
ふみこむ	ふみこん
咲かす	咲かし
とむらう	とむらっ
刺立つ	刺立っ
聞こえる	聞こえ
とまる	とまっ
変じる	変じ
罰す	罰し
降り出す	降り出し
磨りつぶす	磨りつぶし
掻い繰る	掻い繰っ
そなわる	そなわっ
泣く	泣い
浸る	浸っ
交ぜかえす	交ぜかえし
留まる	留まっ
暴れまくる	暴れまくっ
まちのぞむ	まちのぞん
引入れる	引入れ
誓う	誓っ
取り零す	取り零し
こがれる	こがれ
組める	組め
たけりたつ	たけりたっ
まぎらせる	まぎらせ
そめぬく	そめぬい
愛でる	愛で
さとす	さとし
侵す	侵し
濁らせる	濁らせ
吸い出す	吸い出し
擦る	擦っ
歌える	歌え
張上げる	張上げ
掛け合わす	掛け合わし
書記す	書記し
ぶら下がれる	ぶら下がれ
入まじる	入まじっ
止す	止し
引き払う	引き払っ
回る	回っ
探り出せる	探り出せ
振りかける	振りかけ
磨れる	磨れ
かんずる	磨れ
立並ぶ	立並ん
朽ち果てる	朽ち果て
こやす	こやし
卜する	こやし
寄り添う	寄り添っ
誘い出せる	誘い出せ
あやまれる	あやまれ
ひっ括る	ひっ括っ
掻き込む	掻き込ん
受持つ	受持っ
落ちる	落ち
移る	移っ
ハリたおす	ハリたおし
奮い起つ	奮い起っ
ほす	ほし
茂り合う	茂り合っ
転げ込む	転げ込ん
体する	転げ込ん
晴らす	晴らし
心付く	心付い
革める	革め
むせぶ	むせん
窘める	窘め
はらいだす	はらいだし
いい表す	いい表し
殴りとばす	殴りとばし
よびさけぶ	よびさけん
澄切る	澄切っ
立後れる	立後れ
とりしきれる	とりしきれ
かたまりあう	かたまりあっ
係る	係っ
おとし入れる	おとし入れ
立こもる	立こもっ
かよわす	かよわし
あわさる	あわさっ
飛ばす	飛ばし
ふしくれだつ	ふしくれだっ
刷り上がる	刷り上がっ
ひしめき合う	ひしめき合っ
かんがえだせる	かんがえだせ
立退く	立退い
善がる	善がっ
はじき出せる	はじき出せ
働かせる	働かせ
すみつける	すみつけ
れる	れ
あう	あっ
にぎりつぶす	にぎりつぶし
待ち構える	待ち構え
忍び寄る	忍び寄っ
かなしむ	かなしん
振り立てる	振り立て
もうしたてる	もうしたて
言付ける	言付け
打ち砕く	打ち砕い
みかける	みかけ
うつ	うっ
買い叩く	買い叩い
刺し殺せる	刺し殺せ
さぐりだす	さぐりだし
敬う	敬っ
うわずる	うわずっ
摺り抜ける	摺り抜け
繰寄せる	繰寄せ
結わえ付ける	結わえ付け
彫り上げる	彫り上げ
とらわれる	とらわれ
さわる	さわっ
歓ぶ	歓ん
みつもる	みつもっ
つづける	つづけ
すれ違う	すれ違っ
なすりつける	なすりつけ
吃る	吃っ
追詰める	追詰め
出来る	出来
振るう	振るっ
しこむ	しこん
うめたてる	うめたて
やらす	やらし
立ちすくむ	立ちすくん
かたす	かたし
とりつける	とりつけ
ほほ笑む	ほほ笑ん
魘される	魘され
打ちまくる	打ちまくっ
書きさす	書きさし
しまる	しまっ
塗立てる	塗立て
みずぎわだつ	みずぎわだっ
受け取れる	受け取れ
そこねる	そこね
放下す	放下し
ぶす	ぶし
こうむる	こうむっ
じょうじる	じょうじ
けみする	じょうじ
込合う	込合っ
通じる	通じ
病める	病め
ひきとめる	ひきとめ
和らぐ	和らい
くみほす	くみほし
あんずる	くみほし
たちむかえる	たちむかえ
かさ張る	かさ張っ
あづかる	あづかっ
ふみとどまれる	ふみとどまれ
ひきいれる	ひきいれ
照らす	照らし
いぶる	いぶっ
しさる	しさっ
捩れる	捩れ
出揃う	出揃っ
とびちる	とびちっ
くいあらためる	くいあらため
こむ	こん
のりこせる	のりこせ
はげます	はげまし
絞り込む	絞り込ん
決す	決し
捨置く	捨置い
逸る	逸っ
ひかされる	ひかされ
盛り込む	盛り込ん
抜けあがる	抜けあがっ
詰め掛ける	詰め掛け
結える	結え
戯ける	戯け
恋する	戯け
ふるう	ふるっ
割引く	割引い
挾む	挾ん
おれあえる	おれあえ
踏みとどまれる	踏みとどまれ
着く	着い
かまう	かまっ
泊る	泊っ
捨て置く	捨て置い
ぬすみだす	ぬすみだし
戸惑う	戸惑う
はぐらかす	はぐらかし
踏み切る	踏み切っ
釣込む	釣込ん
奮たつ	奮たっ
凌げる	凌げ
目立つ	目立っ
曇らせる	曇らせ
わりもどせる	わりもどせ
黒ずむ	黒ずん
する	し
掛り合う	掛り合っ
言返す	言返し
きりあう	きりあっ
ゆき帰る	ゆき帰っ
取り交す	取り交し
保ち合える	保ち合え
出過ぎる	出過ぎ
仮す	仮し
張り裂ける	張り裂け
すみあらす	すみあらし
いいなす	いいなし
もりこめる	もりこめ
たびかさなる	たびかさなっ
ききとる	ききとっ
増さる	増さっ
媚びる	媚び
あたたまる	あたたまっ
卑しめる	卑しめ
寝違える	寝違え
なぐる	なぐっ
うちけせる	うちけせ
問いかける	問いかけ
うちころせる	うちころせ
向かう	向かっ
運ぶ	運ん
復する	運ん
つけねらう	つけねらっ
体裁振る	体裁振っ
騒ぎだす	騒ぎだし
かきあわせる	かきあわせ
竦み上がる	竦み上がっ
はりだせる	はりだせ
焚く	焚い
刷れる	刷れ
躍り掛る	躍り掛っ
してやる	してやっ
精出す	精出し
到れる	到れ
看る	看
くりあわせる	くりあわせ
売り飛ばせる	売り飛ばせ
降しきる	降しきっ
引締める	引締め
おいだせる	おいだせ
とびのる	とびのっ
垂れ下がる	垂れ下がっ
うえる	うえ
解かす	解かし
ふてくさる	ふてくさっ
そいとげる	そいとげ
いわえる	いわえ
おきかえる	おきかえ
はぎ取る	はぎ取っ
わきでる	わきで
拡がる	拡がっ
着込む	着込ん
掘り出せる	掘り出せ
錆びつく	錆びつい
うきでる	うきで
ふれこむ	ふれこん
変りはてる	変りはて
のりかける	のりかけ
凝らす	凝らし
こねくる	こねくっ
とけ込める	とけ込め
吹き込む	吹き込ん
ばたつく	ばたつい
立ち働く	立ち働い
庶幾う	庶幾っ
きりわすれる	きりわすれ
はじきだす	はじきだし
草する	はじきだし
凍む	凍ん
はいまつわる	はいまつわっ
掻き暗す	掻き暗し
與える	與え
うつしとれる	うつしとれ
かんじとれる	かんじとれ
化ける	化け
掘りさげる	掘りさげ
ふんぞりかえる	ふんぞりかえっ
切り倒せる	切り倒せ
締め付ける	締め付け
こね返す	こね返し
北叟笑む	北叟笑ん
食下がる	食下がっ
引きさく	引きさい
算する	引きさい
言いつのる	言いつのっ
ひっこ抜く	ひっこ抜い
触れ込める	触れ込め
言い尽す	言い尽し
あからむ	あからん
説伏せる	説伏せ
擽る	擽っ
掛かり合う	掛かり合っ
たぐまる	たぐまっ
指さす	指さし
追い込める	追い込め
浮あがる	浮あがっ
うらづける	うらづけ
食い下がる	食い下がっ
のりだせる	のりだせ
ふためく	ふためい
詠める	詠め
ひるがえす	ひるがえし
手つだう	手つだっ
芽ぐむ	芽ぐん
補える	補え
取り越す	取り越し
滅びる	滅び
絡ます	絡まし
損じる	損じ
きんずる	損じ
つきだせる	つきだせ
なくなす	なくなし
請けあう	請けあっ
取り交わす	取り交わし
張りつける	張りつけ
読み流せる	読み流せ
かもし出す	かもし出し
ちからづける	ちからづけ
あずける	あずけ
払い出す	払い出し
象る	象っ
そなえつける	そなえつけ
溜る	溜っ
入れ直す	入れ直し
かかる	かかっ
引っ繰り返る	引っ繰り返っ
しめす	しめし
うろつく	うろつい
もす	もし
たける	たけ
くばりあるける	くばりあるけ
折重ねる	折重ね
とりのぞける	とりのぞけ
吹分ける	吹分け
やける	やけ
たびだてる	たびだて
騙しこむ	騙しこん
踏みにじる	踏みにじっ
かたどる	かたどっ
しょぼくれる	しょぼくれ
挿せる	挿せ
たきつける	たきつけ
こぼつ	こぼっ
織る	織っ
切崩す	切崩し
起き出せる	起き出せ
探せる	探せ
掘下げる	掘下げ
引き下げる	引き下げ
持切る	持切っ
食べる	食べ
おちこむ	おちこん
湿気る	湿気
煩わす	煩わし
かっする	煩わし
ながれおちる	ながれおち
振り放け見みる	振り放け見み
持ち越す	持ち越し
割り切る	割り切っ
食らいつく	食らいつい
牽ける	牽け
天下る	天下っ
買込む	買込ん
あいまつ	あいまっ
えりぬく	えりぬい
塗りつぶせる	塗りつぶせ
放く	放い
推す	推し
とく	とい
馬鹿げる	馬鹿げ
興る	興っ
おもいすごす	おもいすごし
ひびきわたる	ひびきわたっ
あこがれる	あこがれ
おじけだつ	おじけだっ
憎める	憎め
書きなぐる	書きなぐっ
従える	従え
決る	決っ
漕ぎ着ける	漕ぎ着け
つむる	つむっ
襲われる	襲われ
棹さす	棹さし
泣すがる	泣すがっ
打取る	打取っ
引き伸ばす	引き伸ばし
きばむ	きばん
突き飛ばせる	突き飛ばせ
ことづける	ことづけ
ずっこける	ずっこけ
使い分ける	使い分け
あぶりだす	あぶりだし
はらいもどせる	はらいもどせ
払いもどす	払いもどし
あぶらじみる	あぶらじみ
明け渡る	明け渡っ
伏せる	伏せ
もえ出る	もえ出
育てあげる	育てあげ
曵く	曵い
煮込める	煮込め
気圧される	気圧され
あそぶ	あそん
よせかける	よせかけ
ぬかせる	ぬかせ
受け合う	受け合っ
やり遂げる	やり遂げ
おそいかかる	おそいかかっ
畏れる	畏れ
よばなれる	よばなれ
うろぬく	うろぬい
かちこす	かちこし
みたす	みたし
痩せこける	痩せこけ
巡れる	巡れ
とりひろげる	とりひろげ
ふうじる	ふうじ
引っ返す	引っ返し
とがめる	とがめ
老い耄れる	老い耄れ
追いこす	追いこし
踏み入る	踏み入っ
書流す	書流し
わき起こる	わき起こっ
あおる	あおっ
くいいる	くいいっ
囚われる	囚われ
なごめる	なごめ
飲回す	飲回し
歯する	飲回し
うちだす	うちだし
速まる	速まっ
化かせる	化かせ
たどりつける	たどりつけ
聞き入れる	聞き入れ
つとめる	つとめ
飛ぶ	飛ん
担える	担え
このむ	このん
おどしつける	おどしつけ
ふくらませる	ふくらませ
立寄る	立寄っ
みおくる	みおくっ
ふみわける	ふみわけ
憂う	憂っ
託ける	託け
うせる	うせ
掻払う	掻払っ
しっする	掻払っ
出払う	出払っ
きこむ	きこん
じす	じし
追い回す	追い回し
繰りまわす	繰りまわし
繰り越す	繰り越し
よみやぶる	よみやぶっ
切組む	切組ん
悪たれる	悪たれ
撃ち殺せる	撃ち殺せ
しきる	しきっ
執成す	執成し
もぎれる	もぎれ
ほしころす	ほしころし
いでたつ	いでたっ
たゆむ	たゆん
傷つく	傷つい
突き刺す	突き刺し
さしさわる	さしさわっ
報いる	報い
なおす	なおし
とどける	とどけ
使い果たす	使い果たし
てりかえす	てりかえし
ふっきれる	ふっきれ
送り出す	送り出し
きづく	きづい
過ごす	過ごし
かきあげる	かきあげ
飛び回れる	飛び回れ
焦げつく	焦げつい
あおげる	あおげ
画す	画し
しめる	しめ
くい込む	くい込ん
いならぶ	いならん
漬け込む	漬け込ん
這い出でる	這い出で
聞澄ます	聞澄まし
ねそべる	ねそべっ
現れる	現れ
親しめる	親しめ
はいいる	はいいっ
進み出す	進み出し
貸し越す	貸し越し
はじいる	はじいっ
封じ込む	封じ込ん
炒る	炒っ
取りもてる	取りもて
かなぐり捨てる	かなぐり捨て
盛る	盛っ
とばしる	とばしっ
ふきおろす	ふきおろし
ふれあえる	ふれあえ
申し越す	申し越し
残す	残し
きわ立つ	きわ立っ
あしらう	あしらっ
鬱する	あしらっ
かたまれる	かたまれ
引っ込める	引っ込め
かんがえだす	かんがえだし
囲む	囲ん
繰りあげる	繰りあげ
思い当たる	思い当たっ
事切れる	事切れ
切り回せる	切り回せ
げびる	げび
縋れる	縋れ
でかす	でかし
やくする	でかし
むす	むし
つっぱなす	つっぱなし
まどろむ	まどろん
動かす	動かし
いづ	いで
取組む	取組ん
しおおせる	しおおせ
めくるめく	めくるめい
預け入れる	預け入れ
引き攣れる	引き攣れ
聞き合せる	聞き合せ
はれあがる	はれあがっ
振り回せる	振り回せ
似通う	似通っ
せんじつめる	せんじつめ
高まる	高まっ
彫り込める	彫り込め
乗り上げる	乗り上げ
取り合える	取り合え
まいこむ	まいこん
たちのける	たちのけ
ほとばしる	ほとばしっ
ひかれる	ひかれ
世づく	世づい
やぶれる	やぶれ
書き送る	書き送っ
やってくる	やってき
送る	送っ
打直せる	打直せ
いきる	いき
かしだす	かしだし
ふらす	ふらし
旅だつ	旅だっ
上がる	上がっ
煮詰る	煮詰っ
かわいがる	かわいがっ
つぼめる	つぼめ
ふりわける	ふりわけ
つきやぶれる	つきやぶれ
かけつける	かけつけ
あきれる	あきれ
取りあげる	取りあげ
いのる	いのっ
うまれあわす	うまれあわし
折かさなる	折かさなっ
のっかる	のっかっ
食い止める	食い止め
なでおろす	なでおろし
ほりかえす	ほりかえし
うりあげる	うりあげ
ひきあげる	ひきあげ
わける	わけ
着こなす	着こなし
取り運べる	取り運べ
湯引く	湯引い
たまりかねる	たまりかね
たちはたらく	たちはたらい
見立てる	見立て
てづまる	てづまっ
生まれ合わす	生まれ合わし
押しかぶさる	押しかぶさっ
犯す	犯し
いいあやまる	いいあやまっ
くらいする	いいあやまっ
振出す	振出し
出そろう	出そろっ
すくみ上がる	すくみ上がっ
高じる	高じ
惟みる	惟み
績む	績ん
渡りあう	渡りあっ
くどける	くどけ
ひきつぐ	ひきつい
芽差す	芽差し
からます	からまし
祓う	祓っ
付き合える	付き合え
仰る	仰っ
省く	省い
追い求める	追い求め
せめよせる	せめよせ
放れる	放れ
うちこわす	うちこわし
生れ落ちる	生れ落ち
慎む	慎ん
打ちくだく	打ちくだい
なげかつ	なげかっ
沸き起る	沸き起っ
腐らす	腐らし
枕する	腐らし
せっつく	せっつい
伺える	伺え
挺する	伺え
絶てる	絶て
つかまつる	つかまつっ
くみつく	くみつい
せおいこめる	せおいこめ
あけはなれる	あけはなれ
取結ぶ	取結ん
ちぢこまる	ちぢこまっ
みぬける	みぬけ
濡れる	濡れ
泣ける	泣け
励ませる	励ませ
入れ替える	入れ替え
ほおける	ほおけ
嫁ぐ	嫁い
照らせる	照らせ
ひきさく	ひきさい
ふむ	ふん
発く	発い
駆け込む	駆け込ん
さがしだす	さがしだし
ねじ向ける	ねじ向け
えらびだせる	えらびだせ
借倒す	借倒し
とびかける	とびかけっ
悔改める	悔改め
準える	準え
さえ渡る	さえ渡っ
息せききる	息せききっ
逃げ回る	逃げ回っ
いいなおせる	いいなおせ
呑み込める	呑み込め
有り合せる	有り合せ
さとれる	さとれ
たばねる	たばね
入組む	入組ん
打込む	打込ん
突止める	突止め
焼け落ちる	焼け落ち
取る	取っ
齎す	齎し
敷き詰める	敷き詰め
よじ登る	よじ登っ
色褪せる	色褪せ
なのる	なのっ
うちとける	うちとけ
古る	古っ
喩える	喩え
しゃがみこむ	しゃがみこん
吠える	吠え
明らめる	明らめ
にくむ	にくん
打ち切れる	打ち切れ
調える	調え
編める	編め
しりぬく	しりぬい
しょぼ濡れる	しょぼ濡れ
居竦まる	居竦まっ
たがやす	たがやし
へめぐる	へめぐっ
写し出す	写し出し
つめる	つめっ
捜し当てる	捜し当て
ひきさる	ひきさっ
爪弾く	爪弾い
あざむける	あざむけ
数え切れる	数え切れ
降り込む	降り込ん
はなやぐ	はなやい
抛つつ	抛つっ
紛れ込める	紛れ込め
闘える	闘え
方向付ける	方向付け
略す	略し
跪く	跪い
刻み付ける	刻み付け
言い渡せる	言い渡せ
潰す	潰し
開け放す	開け放し
捲し上げる	捲し上げ
はみ出す	はみ出し
いきながらえる	いきながらえ
あきめく	あきめい
適える	適え
賭する	適え
とおりすぎる	とおりすぎ
取り締まれる	取り締まれ
さぼる	さぼっ
付する	さぼっ
踏み越す	踏み越し
乗越える	乗越え
勢いづく	勢いづい
入り乱れる	入り乱れ
組伏せる	組伏せ
うちきれる	うちきれ
ききだせる	ききだせ
破く	破い
さそう	さそっ
食する	さそっ
よろこびあえる	よろこびあえ
積重ねる	積重ね
捩る	捩っ
しわがれる	しわがれ
しょくする	しわがれ
はきだせる	はきだせ
練り直す	練り直し
下種張る	下種張っ
みはからえる	みはからえ
使い果す	使い果し
捲る	捲っ
記せる	記せ
つれもどす	つれもどし
おっしゃる	おっしゃっ
振り払える	振り払え
かりこむ	かりこん
差うつむく	差うつむい
乾かす	乾かし
恐れ入る	恐れ入っ
なきくらす	なきくらし
ばくする	なきくらし
詠じる	詠じ
抓る	抓っ
ちかづく	ちかづい
誤らす	誤らし
たかなる	たかなっ
横たえる	横たえ
はりまわす	はりまわし
拝む	拝ん
ゆるがす	ゆるがし
ひきずりまわせる	ひきずりまわせ
はらいもどす	はらいもどし
ゆびく	ゆびい
斬る	斬っ
もつれあう	もつれあっ
せめおとす	せめおとし
うちはたす	うちはたし
どよむ	どよん
ついていける	ついていけ
交じる	交じっ
脅える	脅え
うちけす	うちけし
轢く	轢い
うけながせる	うけながせ
降やむ	降やん
うなる	うなっ
さしつかえる	さしつかえ
見あたる	見あたっ
取り扱う	取り扱っ
脱する	取り扱っ
でむかえる	でむかえ
けばだつ	けばだっ
生みだす	生みだし
踏抜く	踏抜い
飲む	飲ん
立ち込める	立ち込め
肯んずる	立ち込め
割出す	割出し
かきなおす	かきなおし
組み上げる	組み上げ
けせる	けせ
弁ずる	けせ
乗あわせる	乗あわせ
統べ括る	統べ括っ
泣き明かす	泣き明かし
産み付ける	産み付け
釣り合う	釣り合っ
枝垂れる	枝垂れ
なかせる	なかせ
めしよせる	めしよせ
宣する	めしよせ
とびかかる	とびかかっ
奮い起す	奮い起し
思い上がる	思い上がっ
さずかる	さずかっ
いれなおす	いれなおし
やぶく	やぶい
さがす	さがし
つみかさねる	つみかさね
おもいなおす	おもいなおし
慣す	慣し
澄ます	澄まし
占う	占っ
心得える	心得え
きばる	きばっ
ぬいあわす	ぬいあわし
飛び出す	飛び出し
絵取る	絵取っ
打ち勝つ	打ち勝っ
節榑立つ	節榑立っ
私する	節榑立っ
取り違える	取り違え
おひゃらかす	おひゃらかし
むちうつ	むちうっ
落延びる	落延び
枯れる	枯れ
つまだてる	つまだて
おちょくる	おちょくっ
取りこぼす	取りこぼし
揺らす	揺らし
払いこむ	払いこん
取り極める	取り極め
吹き上げる	吹き上げ
凋む	凋ん
清まる	清まっ
近寄る	近寄っ
いとなむ	いとなん
かかわれる	かかわれ
たくしあげる	たくしあげ
たてつく	たてつい
怖気付く	怖気付い
繰り返す	繰り返し
そよふく	そよふい
壊れる	壊れ
恐がる	恐がっ
壊せる	壊せ
通り抜ける	通り抜け
ひきだせる	ひきだせ
泳ぐ	泳い
冴える	冴え
握りつぶす	握りつぶし
手がける	手がけ
やきつける	やきつけ
顧みる	顧み
しあげる	しあげ
たたきつぶす	たたきつぶし
敵す	敵し
わかつ	わかっ
つからす	つからし
書き記す	書き記し
吹きだす	吹きだし
混ぜっかえす	混ぜっかえし
せりだす	せりだし
折り返せる	折り返せ
ゆるめる	ゆるめ
引き裂ける	引き裂け
えがく	えがい
振りかざす	振りかざし
入り交じる	入り交じっ
たいらぐ	たいらい
わきおこせる	わきおこせ
撫でつける	撫でつけ
嫌がる	嫌がっ
打ち込める	打ち込め
こかす	こかし
変ずる	こかし
托する	こかし
もちかえる	もちかえっ
跨げる	跨げ
点る	点っ
切り離す	切り離し
かさなりあう	かさなりあっ
切れる	切れ
わかす	わかし
打ちあう	打ちあっ
かもせる	かもせ
けんじる	けんじ
辷らす	辷らし
還る	還っ
待ち設ける	待ち設け
住みつべる	住みつべ
こねかえす	こねかえし
さしむける	さしむけ
弁える	弁え
かち合う	かち合っ
つくせる	つくせ
すりつける	すりつけ
取すがる	取すがっ
貸し出す	貸し出し
組みなおす	組みなおし
はやす	はやし
死に絶える	死に絶え
あがく	あがい
じれこむ	じれこん
ぬかずく	ぬかずい
切り忘れる	切り忘れ
乗りまわす	乗りまわし
疲れる	疲れ
いいあらそえる	いいあらそえ
引き落とせる	引き落とせ
突合す	突合し
弾ずる	突合し
かればむ	かればん
抱えこむ	抱えこん
とりまわす	とりまわし
便る	便っ
あけわたす	あけわたし
しょいこむ	しょいこん
あぐねる	あぐね
投げこむ	投げこん
ふるいおとせる	ふるいおとせ
たべる	たべ
読み返せる	読み返せ
流れ歩く	流れ歩い
拗ねる	拗ね
こく	こい
生きかえる	生きかえっ
書分ける	書分け
さししめせる	さししめせ
気づく	気づい
でき上がる	でき上がっ
照りつける	照りつけ
なくなる	なくなっ
ゆだねる	ゆだね
ずれこめる	ずれこめ
はせ参じる	はせ参じ
浮立つ	浮立っ
眠りこける	眠りこけ
はいつくばう	はいつくばっ
封じ込める	封じ込め
ゆでる	ゆで
蒸ける	蒸け
探る	探っ
耐え抜く	耐え抜い
いぬ	いん
うめあわす	うめあわし
つめよる	つめよっ
はつる	はつっ
来る	来
切り替える	切り替え
しょぼつく	しょぼつい
むずかる	むずかっ
差置く	差置い
奪い合える	奪い合え
くもらせる	くもらせ
見まがう	見まがっ
言い付かる	言い付かっ
いいもらす	いいもらし
みまもる	みまもっ
かかりあう	かかりあっ
のみこむ	のみこん
突きあたる	突きあたっ
持つ	持っ
とりまとめる	とりまとめ
もちこめる	もちこめ
供する	もちこめ
ふるいわける	ふるいわけ
落す	落し
ひろげる	ひろげ
載せる	載せ
動ずる	載せ
組みあう	組みあっ
こすれる	こすれ
縋る	縋っ
祓い清める	祓い清め
とけあえる	とけあえ
ほくそえむ	ほくそえん
向かいあう	向かいあっ
引張る	引張っ
繰り回す	繰り回し
おどかす	おどかし
いかける	いかけ
擦切る	擦切っ
窮まる	窮まっ
消せる	消せ
打ち出せる	打ち出せ
退ける	退け
しつくす	しつくし
架ける	架け
持ち帰れる	持ち帰れ
はかす	はかし
聞き惚れる	聞き惚れ
あばれまくる	あばれまくっ
かっ込む	かっ込ん
とりつく	とりつい
下回る	下回っ
いらだてる	いらだて
吊せる	吊せ
がんばる	がんばっ
肯く	肯い
さやばしる	さやばしっ
戦ぐ	戦い
いとう	いとう
はりかえる	はりかえ
きりさげる	きりさげ
買わす	買わし
服せる	服せ
寄る	寄っ
崩す	崩し
ききおく	ききおい
釣合う	釣合っ
浮び上る	浮び上っ
澄渡る	澄渡っ
舞いこむ	舞いこん
言祝ぐ	言祝い
差越える	差越え
走り抜ける	走り抜け
蹴立てる	蹴立て
老ぼれる	老ぼれ
繰り返せる	繰り返せ
問い掛ける	問い掛け
奪い取れる	奪い取れ
わき返る	わき返っ
貰う	貰っ
繰る	繰っ
駆け寄る	駆け寄っ
抜き取る	抜き取っ
すりこむ	すりこん
しけこむ	しけこん
逝く	逝っ
かけだす	かけだし
競り合う	競り合っ
ねっする	競り合っ
突出す	突出し
ふんばる	ふんばっ
乾反る	乾反っ
回り込める	回り込め
うまる	うまっ
しける	しけ
言い淀む	言い淀ん
はやしたてる	はやしたて
見計らう	見計らっ
奉じる	奉じ
末枯れる	末枯れ
はせ戻る	はせ戻っ
波だつ	波だっ
聞ける	聞け
きりいる	きりいっ
取集める	取集め
祭る	祭っ
悔いる	悔い
恥入る	恥入っ
はいだす	はいだし
誑し込む	誑し込ん
とれる	とれ
がいする	とれ
噎ぶ	噎ん
就く	就い
踏ん切れる	踏ん切れ
言い渡す	言い渡し
抜ける	抜け
あきる	あき
成し遂げる	成し遂げ
呼びつける	呼びつけ
たす	たし
もりかえす	もりかえし
がえんずる	もりかえし
こぐ	こい
おもいまどえる	おもいまどえ
掻き口説く	掻き口説い
鼓する	掻き口説い
窶れる	窶れ
被る	被っ
撥ねる	撥ね
操れる	操れ
興じる	興じ
掘り返す	掘り返し
ひきずりまわす	ひきずりまわし
色あせる	色あせ
去る	去っ
生える	生え
ほめちぎる	ほめちぎっ
守り立てる	守り立て
かこつ	かこっ
さしかためる	さしかため
慣わせる	慣わせ
落ち合う	落ち合っ
差し繰る	差し繰っ
はねかかる	はねかかっ
訓ずる	はねかかっ
並べる	並べ
蹴飛ばす	蹴飛ばし
添わる	添わっ
ふるいおこせる	ふるいおこせ
もれ聞く	もれ聞い
つり上がる	つり上がっ
うなされる	うなされ
割る	割っ
すける	すけ
ついばめる	ついばめ
ほうり込む	ほうり込ん
掻き鳴す	掻き鳴し
蒔き直せる	蒔き直せ
みなおせる	みなおせ
やけおちる	やけおち
治す	治し
侍する	治し
馴す	馴し
立かかる	立かかっ
ゆずりうける	ゆずりうけ
召し具す	召し具し
そびえ立つ	そびえ立っ
立ち戻る	立ち戻っ
練歩く	練歩い
およぐ	およい
あざ笑う	あざ笑っ
かちとる	かちとっ
寄りすがる	寄りすがっ
かぎれる	かぎれ
まちかねる	まちかね
狼狽える	狼狽え
掘れる	掘れ
さしひく	さしひい
秘する	さしひい
猛り立つ	猛り立っ
とりはからう	とりはからっ
幽する	とりはからっ
ろうする	とりはからっ
咲そろう	咲そろっ
きしめく	きしめい
げんずる	きしめい
みすかす	みすかし
うちはなす	うちはなし
とっつかまる	とっつかまっ
身罷る	身罷っ
煉り合せる	煉り合せ
触れ込む	触れ込ん
喰う	喰っ
ほめあげる	ほめあげ
連れ戻す	連れ戻し
増やす	増やし
仕上げる	仕上げ
昏れる	昏れ
老い込む	老い込ん
間に合う	間に合っ
さする	さすっ
吹っとぶ	吹っとん
ひっかく	ひっかい
だきあう	だきあっ
居着く	居着い
牽く	牽い
伸ばす	伸ばし
のりすすめる	のりすすめ
はいりこめる	はいりこめ
草臥れる	草臥れ
縁づく	縁づい
這える	這え
追い掛ける	追い掛け
ふきあげる	ふきあげ
つつみこめる	つつみこめ
食い込める	食い込め
打ち解ける	打ち解け
黙す	黙し
言損なう	言損なっ
いいあわせる	いいあわせ
聳やかす	聳やかし
うべなう	うべなっ
差押える	差押え
せり落す	せり落し
いとめる	いとめ
手向かう	手向かっ
あてこむ	あてこん
細める	細め
きぐす	きぐし
ぼやける	ぼやけ
企てる	企て
測れる	測れ
振る舞える	振る舞え
翔ける	翔け
分ける	分け
佩く	佩い
躍り込む	躍り込ん
まなびとれる	まなびとれ
服する	まなびとれ
打ち直せる	打ち直せ
いけどれる	いけどれ
冒せる	冒せ
かけよれる	かけよれ
開け放せる	開け放せ
冴え返る	冴え返っ
かつぎ上げる	かつぎ上げ
打って出る	打って出
きりくずせる	きりくずせ
ふくす	ふくし
ツクる	ツクっ
見回せる	見回せ
すすみだす	すすみだし
のたくる	のたくっ
遊べる	遊べ
興がる	興がっ
ねばりぬける	ねばりぬけ
押し通す	押し通し
付け込む	付け込ん
詠える	詠え
呼び立てる	呼び立て
負ける	負け
たちすくむ	たちすくん
担ぎ出す	担ぎ出し
出向く	出向い
いわす	いわし
くみなおす	くみなおし
聳える	聳え
ひける	ひけ
ゆさぶる	ゆさぶっ
さしのぼる	さしのぼっ
劃する	さしのぼっ
殺げる	殺げ
染め出す	染め出し
勇気づける	勇気づけ
覗く	覗い
ほうり出す	ほうり出し
折りかさなる	折りかさなっ
潜める	潜め
見透せる	見透せ
さし迫る	さし迫っ
炊き込む	炊き込ん
ほりだす	ほりだし
せめこむ	せめこん
うみだす	うみだし
まきなおせる	まきなおせ
割りほぐす	割りほぐし
あばける	あばけ
言いそびれる	言いそびれ
かみさびる	かみさび
積もる	積もっ
放せる	放せ
追いつめる	追いつめ
迎え入れる	迎え入れ
折りかさねる	折りかさね
引き継げる	引き継げ
作り成す	作り成し
みぬく	みぬい
持ち合わす	持ち合わし
言いつかる	言いつかっ
選りわける	選りわけ
うちくつろぐ	うちくつろい
儚む	儚ん
語り合える	語り合え
飛び上がれる	飛び上がれ
かき集める	かき集め
うちほろぼす	うちほろぼし
ふうずる	うちほろぼし
酔っぱらう	酔っぱらっ
ふりくらす	ふりくらし
引っくくる	引っくくっ
ずれ込める	ずれ込め
ゆずりあう	ゆずりあっ
もちあわす	もちあわし
おもいおこす	おもいおこし
挟める	挟め
さきばしる	さきばしっ
褒める	褒め
買える	買え
うりつける	うりつけ
噛み合わす	噛み合わし
すだつ	すだっ
そんじる	そんじ
めかしこむ	めかしこん
たすけだす	たすけだし
走り抜く	走り抜い
てれる	てれ
関する	てれ
巣立つ	巣立っ
らっする	巣立っ
つくり出す	つくり出し
救う	救っ
溜めこむ	溜めこん
振放す	振放し
叱る	叱っ
しげる	しげっ
帰せる	帰せ
屠る	屠っ
言いまくる	言いまくっ
頼る	頼っ
乗り切る	乗り切っ
にかよう	にかよっ
さがせる	さがせ
書き損じる	書き損じ
囁やく	囁やい
立て篭る	立て篭っ
ふみならす	ふみならし
願い下げる	願い下げ
吹きでる	吹きで
反りくり返る	反りくり返っ
こらす	こらし
払わす	払わし
生きぬく	生きぬい
いすわる	いすわっ
猛る	猛っ
差し出せる	差し出せ
眠りこむ	眠りこん
兼ねる	兼ね
明かす	明かし
有難がる	有難がっ
折り重ねる	折り重ね
落ち着き払う	落ち着き払っ
補する	落ち着き払っ
じゅんじょづける	じゅんじょづけ
そこねる	そこね
育める	育め
摘める	摘め
まちがふ	まちがひ
思いなおす	思いなおし
噛み合う	噛み合っ
つきあえる	つきあえ
取合せる	取合せ
射つ	射っ
しめころす	しめころし
覗ける	覗け
踏破る	踏破っ
寄こす	寄こし
きえはてる	きえはて
ききもらす	ききもらし
まちつける	まちつけ
近づく	近づい
まがる	まがっ
たちはだかる	たちはだかっ
繰合せる	繰合せ
借り上げる	借り上げ
たたき上げる	たたき上げ
売付ける	売付け
やり直す	やり直し
考え込む	考え込ん
卷ける	卷け
読み直す	読み直し
聾する	読み直し
握りつぶせる	握りつぶせ
よびだす	よびだし
はめ込める	はめ込め
手渡す	手渡し
めあわす	めあわし
押しのける	押しのけ
みあわす	みあわし
どうじる	どうじ
取り入る	取り入っ
読み替える	読み替え
うみおとせる	うみおとせ
問う	問っ
押し込める	押し込め
とちる	とちっ
なつめく	なつめい
しのびこめる	しのびこめ
彫れる	彫れ
にぎれる	にぎれ
飛び散る	飛び散っ
払込む	払込ん
くみ上げる	くみ上げ
ふりかかる	ふりかかっ
降り篭める	降り篭め
こうる	こうっ
ねむらす	ねむらし
呼びかける	呼びかけ
くみこむ	くみこん
買い控える	買い控え
したたる	したたっ
おびえる	おびえ
いいつくす	いいつくし
吸い込める	吸い込め
差招く	差招い
ふみとどまる	ふみとどまっ
焼き払う	焼き払っ
見逃せる	見逃せ
集まる	集まっ
撥ね付ける	撥ね付け
掠める	掠め
切り廻す	切り廻し
引き入れる	引き入れ
禿びる	禿び
まかせる	まかせ
切捨てる	切捨て
いれかわれる	いれかわれ
まぜかえせる	まぜかえせ
うきたつ	うきたっ
なきはらす	なきはらし
ためこむ	ためこん
すぎる	すぎ
うちつづく	うちつづい
払い除ける	払い除け
かきなぐる	かきなぐっ
さかせる	さかせ
掘り起こせる	掘り起こせ
ねちがえる	ねちがえ
寄せかける	寄せかけ
ひらく	ひらい
付け狙う	付け狙っ
くだされる	くだされ
観する	くだされ
錬る	錬っ
ねばつく	ねばつい
とぶ	とん
引っつかむ	引っつかん
かき鳴す	かき鳴し
ころばす	ころばし
いきたつ	いきたっ
差しだす	差しだし
世帯染みる	世帯染み
積立てる	積立て
ふせげる	ふせげ
詠み込む	詠み込ん
捕まえる	捕まえ
打ち倒せる	打ち倒せ
あい変わる	あい変わっ
なめずる	なめずっ
連れこむ	連れこん
聞きわける	聞きわけ
思い及ぶ	思い及ん
すり減らす	すり減らし
揺れ動く	揺れ動い
崩れる	崩れ
凝る	凝っ
警める	警め
にしめる	にしめ
受け継げる	受け継げ
聞きとどける	聞きとどけ
思い直せる	思い直せ
触れあう	触れあっ
けむにまく	けむにまい
飛び立つ	飛び立っ
解け合える	解け合え
できあがる	できあがっ
しなる	しなっ
そびれる	そびれ
おいたてる	おいたて
踏みとどまる	踏みとどまっ
凹む	凹ん
たちならぶ	たちならん
ねんずる	たちならん
喜べる	喜べ
停る	停っ
しいたげる	しいたげ
しかくばる	しかくばっ
およろこびもうしあげる	およろこびもうしあげ
きりはなす	きりはなし
たきこむ	たきこん
にげかえる	にげかえっ
踏みしだく	踏みしだい
乗っ取れる	乗っ取れ
盛り上げる	盛り上げ
そわつく	そわつい
とけあう	とけあっ
じだいがかる	じだいがかっ
決まる	決まっ
割り振れる	割り振れ
みわける	みわけ
議す	議し
取交す	取交し
滅入る	滅入っ
ふきかける	ふきかけ
埋め合わす	埋め合わし
見定める	見定め
かけずる	かけずっ
恙む	恙ん
燻ぼる	燻ぼっ
通り掛る	通り掛っ
消し止める	消し止め
しゃくる	しゃくっ
飛び立てる	飛び立て
掃き出す	掃き出し
かしだせる	かしだせ
みくびる	みくびっ
願出る	願出
来はじめる	来はじめ
つなぎ止める	つなぎ止め
決め込む	決め込ん
さっする	決め込ん
しわむ	しわん
つり上げる	つり上げ
揚がる	揚がっ
徴する	揚がっ
ちまう	ちまっ
もの申す	もの申し
ねころがる	ねころがっ
おぼめかす	おぼめかし
はがれる	はがれ
やどる	やどっ
割りきれる	割りきれ
読める	読め
とりしずめる	とりしずめ
濁す	濁し
謝る	謝っ
燻す	燻し
因われる	因われ
配す	配し
おとずれる	おとずれ
こそげる	こそげ
変わり果てる	変わり果て
言い丸める	言い丸め
切り込む	切り込ん
まじえる	まじえ
きょうがる	きょうがっ
つねる	つねっ
拝する	つねっ
縫い合わせる	縫い合わせ
探し出す	探し出し
当てはまる	当てはまっ
縫上げる	縫上げ
うちぬく	うちぬい
まき散らす	まき散らし
引き攣る	引き攣っ
ふるい分ける	ふるい分け
祈る	祈っ
群れる	群れ
帰れる	帰れ
叩く	叩い
突っ張れる	突っ張れ
結び付ける	結び付け
唱う	唱っ
はげませる	はげませ
盛返す	盛返し
ふうじこめる	ふうじこめ
かしこす	かしこし
にぎわせる	にぎわせ
買い求める	買い求め
つのだつ	つのだっ
もくする	つのだっ
さくする	つのだっ
祭れる	祭れ
身構える	身構え
そらとぼける	そらとぼけ
巻き返す	巻き返し
譲れる	譲れ
飛び起きる	飛び起き
乗り外す	乗り外し
向かい合える	向かい合え
とめる	とめ
ひらきなおる	ひらきなおっ
絶入る	絶入っ
聞き及ぶ	聞き及ん
腹立つ	腹立っ
賊する	腹立っ
すがり付く	すがり付い
渇かす	渇かし
減せる	減せ
気色ばむ	気色ばん
振り放す	振り放し
はだかる	はだかっ
みわたせる	みわたせ
へぐ	へい
問いあわせる	問いあわせ
すりよる	すりよっ
ききただせる	ききただせ
のりきる	のりきっ
伝う	伝っ
ねる	ね
限れる	限れ
いきづまる	いきづまっ
こせつく	こせつい
泣きわめく	泣きわめい
学べる	学べ
取り寄せる	取り寄せ
緩まる	緩まっ
粘る	粘っ
手控える	手控え
まじなう	まじなっ
張り回す	張り回し
和解し合える	和解し合え
突っ込む	突っ込ん
行合う	行合っ
おおえる	おおえ
よびさます	よびさまし
許せる	許せ
治まる	治まっ
括る	括っ
はじきかえせる	はじきかえせ
困り抜く	困り抜い
継げる	継げ
しめくくる	しめくくっ
戦う	戦っ
かえりざける	かえりざけ
ひっぱがす	ひっぱがし
ひらきなおれる	ひらきなおれ
飛違う	飛違っ
いたみいる	いたみいっ
きずける	きずけ
解き放つ	解き放っ
凍てつく	凍てつい
つきつめる	つきつめ
いれあげる	いれあげ
すりへらす	すりへらし
おこる	おこっ
すり潰す	すり潰し
責め苛む	責め苛ん
ひきはらう	ひきはらっ
荒だつ	荒だっ
言い習わす	言い習わし
おう	おっ
くりこむ	くりこん
あいいれる	あいいれ
ふくらむ	ふくらん
入る	入っ
ゆだる	ゆだっ
つまぐる	つまぐっ
臭わせる	臭わせ
寝入る	寝入っ
召し抱える	召し抱え
茂る	茂っ
いじくる	いじくっ
見張れる	見張れ
ねじこめる	ねじこめ
聞き返す	聞き返し
咲きほこる	咲きほこっ
買う	買っ
いいのがれる	いいのがれ
磨ける	磨け
のこす	のこし
滅ぼせる	滅ぼせ
騙す	騙し
こみあう	こみあっ
逸す	逸し
滑り込む	滑り込ん
答える	答え
ひきしまる	ひきしまっ
座り込む	座り込ん
ひきたつ	ひきたっ
低める	低め
つまみ出す	つまみ出し
盛り付ける	盛り付け
くい止める	くい止め
はらう	はらっ
なりすます	なりすまし
おきかわる	おきかわっ
埋める	埋め
怖じる	怖じ
きそくだつ	きそくだっ
溜める	溜め
締めくくる	締めくくっ
居溢れる	居溢れ
なう	なっ
もたす	もたし
消え果てる	消え果て
行きあう	行きあっ
おしいる	おしいっ
打合せる	打合せ
滑り落ちる	滑り落ち
年取る	年取っ
めぶく	めぶい
うちなおせる	うちなおせ
おどろきいる	おどろきいっ
いがむ	いがん
物申す	物申し
はらばう	はらばっ
売りきれる	売りきれ
平める	平め
射す	射し
抱き合わせる	抱き合わせ
すべりだせる	すべりだせ
ことたりる	ことたり
てきす	てきし
たたずむ	たたずん
せりおとす	せりおとし
追いつく	追いつい
飲み干す	飲み干し
こける	こけ
しとめる	しとめ
やけつく	やけつい
呑み潰す	呑み潰し
たれ込む	たれ込ん
たちまよう	たちまよっ
もえたつ	もえたっ
行過ぎる	行過ぎ
滑り降りる	滑り降り
明く	明い
禁じる	禁じ
出来す	出来し
上擦る	上擦っ
跳ねかす	跳ねかし
責め落とせる	責め落とせ
洗い上げる	洗い上げ
つつみかくす	つつみかくし
生き返れる	生き返れ
押し倒せる	押し倒せ
追い返せる	追い返せ
追出す	追出し
うち群れる	うち群れ
組付ける	組付け
消し飛ぶ	消し飛ん
こばめる	こばめ
遊ばす	遊ばし
間違える	間違え
粘着く	粘着い
思いわずらう	思いわずらっ
おしせまる	おしせまっ
逸らせる	逸らせ
揺らめく	揺らめい
使いこむ	使いこん
免れる	免れ
やせる	やせ
はやらせる	はやらせ
ざす	ざし
もうしきける	もうしきけ
一旗揚げる	一旗揚げ
ちょうずる	一旗揚げ
逃延びる	逃延び
おい付く	おい付い
選り抜く	選り抜い
酌む	酌ん
終わる	終わっ
にげだせる	にげだせ
うらなえる	うらなえ
住まわせる	住まわせ
はじく	はじい
吊りあげる	吊りあげ
申し合わせる	申し合わせ
ます	まし
睨みあう	睨みあっ
てんじる	てんじ
噛み締める	噛み締め
切りかえる	切りかえ
取りこめる	取りこめ
はりめぐらす	はりめぐらし
酔つぶれる	酔つぶれ
つけかえる	つけかえ
騙し込む	騙し込ん
降り立つ	降り立っ
攻め寄る	攻め寄っ
和める	和め
にぎる	にぎっ
とどめる	とどめ
はらいさげる	はらいさげ
組みあわす	組みあわし
拗らす	拗らし
読流す	読流し
おしまくる	おしまくっ
積み分ける	積み分け
薙ぎ伏せる	薙ぎ伏せ
たやせる	たやせ
けずりたおせる	けずりたおせ
分け合う	分け合っ
むせ返る	むせ返っ
たどりつく	たどりつい
従う	従っ
釣出す	釣出し
焼き上げる	焼き上げ
巻き起こせる	巻き起こせ
固まり合う	固まり合っ
ゆびさす	ゆびさし
駆り立てる	駆り立て
列ぶ	列ん
奮う	奮っ
付加える	付加え
照り付ける	照り付け
争える	争え
追い払える	追い払え
ならびたつ	ならびたっ
うちかつ	うちかっ
いいはる	いいはっ
のがせる	のがせ
打切る	打切っ
あじる	あじっ
染込む	染込ん
閉める	閉め
あおぐ	あおい
離す	離し
あやまる	あやまっ
えみわれる	えみわれ
つけ加わる	つけ加わっ
言い暮す	言い暮し
目掛ける	目掛け
染め上がる	染め上がっ
食込む	食込ん
繰り込む	繰り込ん
つく	つい
負わす	負わし
望む	望ん
慣れ親しむ	慣れ親しん
組上げる	組上げ
障む	障ん
きざめる	きざめ
ゆわえる	ゆわえ
漏る	漏っ
うつ伏せる	うつ伏せ
約する	うつ伏せ
ひるがえせる	ひるがえせ
割り出す	割り出し
代える	代え
こごえる	こごえ
持ち上がる	持ち上がっ
節する	持ち上がっ
抱きこむ	抱きこん
回る	回っ
かきおとす	かきおとし
息詰る	息詰っ
まてる	まて
むつむ	むつん
洗い出す	洗い出し
滑る	滑っ
ゆるせる	ゆるせ
倒れる	倒れ
ふりこめる	ふりこめ
別れる	別れ
てこずる	てこずっ
あいかわる	あいかわっ
打破る	打破っ
申しあわせる	申しあわせ
のりこむ	のりこん
なりだす	なりだし
生きのびる	生きのび
おいだす	おいだし
うすらぐ	うすらい
組入れる	組入れ
すまわす	すまわし
ゆいあげる	ゆいあげ
飲み潰れる	飲み潰れ
よりたおす	よりたおし
付込む	付込ん
こと足る	こと足っ
埋かる	埋かっ
つかいはたす	つかいはたし
熟れる	熟れ
乗出す	乗出し
濯げる	濯げ
ほうむれる	ほうむれ
孵る	孵っ
なで下ろす	なで下ろし
附す	附し
廻れる	廻れ
読み上げる	読み上げ
追ひ廻す	追ひ廻し
射通す	射通し
濾す	濾し
行渡る	行渡っ
聞き届ける	聞き届け
えがきだす	えがきだし
込む	込ん
えり抜く	えり抜い
打直す	打直し
困る	困っ
花開く	花開い
諾する	花開い
かねそなえる	かねそなえ
ねらわれる	ねらわれ
手が込む	手が込ん
ぬぐえる	ぬぐえ
乗りだす	乗りだし
ききそこなう	ききそこなっ
すりかえる	すりかえ
きりあげる	きりあげ
怖じ気付く	怖じ気付い
照らし合せる	照らし合せ
割れる	割れ
てらしあわせる	てらしあわせ
もやせる	もやせ
えばる	えばっ
おじる	おじ
煩いつく	煩いつい
慣らす	慣らし
あせる	あせっ
うらぎれる	うらぎれ
切立つ	切立っ
わずらわせる	わずらわせ
吹っきれる	吹っきれ
つくりだす	つくりだし
応じる	応じ
けずりとれる	けずりとれ
たのむ	たのん
そめあげる	そめあげ
はたらく	はたらい
説きつける	説きつけ
おしこめる	おしこめ
張りめぐらせる	張りめぐらせ
みえすく	みえすい
飛出す	飛出し
ていさいぶる	ていさいぶっ
ふれまわる	ふれまわっ
護る	護っ
いっす	いっし
離せる	離せ
掘りおこす	掘りおこし
思い合わせる	思い合わせ
描き出す	描き出し
集まれる	集まれ
たたみこめる	たたみこめ
まくしあげる	まくしあげ
ほぐれる	ほぐれ
打ち破る	打ち破っ
いいよれる	いいよれ
繰返す	繰返し
にぎわす	にぎわし
読み返す	読み返し
はたらかせる	はたらかせ
低まる	低まっ
降敷く	降敷い
取り合わせる	取り合わせ
選び取れる	選び取れ
賎しめる	賎しめ
ぶちまける	ぶちまけ
おもいきる	おもいきっ
わきおこる	わきおこっ
引返す	引返し
そうろう	そうろっ
編みだす	編みだし
語る	語っ
追掛ける	追掛け
しぼめる	しぼめ
みすかせる	みすかせ
むせび泣く	むせび泣い
うちあける	うちあけ
まいらせる	まいらせ
詰寄る	詰寄っ
やりあう	やりあっ
やわらぐ	やわらい
打ちあげる	打ちあげ
ふるまえる	ふるまえ
ろうたける	ろうたけ
滑り出せる	滑り出せ
染上げる	染上げ
寄れる	寄れ
洗う	洗っ
聞きもらす	聞きもらし
蝕する	聞きもらし
およぎつける	およぎつけ
澄む	澄ん
つれかえる	つれかえっ
乗換える	乗換え
当てこむ	当てこん
飲下す	飲下し
降り懸かる	降り懸かっ
訪う	訪っ
剥せる	剥せ
ちぢめる	ちぢめ
酔っぱらえる	酔っぱらえ
辿る	辿っ
闘う	闘っ
震わせる	震わせ
つまだつ	つまだっ
綴る	綴っ
見開く	見開い
踊る	踊っ
話し掛ける	話し掛け
取り下げる	取り下げ
履ける	履け
果たす	果たし
こばむ	こばん
摩る	摩っ
閃く	閃い
進める	進め
うずもれる	うずもれ
とりわける	とりわけ
吹き替える	吹き替え
立たす	立たし
強まる	強まっ
かたぶける	かたぶけ
つける	つけ
取り換える	取り換え
重ね合わす	重ね合わし
取捨てる	取捨て
書きとめる	書きとめ
謡える	謡え
つなげる	つなげ
跳ね返す	跳ね返し
ききすごす	ききすごし
走れる	走れ
ある	あっ
付け替える	付け替え
吹っかける	吹っかけ
ハネ出す	ハネ出し
点す	点し
引っかける	引っかけ
若く	若い
挽く	挽い
話しかける	話しかけ
切り込める	切り込め
抱き留める	抱き留め
助かる	助かっ
飛びかかる	飛びかかっ
立ち行く	立ち行き
刈り取れる	刈り取れ
結く	結い
恋い慕う	恋い慕っ
はがす	はがし
惚気ける	惚気け
勝越す	勝越し
銘じる	銘じ
たらしこむ	たらしこん
取り篭める	取り篭め
打ち殺す	打ち殺し
言う	言っ
さげすむ	さげすん
割く	割い
出す	出し
すがる	すがっ
ぬく	ぬい
申し込む	申し込ん
発する	申し込ん
みする	申し込ん
押さえ付ける	押さえ付け
打ち合わせる	打ち合わせ
負け越す	負け越し
げきする	負け越し
主立つ	主立っ
しはらう	しはらっ
うちなおす	うちなおし
うちかえせる	うちかえせ
だきとめる	だきとめ
横切れる	横切れ
言いよどむ	言いよどん
きりくずす	きりくずし
へる	へっ
へらす	へらし
手向ける	手向け
ひっつかむ	ひっつかん
見舞う	見舞っ
はめる	はめ
飛立つ	飛立っ
撃ち破る	撃ち破っ
にじりよる	にじりよっ
つけくわえる	つけくわえ
落ちこぼれる	落ちこぼれ
あくたれる	あくたれ
こんぐらかる	こんぐらかっ
経巡る	経巡っ
窄める	窄め
食いしばる	食いしばっ
よいつぶれる	よいつぶれ
みあたる	みあたっ
ちぢかむ	ちぢかん
皺める	皺め
聞き込める	聞き込め
いがみ合う	いがみ合っ
勝てる	勝て
あけはらう	あけはらっ
唸る	唸っ
盛り合わす	盛り合わし
まねぶ	まねん
絞める	絞め
むきあう	むきあっ
よそえる	よそえ
うすまる	うすまっ
立遅れる	立遅れ
なざす	なざし
どける	どけ
上り詰める	上り詰め
たたきあげる	たたきあげ
うけだす	うけだし
炙る	炙っ
つぐなえる	つぐなえ
引き上げる	引き上げ
むかえる	むかえ
堪え忍べる	堪え忍べ
ひからびる	ひからび
はれる	はれ
据え付ける	据え付け
つきでる	つきで
はしりこむ	はしりこん
縮まる	縮まっ
談じ込める	談じ込め
付す	付し
さきそろう	さきそろっ
突っかえす	突っかえし
もちはこぶ	もちはこん
スる	スっ
言寄る	言寄っ
蔑する	言寄っ
あゆみはじめる	あゆみはじめ
つかさどる	つかさどっ
諳んずる	つかさどっ
吹っ掛ける	吹っ掛け
たてなおす	たてなおし
冷かす	冷かし
おもいとどまれる	おもいとどまれ
切りはずす	切りはずし
にふくめる	にふくめ
引きずり出せる	引きずり出せ
織成す	織成し
梳る	梳っ
うちかえす	うちかえし
めなれる	めなれ
突き出せる	突き出せ
ふりむく	ふりむい
掘り進む	掘り進ん
買い占める	買い占め
いぶく	いぶい
もぎる	もぎっ
充てがう	充てがっ
いやす	いやし
跨ぐ	跨い
纏める	纏め
うかがう	うかがっ
差し止める	差し止め
型どれる	型どれ
おとしいれる	おとしいれ
ベタつく	ベタつい
よべる	よべ
掴み合う	掴み合っ
ずりおちる	ずりおち
貯め込む	貯め込ん
のみまわす	のみまわし
喘ぐ	喘い
裏返す	裏返し
引きしめる	引きしめ
ほじる	ほじっ
おおう	おおっ
見て取れる	見て取れ
相続く	相続い
ねりあわせる	ねりあわせ
取り掛かる	取り掛かっ
過ぎる	過ぎ
阿る	阿っ
降こめる	降こめ
にじみ出る	にじみ出
准ずる	にじみ出
巻き上げる	巻き上げ
継ぎ足す	継ぎ足し
生まれ変われる	生まれ変われ
おこなえる	おこなえ
取り交わせる	取り交わせ
たもてる	たもて
繋る	繋っ
かみしめる	かみしめ
ずれこむ	ずれこん
たつ	たっ
嘯く	嘯い
壊す	壊し
よみくらべる	よみくらべ
救える	救え
はせさんじる	はせさんじ
脹らます	脹らまし
咳く	咳い
泳がせる	泳がせ
のりはずす	のりはずし
泣きつく	泣きつい
かえれる	かえれ
言い回す	言い回し
蕩ける	蕩け
乗り出せる	乗り出せ
調う	調っ
こなす	こなし
ふみだせる	ふみだせ
霞む	霞ん
換わる	換わっ
没す	没し
浴びる	浴び
食らわす	食らわし
臨める	臨め
くりひろげる	くりひろげ
かんばしる	かんばしっ
施す	施し
あらいだす	あらいだし
りかいしあえる	りかいしあえ
およる	およっ
かざす	かざし
おさまる	おさまっ
削り取る	削り取っ
屈する	削り取っ
併せる	併せ
しのぐ	しのい
ねづく	ねづい
く	っ
入れ替わる	入れ替わっ
見すかす	見すかし
言い做す	言い做し
ちりばめる	ちりばめ
問いただせる	問いただせ
降りしきる	降りしきっ
打ち上げる	打ち上げ
おりかえせる	おりかえせ
頌する	おりかえせ
読ふける	読ふけっ
迎え撃つ	迎え撃っ
まがう	まがっ
付き纏う	付き纏っ
縮める	縮め
ころせる	ころせ
おもいまどう	おもいまどっ
浚える	浚え
狂れる	狂れ
婀娜めく	婀娜めい
突っ掛る	突っ掛っ
もとむ	もとん
真面目くさる	真面目くさっ
売りつける	売りつけ
はかる	はかっ
したおす	したおし
におう	におっ
たらす	たらし
推し量れる	推し量れ
おしやる	おしやっ
もうしいれる	もうしいれ
暴れ出す	暴れ出し
憤る	憤っ
責付ける	責付け
飲ます	飲まし
按ずる	飲まし
持ち上げる	持ち上げ
ひきさける	ひきさけ
しばる	しばっ
駆け寄れる	駆け寄れ
端折れる	端折れ
佇む	佇ん
怯む	怯ん
ほごす	ほごし
つくろえる	つくろえ
打ち沈む	打ち沈ん
構える	構え
撲りとばす	撲りとばし
座り込める	座り込め
きよまる	きよまっ
たちさる	たちさっ
取合う	取合っ
かき込む	かき込ん
備える	備え
ふとれる	ふとれ
じゃう	じゃっ
折れる	折れ
いきかう	いきかっ
解きあかす	解きあかし
付き随う	付き随っ
おもだつ	おもだっ
人なれる	人なれ
めぐりあえる	めぐりあえ
せき上げる	せき上げ
合える	合え
のみ込む	のみ込ん
量る	量っ
切り出す	切り出し
しつらえる	しつらえ
おっこちる	おっこち
まきつける	まきつけ
つよめる	つよめ
ことかく	ことかい
もぐ	もい
握りしめる	握りしめ
固める	固め
食い込む	食い込ん
いたわりあう	いたわりあっ
触合う	触合っ
差出す	差出し
そしる	そしっ
おしあげる	おしあげ
よろう	よろっ
抜あがる	抜あがっ
さしうつむく	さしうつむい
漂う	漂っ
のりこなせる	のりこなせ
宥める	宥め
打あぐむ	打あぐん
おこす	おこし
取り鎮める	取り鎮め
傷める	傷め
ひきおろせる	ひきおろせ
ふん縛る	ふん縛っ
ひきおとす	ひきおとし
おそなわる	おそなわっ
受け出せる	受け出せ
聴ける	聴け
うきたてる	うきたて
おちいる	おちいっ
のりあげる	のりあげ
突きのめす	突きのめし
馴染める	馴染め
もうしのべる	もうしのべ
煮やす	煮やし
歩みよる	歩みよっ
沸おこる	沸おこっ
はからう	はからっ
集う	集っ
いろづく	いろづい
組み合わす	組み合わし
かいつける	かいつけ
勝抜く	勝抜い
揉む	揉ん
しきつめる	しきつめ
外らせる	外らせ
怠ける	怠け
なげうつ	なげうっ
追い出せる	追い出せ
かいあがる	かいあがっ
会える	会え
申し合わす	申し合わし
すまわせる	すまわせ
澄み切る	澄み切っ
きわまる	きわまっ
よろこべる	よろこべ
もらす	もらし
上向く	上向い
思いがける	思いがけ
のびなやむ	のびなやん
てりかがやく	てりかがやい
挟み切る	挟み切っ
ぼっする	挟み切っ
擦り切れる	擦り切れ
黴びる	黴び
もちあわせる	もちあわせ
ふるぼける	ふるぼけ
蠕く	蠕い
打ちこむ	打ちこん
おもいだす	おもいだし
つっぱれる	つっぱれ
きりたおす	きりたおし
やわらげる	やわらげ
差し戻す	差し戻し
届けでる	届けで
群がる	群がっ
振り込む	振り込ん
わかれる	わかれ
しのびよる	しのびよっ
惑わす	惑わし
居合わせる	居合わせ
つまさきだつ	つまさきだっ
せしめる	せしめ
宿れる	宿れ
成れる	成れ
盈ちる	盈ち
通ずる	盈ち
かいとれる	かいとれ
はるめく	はるめい
切り取れる	切り取れ
聞きただす	聞きただし
遡れる	遡れ
耽る	耽っ
ちなむ	ちなん
さずける	さずけ
とう	とう
とびだす	とびだし
跳ね出す	跳ね出し
盛上がる	盛上がっ
学び取る	学び取っ
こじつける	こじつけ
くわえもつ	くわえもっ
あいなかばする	くわえもっ
よりあつまる	よりあつまっ
雪ぐ	雪い
見合わせる	見合わせ
たのしめる	たのしめ
およぼせる	およぼせ
けとばす	けとばし
ぬきつらねる	ぬきつらね
くみとる	くみとっ
かんけいづける	かんけいづけ
噴き出す	噴き出し
ひきちぎる	ひきちぎっ
買いしめる	買いしめ
さす	さし
赤らめる	赤らめ
打ち抜く	打ち抜い
付あがる	付あがっ
ねじくれる	ねじくれ
ふきとばせる	ふきとばせ
だす	だし
かきいれる	かきいれ
みつけだせる	みつけだせ
当はまる	当はまっ
くぼまる	くぼまっ
ぬぎすてる	ぬぎすて
取りくむ	取りくん
言立てる	言立て
掬する	言立て
焼かす	焼かし
おいぬく	おいぬい
ひきあえる	ひきあえ
呑明かす	呑明かし
洗い流せる	洗い流せ
甲走る	甲走っ
差支える	差支え
割る	割
生じる	生じ
呼込む	呼込ん
止まれる	止まれ
紛らわせる	紛らわせ
切換える	切換え
しみったれる	しみったれ
ふすぶる	ふすぶっ
立て込む	立て込ん
居残れる	居残れ
掻き鳴らす	掻き鳴らし
のろう	のろっ
まじろぐ	まじろい
じらせる	じらせ
痛みいる	痛みいっ
乾し殺す	乾し殺し
勝つ	勝っ
飽きる	飽き
契る	契っ
磨き込む	磨き込ん
設ける	設け
秘す	秘し
言い捨てる	言い捨て
差し出でる	差し出で
仕入れる	仕入れ
取っ組む	取っ組ん
従く	従い
数え立てる	数え立て
ひっ提げる	ひっ提げ
おくりとどける	おくりとどけ
遅らせる	遅らせ
だます	だまし
比べる	比べ
僻む	僻ん
引きずり出す	引きずり出し
罷り間違う	罷り間違っ
たおれる	たおれ
つけあがる	つけあがっ
滴る	滴っ
見向く	見向い
絞め殺す	絞め殺し
懲りる	懲り
知恵づく	知恵づい
遣り合う	遣り合っ
搾り取れる	搾り取れ
量りこむ	量りこん
煮えたぎる	煮えたぎっ
言いふらす	言いふらし
見顕す	見顕し
名付ける	名付け
ちらばる	ちらばっ
承ける	承け
かいならす	かいならし
楽しむ	楽しん
切れ上がる	切れ上がっ
勘づく	勘づい
見なせる	見なせ
判ずる	見なせ
書送る	書送っ
のぼせ上がる	のぼせ上がっ
もみ消せる	もみ消せ
おかけいたす	おかけいたし
引き込める	引き込め
あやつれる	あやつれ
這いつくばう	這いつくばっ
ぶちこむ	ぶちこん
案じる	案じ
語り継ぐ	語り継い
落着ける	落着け
くぐりぬける	くぐりぬけ
造り上げる	造り上げ
引き分ける	引き分け
精げる	精げ
朽ちる	朽ち
つまみあげる	つまみあげ
しばりあげる	しばりあげ
問返す	問返し
おしきれる	おしきれ
なする	なすっ
なおせる	なおせ
撰ぶ	撰ん
つかす	つかし
ふるい落とす	ふるい落とし
ぶん投げる	ぶん投げ
関連づける	関連づけ
ひどる	ひどっ
すくいあげる	すくいあげ
とりのこす	とりのこし
つきそう	つきそっ
おびきだせる	おびきだせ
拉する	おびきだせ
とびあるく	とびあるい
みまがう	みまがっ
つぎ込める	つぎ込め
浴びせかける	浴びせかけ
静まり返る	静まり返っ
悩み抜く	悩み抜い
空かす	空かし
ふるいつく	ふるいつい
くぐもる	くぐもっ
おりこめる	おりこめ
萌える	萌え
そぐ	そい
禦ぐ	禦い
見逃す	見逃し
繁る	繁っ
下せる	下せ
めりこむ	めりこん
つよまる	つよまっ
めいうつ	めいうっ
言い兼ねる	言い兼ね
取り上せる	取り上せ
借り受ける	借り受け
差響く	差響い
やくせる	やくせ
飛び出る	飛び出
しめしあわす	しめしあわし
あせじみる	あせじみ
おいつかう	おいつかっ
すりきる	すりきっ
斥ける	斥け
できる	でき
うすめる	うすめ
ひんまげる	ひんまげ
隙取る	隙取っ
のめり込む	のめり込ん
頂く	頂い
塗れる	塗れ
気付かす	気付かし
まっとうする	気付かし
殺す	殺し
ぶっ続ける	ぶっ続け
はこびこめる	はこびこめ
とびたつ	とびたっ
避ける	避け
としよる	としよっ
合う	合っ
泊める	泊め
渡り合える	渡り合え
釣り上がる	釣り上がっ
期する	釣り上がっ
いばれる	いばれ
切廻す	切廻し
よっぱらう	よっぱらっ
さぐる	さぐっ
誘きよせる	誘きよせ
犒う	犒っ
打ち出す	打ち出し
すさる	すさっ
冷ます	冷まし
注げる	注げ
まちこがれる	まちこがれ
つっぱねる	つっぱね
割り戻す	割り戻し
ねじあう	ねじあっ
震えあがる	震えあがっ
漏れ聞く	漏れ聞い
しめ切る	しめ切っ
ひきころす	ひきころし
よわまる	よわまっ
どもる	どもっ
ひする	どもっ
はする	どもっ
しまう	しまっ
交う	交っ
シャレる	シャレ
ふりだせる	ふりだせ
息せき切る	息せき切っ
栄える	栄え
ひりだす	ひりだし
おる	おっ
かさばる	かさばっ
突っ突く	突っ突い
冴えわたる	冴えわたっ
打ちはらう	打ちはらっ
まいもどれる	まいもどれ
掃く	掃い
たよる	たよっ
見過ごせる	見過ごせ
出あう	出あっ
なきあかす	なきあかし
四角張る	四角張っ
からかう	からかっ
荒ぶ	荒ん
にくまれる	にくまれ
倒す	倒し
どなる	どなっ
踏分ける	踏分け
勢い込む	勢い込ん
よみかえせる	よみかえせ
口ずさむ	口ずさん
尽す	尽し
討ち滅ぼす	討ち滅ぼし
嗅ぐ	嗅い
探り当てる	探り当て
息衝く	息衝い
上る	上っ
買いこむ	買いこん
買戻す	買戻し
ぬくめる	ぬくめ
接げる	接げ
連れ戻せる	連れ戻せ
やくだてる	やくだて
懸け隔てる	懸け隔て
たちつくす	たちつくし
しょうずる	たちつくし
奮い立つ	奮い立っ
ろんじる	ろんじ
掴まえる	掴まえ
あがめる	あがめ
興醒める	興醒め
巡り合う	巡り合っ
そそぐ	そそい
萎える	萎え
かこむ	かこん
朝する	かこん
もたれ掛かる	もたれ掛かっ
着付ける	着付け
よどむ	よどん
そる	そっ
こぎる	こぎっ
量れる	量れ
うりいそぐ	うりいそい
なぞらえる	なぞらえ
灼く	灼い
せつく	せつい
煎りつける	煎りつけ
おりまげる	おりまげ
よびいれる	よびいれ
差し向ける	差し向け
当てつける	当てつけ
好きこのむ	好きこのん
頌える	頌え
むくいる	むくい
かきとる	かきとっ
遊び歩く	遊び歩い
付け合わせる	付け合わせ
かきくらす	かきくらし
のむ	のん
持ちかえる	持ちかえっ
育つ	育っ
あいうつ	あいうっ
炊あがる	炊あがっ
没する	炊あがっ
のめる	のめっ
はこべる	はこべ
解れる	解れ
すげる	すげ
落つ	落っ
綻ぶ	綻ん
刻みつける	刻みつけ
迫る	迫っ
赤らむ	赤らん
見限る	見限っ
巣篭る	巣篭っ
ぬかるむ	ぬかるん
読みこなす	読みこなし
ひきこめる	ひきこめ
くらべる	くらべ
食いつく	食いつい
衝く	衝い
かざりつける	かざりつけ
あだめく	あだめい
言逃れる	言逃れ
責めつける	責めつけ
投げる	投げ
持ち歩ける	持ち歩け
煩う	煩っ
学ぶ	学ん
もちはこべる	もちはこべ
ほれこむ	ほれこん
買い戻す	買い戻し
かけあわせる	かけあわせ
点じる	点じ
間にあう	間にあっ
蒔き直す	蒔き直し
おいまわせる	おいまわせ
かえせる	かえせ
閉込める	閉込め
買い戻せる	買い戻せ
拭き取れる	拭き取れ
黙り込む	黙り込ん
点頭く	点頭い
ひきおこす	ひきおこし
見込む	見込ん
巡り会える	巡り会え
行き暮れる	行き暮れ
かぶれる	かぶれ
こきおろす	こきおろし
じょする	こきおろし
抜き放つ	抜き放っ
ねわすれる	ねわすれ
聞置く	聞置い
剥す	剥し
疎む	疎ん
偽る	偽っ
垂さがる	垂さがっ
ころべる	ころべ
のぞきこむ	のぞきこん
想う	想っ
奢る	奢っ
引っ掻く	引っ掻い
死す	死し
もりころす	もりころし
死に後れる	死に後れ
寄り切る	寄り切っ
ざする	寄り切っ
ぱちつかせる	ぱちつかせ
突っかかる	突っかかっ
つらなる	つらなっ
包める	包め
にがす	にがし
せんする	にがし
みわたす	みわたし
沸かす	沸かし
むさぼる	むさぼっ
励ます	励まし
助け出せる	助け出せ
かみ殺せる	かみ殺せ
きりこまざく	きりこまざい
しごく	しごい
抜き合せる	抜き合せ
突き返す	突き返し
すりあげる	すりあげ
付随う	付随っ
ゆわく	ゆわい
遇する	ゆわい
当て込める	当て込め
見上げる	見上げ
賑わう	賑わっ
費やす	費やし
掃出す	掃出し
差立てる	差立て
つまめる	つまめ
思い込む	思い込ん
増える	増え
擂り潰す	擂り潰し
がする	擂り潰し
よみわける	よみわけ
信じ込める	信じ込め
せきあげる	せきあげ
現ずる	せきあげ
なぜる	なぜ
ひっくりかえれる	ひっくりかえれ
たるむ	たるん
誑す	誑し
あまがける	あまがけっ
はたらける	はたらけ
悄気返る	悄気返っ
切羽詰まる	切羽詰まっ
求む	求ん
だきあえる	だきあえ
食切る	食切っ
産み落とす	産み落とし
留置く	留置い
給う	給っ
廃れる	廃れ
のしあがる	のしあがっ
見とがめる	見とがめ
叶う	叶っ
吊るす	吊るし
注す	注し
つたわる	つたわっ
あやどる	あやどっ
抱きとめる	抱きとめ
なくする	抱きとめ
なでる	なで
読みさす	読みさし
ころがれる	ころがれ
憂える	憂え
追い返す	追い返し
過ごせる	過ごせ
みがく	みがい
さしせまる	さしせまっ
寄り切れる	寄り切れ
追い使う	追い使っ
流行る	流行っ
働きかける	働きかけ
信じ合える	信じ合え
まくらする	信じ合え
とりいる	とりいっ
切り掛ける	切り掛け
そなえる	そなえ
呆れる	呆れ
浸かる	浸かっ
はげ落ちる	はげ落ち
きずつく	きずつい
おくまる	おくまっ
とりそろう	とりそろっ
突き通せる	突き通せ
きょうじる	きょうじ
駆付ける	駆付け
結わえる	結わえ
蟠る	蟠っ
泣き濡れる	泣き濡れ
見透す	見透し
盗める	盗め
引っ込む	引っ込ん
峙つ	峙っ
ながれこむ	ながれこん
どんする	ながれこん
流行らす	流行らし
みなおす	みなおし
忘する	みなおし
詰める	詰め
引き裂く	引き裂い
興す	興し
いぶかる	いぶかっ
映し出す	映し出し
しぼる	しぼっ
ふみこす	ふみこし
計れる	計れ
ひくめる	ひくめ
仕向ける	仕向け
抱く	抱い
立ち寄る	立ち寄っ
ぱくつく	ぱくつい
似る	似
忍び込む	忍び込ん
塗りたくる	塗りたくっ
練り上げる	練り上げ
やむをえる	やむをえ
投げ出す	投げ出し
入れ替る	入れ替っ
粘り抜ける	粘り抜け
ほれる	ほれ
引きかえす	引きかえし
売る	売っ
悼む	悼ん
叩き上げる	叩き上げ
乗り掛かる	乗り掛かっ
ゆずりわたす	ゆずりわたし
すげ替える	すげ替え
たくわえる	たくわえ
売切れる	売切れ
雇える	雇え
かきかえる	かきかえ
羞じらう	羞じらっ
泣付く	泣付い
みあう	みあっ
出張る	出張っ
寝かす	寝かし
くいつぶす	くいつぶし
かきまわす	かきまわし
畳み掛ける	畳み掛け
すまう	すまっ
干枯らびる	干枯らび
取りまく	取りまい
はてる	はて
撃ち落とせる	撃ち落とせ
沸き上がる	沸き上がっ
飲みつぶす	飲みつぶし
いいあらわせる	いいあらわせ
歩き回る	歩き回っ
だける	だけ
決する	だけ
ぬぐう	ぬぐっ
もうしあわす	もうしあわし
血走る	血走っ
顕す	顕し
煉る	煉っ
ぐうする	煉っ
書残す	書残し
取りだす	取りだし
目盛る	目盛っ
敗ける	敗け
洗い立てる	洗い立て
しのぶ	しのん
書き換える	書き換え
死にそこなう	死にそこなっ
やる	やっ
おもいなやむ	おもいなやん
飛び掛る	飛び掛っ
変り果てる	変り果て
でくわす	でくわし
いいあらそう	いいあらそっ
たよれる	たよれ
ふぶく	ふぶい
越せる	越せ
すべくくる	すべくくっ
掴みあう	掴みあっ
持ち崩す	持ち崩し
ふみつぶす	ふみつぶし
堪る	堪っ
呆れ返る	呆れ返っ
片す	片し
はりあえる	はりあえ
なりたつ	なりたっ
走り込める	走り込め
しゃしゃり出る	しゃしゃり出
醒ませる	醒ませ
ゆく	ゆき
縛れる	縛れ
ねりあげる	ねりあげ
存する	ねりあげ
かしずく	かしずい
覆える	覆え
くいあらす	くいあらし
起き直れる	起き直れ
思いあたる	思いあたっ
あやつる	あやつっ
責め合う	責め合っ
おわらす	おわらし
通せる	通せ
とりひしぐ	とりひしい
ひきぬく	ひきぬい
せめさいなむ	せめさいなん
あからめる	あからめ
差し越える	差し越え
進ずる	差し越え
巡り会う	巡り会っ
げんじる	げんじ
覚ませる	覚ませ
ひっかぶる	ひっかぶっ
かなでる	かなで
そりおとせる	そりおとせ
いためつける	いためつけ
害す	害し
聞す	聞し
よなげる	よなげ
すいする	よなげ
見下せる	見下せ
手放せる	手放せ
ゆうきづく	ゆうきづい
やられる	やられ
そむける	そむけ
疑う	疑っ
唄う	唄っ
掴まる	掴まっ
なりあがる	なりあがっ
そそげる	そそげ
弱まる	弱まっ
取り縋る	取り縋っ
持ち越せる	持ち越せ
取り除く	取り除い
収まる	収まっ
ひとはたあげる	ひとはたあげ
切り分ける	切り分け
亙る	亙っ
すべる	すべっ
がなる	がなっ
見遣る	見遣っ
かけめぐる	かけめぐっ
滑らす	滑らし
産み落とせる	産み落とせ
作りかえる	作りかえ
さきはじめる	さきはじめ
つっかかる	つっかかっ
捩じこむ	捩じこん
まきなおす	まきなおし
負ぶさる	負ぶさっ
はさめる	はさめ
つのぐむ	つのぐん
聞き取る	聞き取っ
表立つ	表立っ
見張る	見張っ
差昇る	差昇っ
およぼす	およぼし
尊ぶ	尊ん
考える	考え
賀する	考え
鎮める	鎮め
あだする	鎮め
切り払える	切り払え
盗み出す	盗み出し
ききこめる	ききこめ
追返す	追返し
窪む	窪ん
言切る	言切っ
出で立つ	出で立っ
ぶつかる	ぶつかっ
笑いころげる	笑いころげ
取り入れる	取り入れ
うかびあがれる	うかびあがれ
切らす	切らし
反返る	反返っ
ふせる	ふせっ
逆らう	逆らっ
閉め切る	閉め切っ
夢みる	夢み
ゆき届く	ゆき届い
はく	はい
逃す	逃し
患う	患っ
義務付ける	義務付け
漁る	漁っ
いらう	いらっ
嗜む	嗜ん
まぎらわせる	まぎらわせ
梳かす	梳かし
書き直す	書き直し
立ち上がれる	立ち上がれ
あるく	あるい
押える	押え
のりこめる	のりこめ
こむ	こん
買い入れる	買い入れ
通りかかる	通りかかっ
気にいる	気にいっ
送り返す	送り返し
取替える	取替え
もうしこす	もうしこし
ふみならせる	ふみならせ
おくりかえせる	おくりかえせ
臭わす	臭わし
しなう	しなっ
取り廻す	取り廻し
とりそろえる	とりそろえ
おいつける	おいつけ
申し合せる	申し合せ
とびぬける	とびぬけ
興ざめる	興ざめ
語り込める	語り込め
押さえる	押さえ
現われる	現われ
くずせる	くずせ
おどれる	おどれ
押つまる	押つまっ
先がける	先がけ
さいばしる	さいばしっ
振放つ	振放っ
ねつける	ねつけ
深める	深め
こじあける	こじあけ
請出す	請出し
鄙びる	鄙び
散らす	散らし
払い戻す	払い戻し
揺すぶる	揺すぶっ
すさむ	すさん
たちかわれる	たちかわれ
かよう	かよっ
附ける	附け
あせばむ	あせばん
あまてらす	あまてらし
造りだす	造りだし
うけもつ	うけもっ
渡る	渡っ
かいつまむ	かいつまん
殖える	殖え
打寄せる	打寄せ
ばかげる	ばかげ
おちのびる	おちのび
はいりこむ	はいりこん
敷く	敷い
さきほこる	さきほこっ
丸める	丸め
引き立つ	引き立っ
妬ける	妬け
じゃくする	妬け
はねとばす	はねとばし
煮え繰り返る	煮え繰り返っ
乗り回す	乗り回し
きりはずせる	きりはずせ
着こなせる	着こなせ
召し捕る	召し捕っ
しぼれる	しぼれ
けしきばむ	けしきばん
くるしむ	くるしん
号する	くるしん
噴き上げる	噴き上げ
気おされる	気おされ
くわだてる	くわだて
通る	通っ
狂う	狂っ
決めこむ	決めこん
図れる	図れ
とりあげる	とりあげ
住まう	住まっ
ひんす	ひんし
ふれる	ふれ
言わす	言わし
行く	行き
及ぼす	及ぼし
引払う	引払っ
埋め込める	埋め込め
目くるめく	目くるめい
抜く	抜い
ねり合せる	ねり合せ
纏える	纏え
につめる	につめ
返る	返っ
くりかえす	くりかえし
はらいこめる	はらいこめ
説付ける	説付け
選び出す	選び出し
はやる	はやっ
聞きあきる	聞きあき
おいやれる	おいやれ
切開く	切開い
踞る	踞っ
棄てる	棄て
撓む	撓ん
染あがる	染あがっ
埋めたてる	埋めたて
同じる	同じ
あばれだす	あばれだし
なおす	なおし
呼び起こす	呼び起こし
連れる	連れ
ふりおとせる	ふりおとせ
みだれる	みだれ
誘い合わす	誘い合わし
たちもどる	たちもどっ
眇める	眇め
ねびる	ねび
漉き返す	漉き返し
克つ	克っ
極め付ける	極め付け
こそぎ落とす	こそぎ落とし
まちくたびれる	まちくたびれ
追廻す	追廻し
願い出でる	願い出で
奏する	願い出で
咳き入る	咳き入っ
取り続ける	取り続け
さます	さまし
いためる	いため
ふかす	ふかし
断れる	断れ
ひきとる	ひきとっ
突っ走れる	突っ走れ
くみこめる	くみこめ
うてる	うて
のがす	のがし
磨く	磨い
いきぬける	いきぬけ
盛りつける	盛りつけ
継足す	継足し
弾く	弾い
痴れる	痴れ
くり上げる	くり上げ
ふみだす	ふみだし
たちこむ	たちこん
綻びる	綻び
食倒す	食倒し
炊ぐ	炊い
咲きこぼれる	咲きこぼれ
言い換える	言い換え
静まる	静まっ
悔い改める	悔い改め
隣合う	隣合っ
居坐る	居坐っ
助ける	助け
奏でる	奏で
報う	報っ
まもれる	まもれ
はさみきる	はさみきっ
治る	治っ
のりとおす	のりとおし
といただせる	といただせ
そばだつ	そばだっ
いろどれる	いろどれ
きり組む	きり組ん
産みおとす	産みおとし
寄せる	寄せ
埋め立てる	埋め立て
くわす	くわし
紐解く	紐解い
さしいれる	さしいれ
辷り込む	辷り込ん
傾ぐ	傾い
売り払える	売り払え
むく	むい
うちこめる	うちこめ
やせこける	やせこけ
まつわる	まつわっ
煮え滾る	煮え滾っ
翳る	翳っ
一肌脱ぐ	一肌脱い
くめる	くめ
わかやぐ	わかやい
つっぱしる	つっぱしっ
裁ける	裁け
はっする	裁け
述べる	述べ
押返す	押返し
まわりこめる	まわりこめ
力付ける	力付け
切り立てる	切り立て
かどだつ	かどだっ
せめかける	せめかけ
きしる	きしっ
引き戻せる	引き戻せ
うもれる	うもれ
辞する	うもれ
編む	編ん
取広げる	取広げ
止む	止ん
有触れる	有触れ
ねらい打てる	ねらい打て
立てこもる	立てこもっ
除く	除い
甜める	甜め
聞損なう	聞損なっ
聞き捨てる	聞き捨て
ふみしだく	ふみしだい
読み耽る	読み耽っ
挟み込む	挟み込ん
絡める	絡め
走り回れる	走り回れ
ただれる	ただれ
滾つ	滾っ
なすり付ける	なすり付け
あつめる	あつめ
カエる	カエっ
手伝える	手伝え
はりあわす	はりあわし
熱る	熱っ
しょい込む	しょい込ん
くみつける	くみつけ
たずさわる	たずさわっ
練り直せる	練り直せ
たたきおこす	たたきおこし
とりざたす	とりざたし
育む	育ん
きなさる	きなさっ
寝かせる	寝かせ
なつく	なつい
かぎ出せる	かぎ出せ
飛び離れる	飛び離れ
たれさがる	たれさがっ
とりちがえる	とりちがえ
言い放す	言い放し
配り歩ける	配り歩け
吹きまくる	吹きまくっ
へし折る	へし折っ
受止める	受止め
啜り泣く	啜り泣い
張り合う	張り合っ
あか抜ける	あか抜け
知らせる	知らせ
帯びる	帯び
むすぶ	むすん
打ち見る	打ち見
行届く	行届い
華やぐ	華やい
おそれる	おそれ
たずねる	たずね
あるける	あるけ
突っ伏す	突っ伏し
つちかえる	つちかえ
住み替る	住み替っ
いや増す	いや増し
ぶち当てる	ぶち当て
つきすすめる	つきすすめ
おさえこむ	おさえこん
舞戻る	舞戻っ
撮れる	撮れ
あばく	あばい
しれる	しれ
整う	整っ
かきくれる	かきくれ
踏み付ける	踏み付け
呵る	呵っ
持込む	持込ん
だまりこくる	だまりこくっ
ほてる	ほてっ
染みる	染み
連れ回す	連れ回し
暗む	暗ん
待ち付ける	待ち付け
買切る	買切っ
勝ち越せる	勝ち越せ
着ぶくれる	着ぶくれ
おどす	おどし
間引ける	間引け
たやす	たやし
うめこめる	うめこめ
すめる	すめ
見抜ける	見抜け
嫌われる	嫌われ
盛あがる	盛あがっ
息む	息ん
創り出す	創り出し
ぶつ	ぶっ
ふきあれる	ふきあれ
振り払う	振り払っ
みきる	みきっ
ごてる	ごて
しんじこむ	しんじこん
差伸べる	差伸べ
さしぐむ	さしぐん
飛び廻る	飛び廻っ
取違える	取違え
かんじいる	かんじいっ
辞む	辞ん
のりかかる	のりかかっ
とむ	とん
ひる	ひ
色づく	色づい
とうじる	とうじ
討止める	討止め
しもがかる	しもがかっ
落合う	落合っ
ふみぬく	ふみぬい
しみわたる	しみわたっ
捕る	捕っ
もえつく	もえつい
並べ立てる	並べ立て
かたれる	かたれ
撃てる	撃て
さまよう	さまよっ
ほえる	ほえ
引つれる	引つれ
思い悩む	思い悩ん
組み直す	組み直し
投出す	投出し
血ばしる	血ばしっ
折れ込む	折れ込ん
扱き下ろす	扱き下ろし
まとえる	まとえ
喫する	まとえ
よこぎる	よこぎっ
乗り付ける	乗り付け
けんずる	乗り付け
刈り入れる	刈り入れ
倒せる	倒せ
さしかかる	さしかかっ
閉す	閉し
かしこまる	かしこまっ
あららげる	あららげ
擦れる	擦れ
ありがたがる	ありがたがっ
抱きしめる	抱きしめ
みちびきだせる	みちびきだせ
ひっとらえる	ひっとらえ
おしかける	おしかけ
どなりこむ	どなりこん
やらかす	やらかし
くるう	くるっ
明け渡す	明け渡し
渡り合う	渡り合っ
手間取る	手間取っ
貸し出せる	貸し出せ
相いれる	相いれ
えどる	えどっ
掻き出す	掻き出し
しいする	掻き出し
取乱す	取乱し
なりわたる	なりわたっ
熟する	なりわたっ
やきすてる	やきすて
張り巡らす	張り巡らし
駆り集める	駆り集め
潮垂れる	潮垂れ
冷やかす	冷やかし
貯める	貯め
引き渡す	引き渡し
たかめる	たかめ
ちぢむ	ちぢん
いらっしゃる	いらっしゃっ
塗付ける	塗付け
縢る	縢っ
詠み込める	詠み込め
伸びゆく	伸びゆき
埋め合せる	埋め合せ
はせさんずる	埋め合せ
蔑む	蔑ん
待てる	待て
鎮まる	鎮まっ
あそべる	あそべ
たてる	たて
こしらえる	こしらえ
うっちゃる	うっちゃっ
開ける	開け
谷まる	谷まっ
なベかえる	なベかえ
あずけいれる	あずけいれ
追いかける	追いかけ
よみとおす	よみとおし
行き詰まる	行き詰まっ
騒がす	騒がし
見え透く	見え透い
おそわれる	おそわれ
巣だつ	巣だっ
落ち着く	落ち着い
追い縋る	追い縋っ
きえのこる	きえのこっ
おく	おい
いける	いけ
産む	産ん
つたう	つたっ
ときつける	ときつけ
歩き回れる	歩き回れ
突あたる	突あたっ
約す	約し
はいす	はいし
うわつく	うわつい
下ろす	下ろし
すすみだせる	すすみだせ
競る	競っ
こりかたまる	こりかたまっ
遣い込む	遣い込ん
悖る	悖っ
踏みしめる	踏みしめ
ほほえむ	ほほえん
誘い掛ける	誘い掛け
読みつぐ	読みつい
信ずる	読みつい
ゆき悩む	ゆき悩ん
薫る	薫っ
とりこむ	とりこん
攫う	攫っ
突っぱねる	突っぱね
かねあう	かねあっ
はまる	はまっ
揺さぶる	揺さぶっ
受けつける	受けつけ
もどせる	もどせ
繰り入れる	繰り入れ
生まれ変わる	生まれ変わっ
持たす	持たし
降り続く	降り続い
縫いつける	縫いつけ
とびはなれる	とびはなれ
にぶる	にぶっ
浮つく	浮つい
夾む	夾ん
よわめる	よわめ
変る	変っ
さけぶ	さけん
くぼめる	くぼめ
でそろう	でそろっ
散りはてる	散りはて
のりおくれる	のりおくれ
つかうまつる	つかうまつっ
引っ捕える	引っ捕え
取戻す	取戻し
うすれる	うすれ
もりあがる	もりあがっ
称す	称し
暴ける	暴け
ひきのける	ひきのけ
しぼり上げる	しぼり上げ
さがしだせる	さがしだせ
いきり立つ	いきり立っ
抜く	抜い
取りまとめる	取りまとめ
ふっ切れる	ふっ切れ
絶えはてる	絶えはて
えんじる	えんじ
行く	行っ
転がす	転がし
うちやぶる	うちやぶっ
捜せる	捜せ
引こもる	引こもっ
組み合す	組み合し
思い起こせる	思い起こせ
絞る	絞っ
なつかしむ	なつかしん
ふきこめる	ふきこめ
泳ぎ着く	泳ぎ着い
成り下がれる	成り下がれ
たすける	たすけ
そそり立てる	そそり立て
たたき出す	たたき出し
取り消す	取り消し
繰り出せる	繰り出せ
染め返す	染め返し
とびこむ	とびこん
ひしげる	ひしげ
吹き飛ぶ	吹き飛ん
盛り込める	盛り込め
手こずる	手こずっ
むかいあう	むかいあっ
掴める	掴め
引攣れる	引攣れ
楯突く	楯突い
ひきさがる	ひきさがっ
肖る	肖っ
便ずる	肖っ
摘み取る	摘み取っ
せいだせる	せいだせ
断てる	断て
りゃくす	りゃくし
降りかかる	降りかかっ
うえこめる	うえこめ
酔しれる	酔しれ
はぐらかせる	はぐらかせ
しあがる	しあがっ
取壊す	取壊し
吹きすさぶ	吹きすさん
ゆがめる	ゆがめ
生かる	生かっ
とり殺す	とり殺し
かきくもる	かきくもっ
乱れる	乱れ
さがしまわる	さがしまわっ
庇う	庇っ
ついてまわる	ついてまわっ
かいつくろう	かいつくろっ
ふける	ふけ
飛びたつ	飛びたっ
採り上げる	採り上げ
くみす	くみし
明け離れる	明け離れ
取りつく	取りつい
買い被る	買い被っ
むらだつ	むらだち
浮きたつ	浮きたっ
持て扱う	持て扱っ
おさえる	おさえ
翻る	翻っ
飲み下す	飲み下し
著す	著し
わびる	わび
とげだつ	とげだっ
賜う	賜っ
いする	賜っ
のけぞる	のけぞっ
勇気づく	勇気づい
勢いづける	勢いづけ
突く	突い
ふんじばる	ふんじばっ
待ち伏せる	待ち伏せ
さいなむ	さいなん
たてとおす	たてとおし
詣る	詣っ
うる	詣っ
謳う	謳っ
すいあげる	すいあげ
逃せる	逃せ
まちもうける	まちもうけ
当こする	当こすっ
行き合う	行き合っ
折りたたむ	折りたたん
うちあぐむ	うちあぐん
下がかる	下がかっ
縮み上がる	縮み上がっ
飛び上がる	飛び上がっ
取り付ける	取り付け
ゆきあたる	ゆきあたっ
零落れる	零落れ
かまける	かまけ
蒸らす	蒸らし
合う	合っ
縮む	縮ん
経上がる	経上がっ
立ち上がる	立ち上がっ
ぬきだせる	ぬきだせ
告ぐ	告い
だす	だし
突き出す	突き出し
取りやめる	取りやめ
つきかえす	つきかえし
ざんねんがる	ざんねんがっ
付け加える	付け加え
やりとげる	やりとげ
ふりまく	ふりまい
屯する	ふりまい
はりあう	はりあっ
召し上げる	召し上げ
解けあう	解けあっ
切り開く	切り開い
見直す	見直し
打ちあわす	打ちあわし
窺う	窺っ
貶む	貶ん
捏ねかえす	捏ねかえし
呼び叫ぶ	呼び叫ん
たちいたる	たちいたっ
たまげる	たまげ
受継ぐ	受継い
消え残る	消え残っ
さしひかえる	さしひかえ
追い越せる	追い越せ
じゅんずる	追い越せ
建つ	建っ
終わらせる	終わらせ
もみあう	もみあっ
差し付ける	差し付け
むきあえる	むきあえ
寝そびれる	寝そびれ
立回る	立回っ
舞い戻れる	舞い戻れ
言い当てる	言い当て
すっ飛ぶ	すっ飛ん
生れおちる	生れおち
乗り組める	乗り組め
いらっしゃる	いらっしゃっ
切上げる	切上げ
貢ずる	切上げ
さしだせる	さしだせ
わたりあう	わたりあっ
守り抜く	守り抜い
うずもる	うずもっ
保てる	保て
みひらく	みひらい
引き合わす	引き合わし
過ぎ行く	過ぎ行き
因む	因ん
いちゃつく	いちゃつい
糶る	糶っ
捲き揚げる	捲き揚げ
ひきずりだす	ひきずりだし
取り壊せる	取り壊せ
攻めたてる	攻めたて
為す	為し
澄みわたる	澄みわたっ
填る	填っ
周章てる	周章て
感づく	感づい
たちなおる	たちなおっ
跳ねあがる	跳ねあがっ
値する	跳ねあがっ
ぐずつく	ぐずつい
かき寄せる	かき寄せ
奨める	奨め
折畳む	折畳ん
馴れ合う	馴れ合っ
作り出せる	作り出せ
守る	守っ
かりとれる	かりとれ
思い知らす	思い知らし
とおれる	とおれ
巻きこむ	巻きこん
並みいる	並みい
めんじる	めんじ
陳べる	陳べ
たちそう	たちそっ
さしとめる	さしとめ
調べる	調べ
惚ける	惚け
ゆるぎ出る	ゆるぎ出
べと付く	べと付い
まちあわす	まちあわし
煮含める	煮含め
べとつく	べとつい
かりたてる	かりたて
かりきる	かりきっ
つからせる	つからせ
捜し求める	捜し求め
撫す	撫し
くみとれる	くみとれ
かっ飛ばす	かっ飛ばし
かき鳴らす	かき鳴らし
ふるわせる	ふるわせ
鋳潰す	鋳潰し
食違う	食違っ
打ち合せる	打ち合せ
せせくる	せせくっ
気付く	気付い
触回る	触回っ
走り回る	走り回っ
とぐ	とい
いいこめる	いいこめ
かこつける	かこつけ
振り当てる	振り当て
にぎわう	にぎわっ
こわばる	こわばっ
長引く	長引い
みきわめる	みきわめ
押通す	押通し
かたづく	かたづい
すいとる	すいとっ
おきあがれる	おきあがれ
航る	航っ
浮べる	浮べ
引きたてる	引きたて
さしこす	さしこし
掘り出す	掘り出し
染めかえす	染めかえし
泣込む	泣込ん
とりまぎれる	とりまぎれ
かけまわる	かけまわっ
見なれる	見なれ
思い止る	思い止っ
老いる	老い
すすむ	すすん
くりだす	くりだし
廻す	廻し
寝惚ける	寝惚け
凝り固まる	凝り固まっ
向き直る	向き直っ
塞がる	塞がっ
ふちどる	ふちどっ
脹らむ	脹らん
たぶらかす	たぶらかし
年老いる	年老い
買い込む	買い込ん
征する	買い込ん
届ける	届け
勝ち越す	勝ち越し
にぎわわす	にぎわわし
ゆける	ゆけ
捌かす	捌かし
縛り上げる	縛り上げ
はしょれる	はしょれ
だまくらかす	だまくらかし
捺す	捺し
問いただす	問いただし
相伴う	相伴っ
かがやかす	かがやかし
売り払う	売り払っ
のりする	売り払っ
滑り込める	滑り込め
吸い取る	吸い取っ
重んじる	重んじ
もどる	もどっ
恨む	恨ん
はやめる	はやめ
錆び付く	錆び付い
つめきる	つめきっ
怒鳴り込む	怒鳴り込ん
観ずる	怒鳴り込ん
引当てる	引当て
押し薦める	押し薦め
あてがう	あてがっ
つやめく	つやめい
取次ぐ	取次い
捨て去る	捨て去っ
さぐりだせる	さぐりだせ
仕上る	仕上っ
乗ずる	仕上っ
にえる	にえ
留め置く	留め置い
敷きつめる	敷きつめ
交ぜっかえす	交ぜっかえし
かき消す	かき消し
切り裂く	切り裂い
烟る	烟っ
ききつける	ききつけ
煮る	煮
みにつける	みにつけ
ぐれる	ぐれ
ねりあわす	ねりあわし
つきとおす	つきとおし
座りこむ	座りこん
臥せる	臥せっ
立ち去る	立ち去っ
降す	降し
おじける	おじけ
かすむ	かすん
ねらい打つ	ねらい打っ
織れる	織れ
はびこる	はびこっ
見直せる	見直せ
仰向く	仰向い
満ち足りる	満ち足り
つぎたせる	つぎたせ
乗りかける	乗りかけ
さらけだす	さらけだし
なげかてる	なげかて
則る	則っ
ころぶ	ころん
しぶる	しぶっ
こびり着く	こびり着い
みみなれる	みみなれ
拉ぐ	拉い
憂ふ	憂ひ
分け与える	分け与え
位置付ける	位置付け
おもいきれる	おもいきれ
弄ぶ	弄ん
飛び乗れる	飛び乗れ
売りさばく	売りさばい
おもいこむ	おもいこん
握る	握っ
考え出す	考え出し
係わる	係わっ
塗り替える	塗り替え
堪りかねる	堪りかね
きつける	きつけ
しゃぶる	しゃぶっ
降かかる	降かかっ
吹き出る	吹き出
叱り付ける	叱り付け
物言う	物言っ
とびかう	とびかっ
適う	適っ
弘める	弘め
服す	服し
おしきる	おしきっ
乱す	乱し
助け合う	助け合っ
もめる	もめ
追える	追え
寵する	追え
繰り合せる	繰り合せ
にごらす	にごらし
改まる	改まっ
伐つ	伐っ
ひれふす	ひれふし
打取れる	打取れ
しのべる	しのべ
きえうせる	きえうせ
かい摘む	かい摘ん
為出かす	為出かし
酔う	酔う
うけつける	うけつけ
取り扱える	取り扱え
這い出す	這い出し
入りまじる	入りまじっ
打壊す	打壊し
見積る	見積っ
恥じる	恥じ
襲かかる	襲かかっ
張飛ばす	張飛ばし
亡くす	亡くし
降らせる	降らせ
培える	培え
宿す	宿し
捻じくれる	捻じくれ
かしつける	かしつけ
言い寄る	言い寄っ
込上げる	込上げ
こと足りる	こと足り
誂える	誂え
消え失せる	消え失せ
使える	使え
さきわう	さきわっ
くたびれる	くたびれ
張り詰める	張り詰め
張裂ける	張裂け
取り崩せる	取り崩せ
逆巻く	逆巻い
切りかかる	切りかかっ
思いあわせる	思いあわせ
つまびく	つまびい
しばたたく	しばたたい
あげつらる	あげつらっ
付回す	付回し
呑み明かす	呑み明かし
おいかえす	おいかえし
思い乱れる	思い乱れ
呼び入れる	呼び入れ
賑やかす	賑やかし
骨ばる	骨ばっ
誘いまくる	誘いまくっ
割ける	割け
光り輝く	光り輝い
絶やせる	絶やせ
容れる	容れ
則する	容れ
餌付く	餌付い
読み誤る	読み誤っ
ふきとる	ふきとっ
涸れる	涸れ
おどける	おどけ
ためらう	ためらっ
おもいわずらう	おもいわずらっ
埋め合わせる	埋め合わせ
徹る	徹っ
へす	へし
たたき込める	たたき込め
ととのえなおす	ととのえなおし
しずめる	しずめ
書き込める	書き込め
じゃらつく	じゃらつい
笑む	笑ん
たえる	たえ
飽き飽きする	たえ
ゆるぎでる	ゆるぎで
かいくる	かいくっ
おぶる	おぶっ
買い与える	買い与え
こき下ろす	こき下ろし
たちのぼる	たちのぼっ
刈り上げる	刈り上げ
ちょんぎる	ちょんぎっ
いいはなす	いいはなし
召しあげる	召しあげ
きりつける	きりつけ
いびり出す	いびり出し
付け上がる	付け上がっ
形づくる	形づくっ
つうぶる	つうぶっ
うれえる	うれえ
逆立てる	逆立て
舞い上がる	舞い上がっ
はこびだせる	はこびだせ
覚える	覚え
晒せる	晒せ
といあわす	といあわし
きり入る	きり入っ
毒づく	毒づい
急かせる	急かせ
逝く	逝い
腰掛ける	腰掛け
いる	い
切りかける	切りかけ
先走る	先走っ
ふきはらう	ふきはらっ
あかぬける	あかぬけ
おうずる	あかぬけ
起あがる	起あがっ
咲き誇る	咲き誇っ
めしあがれる	めしあがれ
ふみにじる	ふみにじっ
かたりこむ	かたりこん
震い付く	震い付い
削り取れる	削り取れ
浮び上がる	浮び上がっ
娶す	娶し
思いつめる	思いつめ
つめかえる	つめかえ
すべりおりる	すべりおり
かぐ	かい
打倒せる	打倒せ
より抜ける	より抜け
嗄れる	嗄れ
渡す	渡し
悟る	悟っ
ふれ合う	ふれ合っ
引込む	引込ん
赤める	赤め
差し押える	差し押え
こんじる	こんじ
折りこむ	折りこん
疲らす	疲らし
いきかえる	いきかえっ
きる	きっ
刈込む	刈込ん
片寄せる	片寄せ
つくねる	つくね
振りはらう	振りはらっ
ひけらかす	ひけらかし
せばまる	せばまっ
打ち落とせる	打ち落とせ
しくじる	しくじっ
ねかす	ねかし
にえたぎる	にえたぎっ
こうずる	にえたぎっ
おどりはじめる	おどりはじめ
寫せる	寫せ
勤しむ	勤しん
永らえる	永らえ
忘れる	忘れ
ふてくされる	ふてくされ
当たり散らす	当たり散らし
論じる	論じ
描ける	描け
めいる	めいっ
渦まく	渦まい
照りはえる	照りはえ
くすむ	くすん
見きわめる	見きわめ
牛耳る	牛耳っ
はい出る	はい出
持ち運べる	持ち運べ
きしむ	きしん
振り込める	振り込め
聞きほれる	聞きほれ
義務づける	義務づけ
損ねる	損ね
おこせる	おこせ
うけもてる	うけもて
くりまわす	くりまわし
つきとばせる	つきとばせ
貴ぶ	貴ん
おりたたむ	おりたたん
割り出せる	割り出せ
とどこおる	とどこおっ
さびつく	さびつい
咲乱れる	咲乱れ
存じる	存じ
きえさる	きえさっ
這入る	這入っ
思いたつ	思いたっ
ひとかわむく	ひとかわむい
ききおとす	ききおとし
ただす	ただし
たえはてる	たえはて
持て成す	持て成し
現せる	現せ
わらわれる	わらわれ
おれこむ	おれこん
頭抜ける	頭抜け
匂わす	匂わし
関わる	関わっ
ひきつける	ひきつけ
鳴る	鳴っ
見のがす	見のがし
印する	見のがし
慴れる	慴れ
気が付く	気が付い
ふりむける	ふりむけ
あるきまわる	あるきまわっ
乗り移る	乗り移っ
咲きでる	咲きで
こぼれる	こぼれ
採り入れる	採り入れ
着膨れる	着膨れ
弛れる	弛れ
手伝う	手伝っ
せいす	せいし
撲りつける	撲りつけ
飛回る	飛回っ
くずれさる	くずれさっ
有す	有し
手繰る	手繰っ
彩る	彩っ
くいちがう	くいちがっ
放る	放っ
賑わせる	賑わせ
遠退ける	遠退け
亡ぼす	亡ぼし
廻せる	廻せ
こもれる	こもれ
乗せる	乗せ
殺せる	殺せ
擧げる	擧げ
まよう	まよう
まじわれる	まじわれ
ぼける	ぼけ
叩きあげる	叩きあげ
はむ	はん
ききわける	ききわけ
組織だつ	組織だっ
滑れる	滑れ
居合せる	居合せ
食止める	食止め
冴え渡る	冴え渡っ
あいつぐ	あいつい
ちゃう	ちゃっ
あらそえる	あらそえ
さしあたる	さしあたっ
酔える	酔え
まとまる	まとまっ
ひきこもる	ひきこもっ
くぎれる	くぎれ
ちがう	ちがっ
辞める	辞め
追いやる	追いやっ
潰える	潰え
すずめる	すずめ
くれる	くれ
鍛える	鍛え
もちだす	もちだし
引っ掴む	引っ掴ん
稼ぐ	稼い
対する	稼い
列する	稼い
はさみこめる	はさみこめ
繁り合う	繁り合っ
喫す	喫し
処す	処し
取り分ける	取り分け
つづりあわせる	つづりあわせ
てらす	てらし
つかむ	つかん
てがこむ	てがこん
組み立てる	組み立て
貶す	貶し
ダブつく	ダブつい
おぶさる	おぶさっ
捌ける	捌け
印象づける	印象づけ
詰込む	詰込ん
たしなむ	たしなん
看取れる	看取れ
目する	看取れ
いいすてる	いいすて
ばいする	いいすて
降りそそぐ	降りそそい
堰く	堰い
護れる	護れ
くだく	くだい
吊上がる	吊上がっ
肥す	肥し
せせらわらえる	せせらわらえ
和らげる	和らげ
臭う	臭っ
直す	直し
照り輝く	照り輝い
かききえる	かききえ
打ち取れる	打ち取れ
煮えくりかえる	煮えくりかえっ
動かせる	動かせ
へつらう	へつらっ
ひねる	ひねっ
ほりすすむ	ほりすすん
あるきつづける	あるきつづけ
曇る	曇っ
説く	説い
しのばす	しのばし
ぶったぎる	ぶったぎっ
擂り込む	擂り込ん
附く	附い
航れる	航れ
付け加わる	付け加わっ
傾ける	傾け
よみきれる	よみきれ
切りこまざく	切りこまざい
切り刻む	切り刻ん
生け捕れる	生け捕れ
てらう	てらっ
てばなす	てばなし
まけこす	まけこし
あげる	あげ
さっぴく	さっぴい
這い纏る	這い纏っ
とおのく	とおのい
交ざる	交ざっ
売り渡す	売り渡し
鳴きしきる	鳴きしきっ
うばいとる	うばいとっ
詠みこむ	詠みこん
いいふるす	いいふるし
つつむ	つつん
捜す	捜し
歎ずる	捜し
埋もれる	埋もれ
かくまう	かくまっ
でつくす	でつくし
飛乗る	飛乗っ
腐す	腐し
取り殺す	取り殺し
ひきのばせる	ひきのばせ
つまみだせる	つまみだせ
きかかる	きかかっ
とく	とい
こんがらがる	こんがらがっ
おりあえる	おりあえ
こぼせる	こぼせ
はりこむ	はりこん
ふりはらえる	ふりはらえ
出切る	出切っ
たたきこむ	たたきこん
教わる	教わっ
花やぐ	花やい
責めさいなむ	責めさいなん
噛みしめる	噛みしめ
狂わす	狂わし
装える	装え
さしのべる	さしのべ
つきとおせる	つきとおせ
さばく	さばい
滞る	滞っ
ふりはなつ	ふりはなっ
振りまく	振りまい
特性づける	特性づけ
問い返す	問い返し
ねたむ	ねたん
ねころべる	ねころべ
待設ける	待設け
拾い上げる	拾い上げ
舞込む	舞込ん
飛び回る	飛び回っ
感じとれる	感じとれ
走る	走っ
かむ	かん
たたき起こす	たたき起こし
突き刺せる	突き刺せ
寄り掛かる	寄り掛かっ
ふやける	ふやけ
よがる	よがっ
たたかえる	たたかえ
乗り進める	乗り進め
しわぶく	しわぶい
穢れる	穢れ
さすらう	さすらっ
当り散らす	当り散らし
ぼくする	当り散らし
掻い出す	掻い出し
繰り延べる	繰り延べ
たいする	繰り延べ
いりくむ	いりくん
対す	対し
一花咲かせる	一花咲かせ
振込む	振込ん
ゆりおこす	ゆりおこし
送り返せる	送り返せ
よりわける	よりわけ
近づける	近づけ
くろずむ	くろずん
踏み出す	踏み出し
座りこめる	座りこめ
きゅうする	座りこめ
若がえる	若がえっ
ひっかえす	ひっかえし
言触らす	言触らし
推し量る	推し量っ
知りぬく	知りぬい
擁す	擁し
見積もれる	見積もれ
ひきもどす	ひきもどし
填める	填め
つっ伏す	つっ伏し
ためす	ためし
広がる	広がっ
油染みる	油染み
まどわす	まどわし
まとわりつく	まとわりつい
聞き付ける	聞き付け
さかのぼれる	さかのぼれ
手づまる	手づまっ
立ち向かう	立ち向かっ
ふりそそぐ	ふりそそい
いいよどむ	いいよどん
へしゃげる	へしゃげ
かきぬく	かきぬい
愛せる	愛せ
焦れる	焦れ
浸す	浸し
嘲る	嘲っ
かっきる	かっきっ
謝れる	謝れ
取り留める	取り留め
きざみこむ	きざみこん
縫い込める	縫い込め
因る	因っ
おちゃらかす	おちゃらかし
付け出す	付け出し
ならべたてる	ならべたて
みてとれる	みてとれ
膨らす	膨らし
のりうつる	のりうつっ
言いすてる	言いすて
はたく	はたい
あてつける	あてつけ
手懐ける	手懐け
きこなす	きこなし
流し込む	流し込ん
くさむす	くさむし
買い上がる	買い上がっ
重なり合う	重なり合っ
ぬぐいとる	ぬぐいとっ
娶せる	娶せ
しんずる	娶せ
うとんずる	娶せ
歯向かう	歯向かっ
撓う	撓っ
立ち会う	立ち会っ
とりあえる	とりあえ
抜合せる	抜合せ
替われる	替われ
撃ち抜く	撃ち抜い
緩める	緩め
産まれる	産まれ
さっ引く	さっ引い
めんくらう	めんくらっ
剃り落とす	剃り落とし
飛出る	飛出
うりとばせる	うりとばせ
色付く	色付い
むしばむ	むしばん
へんずる	むしばん
みおろす	みおろし
おもう	おもっ
戻れる	戻れ
塗り立てる	塗り立て
続く	続い
脱がす	脱がし
差しあげる	差しあげ
志ざす	志ざし
組み合わせる	組み合わせ
跳ね上がる	跳ね上がっ
取り巻く	取り巻い
捩じ向ける	捩じ向け
高ぶる	高ぶっ
しらむ	しらん
書き捨てる	書き捨て
列べる	列べ
きそえる	きそえ
問い合わす	問い合わし
つづく	つづい
攀じる	攀じ
ぬすみだせる	ぬすみだせ
つぶす	つぶし
追っかける	追っかけ
咳込む	咳込ん
聞きかえす	聞きかえし
とかせる	とかせ
あらう	あらっ
みつげる	みつげ
すりこめる	すりこめ
かたりあかす	かたりあかし
取りあう	取りあっ
とりおこなう	とりおこなっ
押せる	押せ
絡み付く	絡み付い
取返す	取返し
すじばる	すじばっ
ならべる	ならべ
飾りたてる	飾りたて
あゆみよれる	あゆみよれ
熱す	熱し
かねる	かね
たちまわる	たちまわっ
アジる	アジっ
さびれる	さびれ
ころがせる	ころがせ
さび付く	さび付い
かき暗す	かき暗し
さわぐ	さわい
たたきこめる	たたきこめ
とどろかせる	とどろかせ
引きずりこむ	引きずりこん
差し挟む	差し挟ん
知ろしめす	知ろしめし
てむかえる	てむかえ
じまう	じまっ
投付ける	投付け
呑み込む	呑み込ん
ぶる	ぶっ
わりびける	わりびけ
ホレる	ホレ
ねこむ	ねこん
さしおさえる	さしおさえ
なおる	なおっ
跳ね返る	跳ね返っ
もちくずす	もちくずし
連なる	連なっ
見れる	見れ
干る	干
さしとおす	さしとおし
たむろする	さしとおし
みうしなう	みうしなっ
戴ける	戴け
言いこめる	言いこめ
みなす	みなし
おきる	おき
かたちづくる	かたちづくっ
茹だる	茹だっ
すわり込める	すわり込め
眠る	眠っ
はき違える	はき違え
乗取る	乗取っ
とだえる	とだえ
面す	面し
ささげる	ささげ
まかれる	まかれ
わたす	わたし
傾げる	傾げ
耐忍ぶ	耐忍ん
おちあう	おちあっ
ふりたてる	ふりたて
ふくする	ふりたて
超える	超え
立ち代わる	立ち代わっ
見そこなう	見そこなっ
かもしだす	かもしだし
切りさいなむ	切りさいなん
波打つ	波打っ
とりかかる	とりかかっ
寂びる	寂び
戯れる	戯れ
引き替える	引き替え
うわる	うわっ
着る	着
あたる	あたっ
もちこむ	もちこん
事寄せる	事寄せ
おどろかす	おどろかし
綾なす	綾なし
はいでる	はいで
かいきる	かいきっ
附する	かいきっ
でむく	でむい
掻き暮れる	掻き暮れ
ふくれる	ふくれ
せき込む	せき込ん
つづる	つづっ
シラケる	シラケ
待ち合せる	待ち合せ
さらけ出す	さらけ出し
かかえこむ	かかえこん
上がり込む	上がり込ん
水際立つ	水際立っ
ぬけでる	ぬけで
確かめる	確かめ
裁つ	裁っ
しみいる	しみいっ
立ち止まる	立ち止まっ
いいわたせる	いいわたせ
思い当る	思い当っ
強請る	強請っ
しもがれる	しもがれ
提げる	提げ
連れ出せる	連れ出せ
刷る	刷っ
つっ放す	つっ放し
減す	減し
すぐれる	すぐれ
晴れる	晴れ
あおむける	あおむけ
もてあます	もてあまし
吹く	吹い
わたせる	わたせ
聞付ける	聞付け
聞き損なう	聞き損なっ
はなじろむ	はなじろん
恥じらう	恥じらっ
くいちらす	くいちらし
見付かる	見付かっ
擢んでる	擢んで
恐れる	恐れ
ちかう	ちかっ
あけはなつ	あけはなっ
もうしあわせる	もうしあわせ
下ろせる	下ろせ
言いつくす	言いつくし
祈ぐ	祈い
据わる	据わっ
あわだつ	あわだっ
なじめる	なじめ
寒気立つ	寒気立っ
ぶちあてる	ぶちあて
買い切る	買い切っ
干せる	干せ
兼ね合う	兼ね合っ
ですぎる	ですぎ
凭せかける	凭せかけ
取殺す	取殺し
立どまる	立どまっ
もぐりこむ	もぐりこん
投げ棄てる	投げ棄て
挟み込める	挟み込め
思いだす	思いだし
めざめる	めざめ
にがみばしる	にがみばしっ
よぶ	よん
むきだす	むきだし
のれる	のれ
住みつく	住みつい
いろめく	いろめい
くれる	くれ
請け出す	請け出し
逸れる	逸れ
かくす	かくし
ひきさげる	ひきさげ
ウケる	ウケ
えらべる	えらべ
引合せる	引合せ
笑いかける	笑いかけ
篩う	篩っ
ほぐす	ほぐし
拗ける	拗け
下げ渋る	下げ渋っ
織込む	織込ん
転げ落ちる	転げ落ち
過ぎ去る	過ぎ去っ
有り合わせる	有り合わせ
ぞんじる	ぞんじ
討てる	討て
いいよる	いいよっ
まつ	まっ
売払う	売払っ
からませる	からませ
買い受ける	買い受け
憐れむ	憐れん
おくりこむ	おくりこん
触れ回る	触れ回っ
煉れる	煉れ
晴れわたる	晴れわたっ
きえる	きえ
召出す	召出し
ひん曲がる	ひん曲がっ
くもる	くもっ
へだたる	へだたっ
まぎらわす	まぎらわし
付添う	付添っ
えぐれる	えぐれ
打ち合す	打ち合し
組みなおせる	組みなおせ
うたぐる	うたぐっ
たばかる	たばかっ
妬く	妬い
借り集める	借り集め
くいしばる	くいしばっ
言い寄れる	言い寄れ
嬲る	嬲っ
裏返る	裏返っ
染み付く	染み付い
切り組む	切り組ん
おいはらう	おいはらっ
はいあがる	はいあがっ
になう	になっ
防げる	防げ
砕ける	砕け
ふりだす	ふりだし
うちはたせる	うちはたせ
取り出せる	取り出せ
こまる	こまっ
連だつ	連だっ
修する	連だっ
組み替える	組み替え
すじる	すじっ
呼入れる	呼入れ
つきもどせる	つきもどせ
書き立てる	書き立て
曰う	曰っ
付足す	付足し
あわせる	あわせ
立すくむ	立すくん
釣りあげる	釣りあげ
つけ回す	つけ回し
書き残す	書き残し
追い捲る	追い捲っ
鋤き返す	鋤き返し
思い立つ	思い立っ
締め殺す	締め殺し
ほったらかす	ほったらかし
映じる	映じ
ふるふ	ふるひ
触れる	触れ
退く	退い
といただす	といただし
訣れる	訣れ
さしこむ	さしこん
死に変る	死に変っ
抗する	死に変っ
転ばす	転ばし
申し出でる	申し出で
生やす	生やし
こころみる	こころみ
かいかえる	かいかえ
搦める	搦め
ついやせる	ついやせ
おちつける	おちつけ
忘れかける	忘れかけ
けずりとる	けずりとっ
よっぱらえる	よっぱらえ
引ずる	引ずっ
免ずる	引ずっ
暈す	暈し
申し聞ける	申し聞け
詣でる	詣で
くゆらせる	くゆらせ
取外す	取外し
混ぜ返せる	混ぜ返せ
結べる	結べ
突っ込める	突っ込め
贈れる	贈れ
どうずる	贈れ
みたせる	みたせ
討つ	討っ
振り放つ	振り放っ
ざれる	ざれ
吹き鳴らす	吹き鳴らし
すぎさる	すぎさっ
とりはこぶ	とりはこん
刈りとる	刈りとっ
示しあわせる	示しあわせ
弾む	弾ん
つれこめる	つれこめ
押し入れる	押し入れ
割り当てる	割り当て
ねじ曲げる	ねじ曲げ
さからう	さからっ
乗り込む	乗り込ん
みこめる	みこめ
乗移る	乗移っ
屈まる	屈まっ
肥れる	肥れ
よそう	よそっ
むつかる	むつかっ
見縊る	見縊っ
置換える	置換え
躍りかかる	躍りかかっ
捗る	捗っ
弔する	捗っ
とびのく	とびのい
たちよる	たちよっ
呼べる	呼べ
つれだせる	つれだせ
流る	流
ぬかづく	ぬかづい
つきさす	つきさし
ひがむ	ひがん
冷えこむ	冷えこん
通り掛かる	通り掛かっ
とっくむ	とっくん
おしとおす	おしとおし
抱き取る	抱き取っ
みかえす	みかえし
亡びる	亡び
空く	空い
軋めく	軋めい
呼ばわる	呼ばわっ
つぐむ	つぐん
突き合わせる	突き合わせ
あわす	あわし
講ずる	あわし
知り合える	知り合え
つきる	つき
振立てる	振立て
織り上げる	織り上げ
聞し召す	聞し召し
なれる	なれ
せばめる	せばめ
苛立てる	苛立て
こりる	こり
縒れる	縒れ
ぬいつける	ぬいつけ
へあがる	へあがっ
引き篭る	引き篭っ
くびれる	くびれ
揺り動かせる	揺り動かせ
畏まる	畏まっ
誘い合う	誘い合っ
言い立てる	言い立て
こごる	こごっ
角目立つ	角目立っ
あゆみよる	あゆみよっ
吹ける	吹け
役立つ	役立っ
もうしあげる	もうしあげ
訪れる	訪れ
入れ替われる	入れ替われ
塾す	塾し
ひきつる	ひきつっ
そそぎこむ	そそぎこん
憩う	憩っ
迷う	迷う
よばわる	よばわっ
はべれる	はべれ
滴らす	滴らし
乗遅れる	乗遅れ
割り込める	割り込め
入かわる	入かわっ
せびる	せびっ
取紛れる	取紛れ
見破れる	見破れ
とびのれる	とびのれ
立ち並ぶ	立ち並ん
醒す	醒し
つづける	つづけ
閉じ篭る	閉じ篭っ
めげる	めげ
吹き込める	吹き込め
向けなおす	向けなおし
踏みはずす	踏みはずし
しめしあわせる	しめしあわせ
ねむれる	ねむれ
ぬける	ぬけ
打ち連れる	打ち連れ
かくれる	かくれ
組織立つ	組織立っ
見せつける	見せつけ
取りざたす	取りざたし
ひむ	ひん
読み込める	読み込め
すきとおる	すきとおっ
おめにかかる	おめにかかっ
介する	おめにかかっ
競り勝つ	競り勝っ
震う	震っ
聞き齧る	聞き齧っ
苦り切る	苦り切っ
はる	はっ
住まわす	住まわし
申越す	申越し
きらめかす	きらめかし
昇れる	昇れ
つまみ出せる	つまみ出せ
抛る	抛っ
塞ぎ込む	塞ぎ込ん
あなどる	あなどっ
組みあげる	組みあげ
度重なる	度重なっ
とりしらべる	とりしらべ
弁じる	弁じ
くるまる	くるまっ
きまる	きまっ
しょげる	しょげ
差し引く	差し引い
立ちこむ	立ちこん
もぎとる	もぎとっ
落魄れる	落魄れ
助け出す	助け出し
しゅうする	助け出し
はせあつまる	はせあつまっ
おいそだつ	おいそだっ
しらせる	しらせ
見つけ出せる	見つけ出せ
折りかえす	折りかえし
聞き返せる	聞き返せ
反する	聞き返せ
殺める	殺め
うちつける	うちつけ
齧る	齧っ
物思う	物思っ
あわてる	あわて
逆立つ	逆立っ
断ち割る	断ち割っ
かめる	かめ
ようだいぶる	ようだいぶっ
威す	威し
ふるえる	ふるえ
絞れる	絞れ
汲む	汲ん
引っ掛かる	引っ掛かっ
断つ	断っ
起こす	起こし
ぎょうずる	起こし
もうしつたえる	もうしつたえ
見受ける	見受け
はんずる	見受け
紛らせる	紛らせ
ひっ担ぐ	ひっ担い
数え上げる	数え上げ
印せる	印せ
勝ち抜く	勝ち抜い
いさむ	いさん
篭る	篭っ
ふきまくる	ふきまくっ
思いまどえる	思いまどえ
脱せる	脱せ
かみころす	かみころし
讃える	讃え
言い争う	言い争っ
ならえる	ならえ
有する	ならえ
ひとはなさかせる	ひとはなさかせ
測る	測っ
拐う	拐っ
破れる	破れ
呼付ける	呼付け
すっとぶ	すっとん
絡ませる	絡ませ
折込む	折込ん
もうかる	もうかっ
駆催す	駆催し
やりかえす	やりかえし
当て付ける	当て付け
余る	余っ
ふみきれる	ふみきれ
見なす	見なし
擦れ違う	擦れ違っ
流れ込む	流れ込ん
かりこす	かりこし
蹴る	蹴っ
うず巻く	うず巻い
よびもどせる	よびもどせ
ぶっつづける	ぶっつづけ
ふくむ	ふくん
まぎれ込む	まぎれ込ん
生き抜ける	生き抜け
受合う	受合っ
繰延べる	繰延べ
さ迷う	さ迷う
つけ上がる	つけ上がっ
引しまる	引しまっ
さしあう	さしあっ
受取る	受取っ
引き具する	受取っ
せっぱつまる	せっぱつまっ
かいたたく	かいたたい
揉み合う	揉み合っ
魂消る	魂消
取り運ぶ	取り運ん
すくい上げる	すくい上げ
せせらわらう	せせらわらっ
枉げる	枉げ
言いふくめる	言いふくめ
落ちぶれる	落ちぶれ
しはらえる	しはらえ
なであげる	なであげ
突き放せる	突き放せ
添える	添え
せせら笑える	せせら笑え
とってかえす	とってかえし
とむらえる	とむらえ
さとる	さとっ
篭もる	篭もっ
按じる	按じ
見晴らせる	見晴らせ
とどけでる	とどけで
くすぐる	くすぐっ
ほうずる	くすぐっ
興ずる	くすぐっ
浮びあがる	浮びあがっ
織りこむ	織りこん
出せる	出せ
いきわたる	いきわたっ
うごめかす	うごめかし
思いおこす	思いおこし
はらす	はらし
もぐり込める	もぐり込め
ごったがえす	ごったがえし
思いとどまれる	思いとどまれ
荒立つ	荒立っ
湯掻く	湯掻い
殺ぐ	殺い
煮つめる	煮つめ
ひしめく	ひしめい
吹き付ける	吹き付け
懐ける	懐け
なぶる	なぶっ
思い詰める	思い詰め
償う	償っ
加える	加え
ききはずす	ききはずし
道化ける	道化け
転べる	転べ
かっこむ	かっこん
躓く	躓い
立ち寄れる	立ち寄れ
結う	結っ
なく	ない
言いそこなう	言いそこなっ
よじ登れる	よじ登れ
滅する	よじ登れ
空ける	空け
脅し付ける	脅し付け
映える	映え
選べる	選べ
死なす	死なし
告げる	告げ
あやまつ	あやまっ
きょうざめる	きょうざめ
誘い込む	誘い込ん
もちあるける	もちあるけ
痛める	痛め
推移る	推移っ
売り出す	売り出し
きくする	売り出し
ひきあてる	ひきあて
打解ける	打解け
言い直せる	言い直せ
退かす	退かし
気遣う	気遣っ
づける	づけ
取っちめる	取っちめ
デモる	デモっ
跳び越す	跳び越し
甦る	甦っ
かわる	かわっ
差固める	差固め
矧ぐ	矧い
まじめくさる	まじめくさっ
踏み倒す	踏み倒し
ひきはなす	ひきはなし
さかす	さかし
逆だつ	逆だっ
はばめる	はばめ
切詰める	切詰め
たぐえる	たぐえ
射貫く	射貫い
けちる	けちっ
嘲笑う	嘲笑っ
ひさぐ	ひさい
あそびあるく	あそびあるい
もうしこめる	もうしこめ
払戻す	払戻し
逃げ出す	逃げ出し
ふてる	ふて
ひねれる	ひねれ
勢い付く	勢い付い
ぬれそぼつ	ぬれそぼっ
指せる	指せ
あじわえる	あじわえ
流す	流し
つぼむ	つぼん
わたくしする	つぼん
いただく	いただい
打ち直す	打ち直し
やぶる	やぶっ
かきあつめる	かきあつめ
おびる	おび
取り落とす	取り落とし
もうしおくる	もうしおくっ
畳む	畳ん
よす	よし
やむを得る	やむを得
なまる	なまっ
語り明かす	語り明かし
飛び渡る	飛び渡っ
問い詰める	問い詰め
取っつく	取っつい
揺がす	揺がし
さきんじる	さきんじ
取越す	取越し
似かよう	似かよっ
見捨てる	見捨て
封ずる	見捨て
せき止める	せき止め
眠らす	眠らし
取りつかれる	取りつかれ
蕩かす	蕩かし
上がれる	上がれ
読みあさる	読みあさっ
こわがる	こわがっ
刷り込める	刷り込め
怒鳴りつける	怒鳴りつけ
申込む	申込ん
さえる	さえ
くろみがかる	くろみがかっ
垢抜ける	垢抜け
派する	垢抜け
ちちくる	ちちくっ
生らす	生らし
ものおもう	ものおもっ
読上げる	読上げ
潜まる	潜まっ
抛り出す	抛り出し
ずれ込む	ずれ込ん
驚かす	驚かし
羽織る	羽織っ
にあがる	にあがっ
角立てる	角立て
窶す	窶し
呈する	窶し
きる	きっ
差し固める	差し固め
知れる	知れ
乗りこなす	乗りこなし
聞き流せる	聞き流せ
みつくろう	みつくろっ
とりかこめる	とりかこめ
ほねばる	ほねばっ
入替る	入替っ
いただける	いただけ
たわける	たわけ
よみだす	よみだし
かんがえなおす	かんがえなおし
取り仕切れる	取り仕切れ
送り届ける	送り届け
引っくり返す	引っくり返し
見廻す	見廻し
聞き外す	聞き外し
飲み込む	飲み込ん
しらべる	しらべ
みならう	みならっ
であう	であっ
奪い返す	奪い返し
はう	はっ
取り拉ぐ	取り拉い
見届ける	見届け
ころがす	ころがし
しめだす	しめだし
たたみかける	たたみかけ
さげる	さげ
売りこむ	売りこん
流し入れる	流し入れ
包み隠す	包み隠し
救い出せる	救い出せ
あく	あい
湛える	湛え
招き入れる	招き入れ
より分ける	より分け
化す	化し
釣りあがる	釣りあがっ
抗える	抗え
切り付ける	切り付け
のりこえる	のりこえ
いれかえる	いれかえ
よびこめる	よびこめ
間引く	間引い
こきつかえる	こきつかえ
利する	こきつかえ
活ける	活け
下卑る	下卑
進み出せる	進み出せ
組み込む	組み込ん
突き付ける	突き付け
ねりあるく	ねりあるい
応ずる	ねりあるい
まぜかえす	まぜかえし
書立てる	書立て
はしりこめる	はしりこめ
乗り入れる	乗り入れ
引き継ぐ	引き継い
あいいとなむ	あいいとなん
おれ合う	おれ合っ
吹き飛ばす	吹き飛ばし
憬れる	憬れ
見下げる	見下げ
採る	採っ
和ぐ	和い
さびる	さび
やつれる	やつれ
穿く	穿い
おちる	おち
耀く	耀い
寄あつまる	寄あつまっ
至る	至っ
かよえる	かよえ
あかみがかる	あかみがかっ
たがねる	たがね
書き成す	書き成し
突戻す	突戻し
つくれる	つくれ
擦り寄る	擦り寄っ
競上げる	競上げ
起き直る	起き直っ
すごもる	すごもっ
うちよせる	うちよせ
留る	留っ
つきぬく	つきぬい
いそしむ	いそしん
入乱れる	入乱れ
扇ぐ	扇い
清ます	清まし
放つ	放っ
ごった返す	ごった返し
削ぐ	削い
磨る	磨っ
押えつける	押えつけ
考え抜く	考え抜い
戴く	戴い
いたぶる	いたぶっ
わする	いたぶっ
つきそえる	つきそえ
切りとれる	切りとれ
睡る	睡っ
働ける	働け
すえつける	すえつけ
取りとめる	取りとめ
ふす	ふし
閉じこめる	閉じこめ
おっかぶせる	おっかぶせ
見せびらかす	見せびらかし
うかばれる	うかばれ
よびかける	よびかけ
もちだせる	もちだせ
抱き合える	抱き合え
勝ち進める	勝ち進め
うきあがれる	うきあがれ
うむ	うん
番える	番え
とつぐ	とつい
誘いかける	誘いかけ
言い争える	言い争え
まかなえる	まかなえ
突っ立てる	突っ立て
しゃれる	しゃれ
取澄ます	取澄まし
うかれ出る	うかれ出
粘つく	粘つい
思い余る	思い余っ
押付ける	押付け
削る	削っ
直す	直し
うちあう	うちあっ
つっぷす	つっぷし
繰り下げる	繰り下げ
つきすすむ	つきすすん
踏みつぶす	踏みつぶし
見送れる	見送れ
裁ち切る	裁ち切っ
生き残れる	生き残れ
憧れる	憧れ
すり減る	すり減っ
割り引く	割り引い
ぬたくる	ぬたくっ
よじれる	よじれ
すげかえる	すげかえ
強ばる	強ばっ
やりすごす	やりすごし
起てる	起て
痩せさらばえる	痩せさらばえ
押し返す	押し返し
言いあう	言いあっ
あったまる	あったまっ
のりつける	のりつけ
持運ぶ	持運ん
広げる	広げ
崩れ落ちる	崩れ落ち
ほうける	ほうけ
ひなびる	ひなび
固まれる	固まれ
還す	還し
とりなおせる	とりなおせ
飲みまわす	飲みまわし
しかる	しかっ
うごく	うごい
下す	下し
肥やす	肥やし
さしかえる	さしかえ
まちうける	まちうけ
おいこむ	おいこん
青ざめる	青ざめ
踏み外す	踏み外し
まかりこす	まかりこし
取り片付ける	取り片付け
たちかわる	たちかわっ
書き取る	書き取っ
かきあらわす	かきあらわし
引き締める	引き締め
入り雑じる	入り雑じっ
くみあう	くみあっ
浮き立つ	浮き立っ
こもる	こもっ
おりなす	おりなし
しにかける	しにかけ
さんずる	しにかけ
相営む	相営ん
招ずる	相営ん
つりこむ	つりこん
いきのこる	いきのこっ
いかる	いかっ
ふくらせる	ふくらせ
かみ殺す	かみ殺し
任す	任し
制す	制し
取りかえる	取りかえ
差し込む	差し込ん
にげこむ	にげこん
行える	行え
さ迷う	さ迷っ
おいぬける	おいぬけ
しなびる	しなび
掲げる	掲げ
充ちる	充ち
みつかる	みつかっ
もつれ合う	もつれ合っ
携わる	携わっ
狩出す	狩出し
ひっくりかえす	ひっくりかえし
注ぐ	注い
くり貫く	くり貫い
おがむ	おがん
吊る	吊っ
方向づける	方向づけ
回せる	回せ
撃ち落とす	撃ち落とし
降り注ぐ	降り注い
駆り出す	駆り出し
掴みかかる	掴みかかっ
願う	願っ
煮上がる	煮上がっ
立込める	立込め
つっ込む	つっ込ん
誉めちぎる	誉めちぎっ
うつせる	うつせ
狙える	狙え
したまわる	したまわっ
うちおとす	うちおとし
生まれでる	生まれで
くじけかかる	くじけかかっ
かいしめる	かいしめ
とりまける	とりまけ
懸け隔たる	懸け隔たっ
よみこむ	よみこん
引出す	引出し
むすびつく	むすびつい
観る	観
演じる	演じ
揃える	揃え
消えはてる	消えはて
すきおこす	すきおこし
揺り起こす	揺り起こし
後らせる	後らせ
謙る	謙っ
とりおこなえる	とりおこなえ
取り逃がす	取り逃がし
おりゃる	おりゃっ
住み着く	住み着い
縮くれる	縮くれ
そりくりかえる	そりくりかえっ
転ぶ	転ん
きりぬける	きりぬけ
のみあかす	のみあかし
かぎつける	かぎつけ
しゃうぞく	しゃうぞい
逸らす	逸らし
まきかえせる	まきかえせ
巻ける	巻け
繰り替える	繰り替え
踏みこたえる	踏みこたえ
うる	うっ
ふせぐ	ふせい
叫ぶ	叫ん
立ち去れる	立ち去れ
白む	白ん
持ち出す	持ち出し
剥ぐ	剥い
励む	励ん
研げる	研げ
剥がれる	剥がれ
のりつげる	のりつげ
つきまとう	つきまとっ
被さる	被さっ
かけもつ	かけもっ
やどれる	やどれ
しらす	しらし
吹っ切れる	吹っ切れ
とりしまれる	とりしまれ
合さる	合さっ
まつわりつく	まつわりつい
つかみ合う	つかみ合っ
圧す	圧し
振り捨てる	振り捨て
はぎとる	はぎとっ
傷む	傷ん
微睡む	微睡ん
はりだす	はりだし
撃ち込める	撃ち込め
打払える	打払え
組込める	組込め
突き進む	突き進ん
連合う	連合っ
またぐ	またい
燐む	燐ん
緩む	緩ん
付合う	付合っ
踏倒す	踏倒し
見越す	見越し
寄り倒す	寄り倒し
はしょる	はしょっ
いれかわる	いれかわっ
がたつく	がたつい
みそめる	みそめ
おわらせる	おわらせ
つかいこなせる	つかいこなせ
数えあげる	数えあげ
もとまる	もとまっ
垂らす	垂らし
笑える	笑え
おれる	おれ
葬れる	葬れ
躄る	躄っ
無くなす	無くなし
吹き降ろす	吹き降ろし
折り合える	折り合え
無くす	無くし
もちあげる	もちあげ
沈む	沈ん
ぬけかわる	ぬけかわっ
たしなめる	たしなめ
張り出す	張り出し
立添う	立添っ
除ける	除け
掬う	掬っ
揺らせる	揺らせ
立ち代われる	立ち代われ
あきれ返る	あきれ返っ
とまどう	とまどう
聞きはずす	聞きはずし
天翔る	天翔っ
生み落す	生み落し
からす	からし
取り澄ます	取り澄まし
つきささる	つきささっ
案ずる	つきささっ
言い伝える	言い伝え
誘き出す	誘き出し
熾る	熾っ
腫れ上がる	腫れ上がっ
よみさす	よみさし
いだく	いだい
すます	すまし
なげきあかす	なげきあかし
くさす	くさし
ふやかす	ふやかし
暴れだす	暴れだし
負かす	負かし
あいする	負かし
ねむりこむ	ねむりこん
引き返せる	引き返せ
とおりかかる	とおりかかっ
伏せる	伏せっ
学びとる	学びとっ
爆ぜる	爆ぜ
うまれつく	うまれつい
出会える	出会え
聞きすます	聞きすまし
流れ出る	流れ出
淫する	流れ出
食らう	食らっ
引く	引い
吊り出す	吊り出し
まわる	まわっ
苦みばしる	苦みばしっ
込み上げる	込み上げ
じれ込む	じれ込ん
懸ける	懸け
書き起す	書き起し
さえかえる	さえかえっ
見識張る	見識張っ
ねかしつける	ねかしつけ
あがれる	あがれ
まぎれこむ	まぎれこん
すくめる	すくめ
おきなおれる	おきなおれ
摩れる	摩れ
見抜く	見抜い
入雑じる	入雑じっ
よわる	よわっ
ひる	ひっ
出しゃばる	出しゃばっ
おぼれる	おぼれ
おりたためる	おりたため
究める	究め
陣どる	陣どっ
投げ込める	投げ込め
受けとる	受けとっ
喪う	喪っ
振り絞る	振り絞っ
さきがける	さきがけ
締め括る	締め括っ
そらせる	そらせ
味付ける	味付け
咲こぼれる	咲こぼれ
遅らす	遅らし
ときあかす	ときあかし
とっくめる	とっくめ
黙する	とっくめ
もむ	もん
ほじくる	ほじくっ
ひもとける	ひもとけ
打ちあぐむ	打ちあぐん
想える	想え
脱ぐ	脱い
諮れる	諮れ
けずれる	けずれ
謀れる	謀れ
おす	おし
上れる	上れ
目ざめる	目ざめ
はしりまわれる	はしりまわれ
やすめる	やすめ
攻めのぼる	攻めのぼっ
荒む	荒ん
はなしかける	はなしかけ
はたす	はたし
まする	はたし
憶える	憶え
割切れる	割切れ
こなせる	こなせ
太る	太っ
まみれる	まみれ
積込む	積込ん
居座る	居座っ
ききいる	ききいっ
躍りでる	躍りで
過つ	過っ
とる	とっ
みかえせる	みかえせ
のけ反る	のけ反っ
揺さぶれる	揺さぶれ
おしのける	おしのけ
値切れる	値切れ
縊れる	縊れ
はいれる	はいれ
思いきる	思いきっ
聰る	聰っ
ほころぶ	ほころん
口篭る	口篭っ
遇う	遇っ
酬いる	酬い
冬篭る	冬篭っ
ふみきる	ふみきっ
かき消せる	かき消せ
なげとばす	なげとばし
死に遅れる	死に遅れ
近付く	近付い
なきしずむ	なきしずん
仕留める	仕留め
醂す	醂し
たおせる	たおせ
はえる	はえ
いりかわる	いりかわっ
見回る	見回っ
差戻す	差戻し
腹だつ	腹だっ
厭き厭きする	腹だっ
縛りあげる	縛りあげ
買取る	買取っ
またたく	またたい
立ち竦む	立ち竦ん
足る	足っ
温もる	温もっ
惹ける	惹け
立掛ける	立掛け
譲り渡す	譲り渡し
ひろまる	ひろまっ
焦る	焦っ
ひっさげる	ひっさげ
死かわる	死かわっ
まざる	まざっ
透ける	透け
追込む	追込ん
ほりこむ	ほりこん
ばかす	ばかし
さがる	さがっ
まもりそだてる	まもりそだて
移り変る	移り変っ
混ぜ合わす	混ぜ合わし
はね上げる	はね上げ
かがる	かがっ
潤びる	潤び
押し負ける	押し負け
突ぱる	突ぱっ
よびこむ	よびこん
かろんずる	よびこん
搾れる	搾れ
こげつく	こげつい
おもんずる	こげつい
ささめく	ささめい
突き通る	突き通っ
請けおう	請けおっ
打しおれる	打しおれ
解する	打しおれ
植える	植え
なみだつ	なみだっ
取り広げる	取り広げ
はからえる	はからえ
腫れる	腫れ
飛交う	飛交っ
高める	高め
つまずく	つまずい
がぶる	がぶっ
捲し立てる	捲し立て
のこれる	のこれ
駆け付ける	駆け付け
引き寄せる	引き寄せ
写る	写っ
解合う	解合っ
たちおくれる	たちおくれ
くずおれる	くずおれ
立会う	立会っ
思ふ	思ひ
つる	つっ
当込む	当込ん
なぐりつける	なぐりつけ
とりつぐ	とりつい
きらう	きらっ
耕せる	耕せ
散じる	散じ
けしとぶ	けしとん
こびる	こび
取り囲む	取り囲ん
一皮剥く	一皮剥い
馳せ参ずる	一皮剥い
むらがる	むらがっ
刳る	刳っ
かきとめる	かきとめ
出っ張る	出っ張っ
ひきつれる	ひきつれ
しんぜる	しんぜ
もえる	もえ
やつす	やつし
知り合う	知り合っ
鍛え上げる	鍛え上げ
持て余す	持て余し
差し違える	差し違え
おりまぜる	おりまぜ
のべる	のべ
わきまえる	わきまえ
封じる	封じ
覚める	覚め
殉ずる	覚め
思い付く	思い付い
努まる	努まっ
陳ぶ	陳ん
がかる	がかっ
たかれる	たかれ
やりこなす	やりこなし
ふざける	ふざけ
売り悩む	売り悩ん
向かい合わせる	向かい合わせ
佇つ	佇っ
よりそう	よりそっ
曇らす	曇らし
弔う	弔っ
生かせる	生かせ
撚る	撚っ
なきつく	なきつい
わる	わっ
入れる	入れ
行き着く	行き着い
盛り上がる	盛り上がっ
締まる	締まっ
はしりでる	はしりで
なえる	なえ
亡ぶ	亡ん
燻る	燻っ
すすりなく	すすりない
ひきのばす	ひきのばし
にごす	にごし
くりこす	くりこし
狭まる	狭まっ
取り捌く	取り捌い
娶る	娶っ
急かす	急かし
ながらえる	ながらえ
転がりこむ	転がりこん
おもひよる	おもひよっ
振切る	振切っ
羽ばたく	羽ばたい
請負う	請負っ
落行く	落行き
そろう	そろっ
揺れる	揺れ
だまりこむ	だまりこん
とりすます	とりすまし
おしだまる	おしだまっ
なみうつ	なみうっ
ずる	ずっ
詰まる	詰まっ
合わす	合わし
ききこむ	ききこん
折る	折っ
正せる	正せ
すり替える	すり替え
連出す	連出し
つけくわわる	つけくわわっ
かきなおせる	かきなおせ
小突き回す	小突き回し
荒らす	荒らし
とりこわす	とりこわし
きわめる	きわめ
待つ	待っ
巧む	巧ん
さんする	巧ん
くみ取れる	くみ取れ
おもいだせる	おもいだせ
ふきならす	ふきならし
ごする	ふきならし
心行く	心行き
食み出す	食み出し
支う	支っ
溜め込む	溜め込ん
ことわれる	ことわれ
とびはねる	とびはね
繰り込める	繰り込め
ふきはらえる	ふきはらえ
殉じる	殉じ
注ぎ込む	注ぎ込ん
沿う	沿っ
泊まり込む	泊まり込ん
炊きあがる	炊きあがっ
すすける	すすけ
飛離れる	飛離れ
ひねり回す	ひねり回し
取分ける	取分け
流せる	流せ
光らす	光らし
すがれる	すがれ
折返す	折返し
へこむ	へこん
漱ぐ	漱い
借りる	借り
問い合わせる	問い合わせ
みせる	みせ
呼出す	呼出し
数える	数え
着飾る	着飾っ
出来上がる	出来上がっ
いたる	いたっ
召す	召し
先んずる	召し
こらしめる	こらしめ
腐れる	腐れ
受けいれる	受けいれ
切り抜ける	切り抜け
巡らせる	巡らせ
ずらす	ずらし
爪立つ	爪立っ
売急ぐ	売急い
翻す	翻し
くちばしる	くちばしっ
捻くれる	捻くれ
錆付く	錆付い
しょうじる	しょうじ
まいる	まいっ
歪める	歪め
突き合す	突き合し
羽ばたける	羽ばたけ
ひす	ひし
引下げる	引下げ
かんさびる	かんさび
削り倒す	削り倒し
備え付ける	備え付け
操る	操っ
よれる	よれ
ねばりぬく	ねばりぬい
いいだせる	いいだせ
さげわたす	さげわたし
叩き起す	叩き起し
きりかわる	きりかわっ
諭せる	諭せ
きける	きけ
打砕く	打砕い
売り込む	売り込ん
ひやかせる	ひやかせ
捩じ伏せる	捩じ伏せ
おしながす	おしながし
使う	使っ
みすてる	みすて
嚼む	嚼ん
フケる	フケ
積出す	積出し
めっする	積出し
言い放つ	言い放っ
殺気立つ	殺気立っ
せきたてる	せきたて
みとおせる	みとおせ
渡れる	渡れ
見かねる	見かね
出回る	出回っ
啜る	啜っ
心ゆく	心ゆき
引連れる	引連れ
よりそえる	よりそえ
じゅくする	よりそえ
酔い潰れる	酔い潰れ
剃る	剃っ
ではじめる	ではじめ
せめたてる	せめたて
ゆき交う	ゆき交っ
かちすすむ	かちすすん
くいこむ	くいこん
じめつく	じめつい
ふんまえる	ふんまえ
しそんじる	しそんじ
撃ち殺す	撃ち殺し
綰ねる	綰ね
医する	綰ね
噛み付く	噛み付い
間切る	間切っ
しまふ	しまひ
送り込める	送り込め
だんじこむ	だんじこん
みちびきだす	みちびきだし
造れる	造れ
打ちとける	打ちとけ
行く	行き
のたうつ	のたうっ
つま弾く	つま弾い
存じ上げる	存じ上げ
汲み出す	汲み出し
抱締める	抱締め
罪する	抱締め
勝ち取る	勝ち取っ
撮す	撮し
濡れそぼつ	濡れそぼっ
くるしめる	くるしめ
泣かす	泣かし
売り切れる	売り切れ
食い倒す	食い倒し
踏みだす	踏みだし
きれあがる	きれあがっ
咬む	咬ん
飾る	飾っ
へばりつく	へばりつい
すねる	すね
座する	すね
あおみがかる	あおみがかっ
引き落とす	引き落とし
はなしこむ	はなしこん
ふりかける	ふりかけ
申出る	申出
漏れる	漏れ
つきあたる	つきあたっ
ふりかえる	ふりかえっ
とっつく	とっつい
むすびつける	むすびつけ
かたどれる	かたどれ
萎む	萎ん
耀かす	耀かし
刺殺す	刺殺し
よう	よっ
たたき出せる	たたき出せ
接する	たたき出せ
放す	放し
掴み掛る	掴み掛っ
遊びあきる	遊びあき
すべり込む	すべり込ん
追いまわす	追いまわし
挑む	挑ん
押し入る	押し入っ
のぼせる	のぼせ
ざわめく	ざわめい
いりつける	いりつけ
質せる	質せ
たえしのぶ	たえしのん
給する	たえしのん
擦付ける	擦付け
ひきつくろう	ひきつくろっ
そやす	そやし
引き延ばす	引き延ばし
付き添う	付き添っ
刺し違える	刺し違え
売り上げる	売り上げ
よだつ	よだっ
聞きだす	聞きだし
利く	利い
染み入る	染み入っ
うなずける	うなずけ
ぞんずる	うなずけ
よびおこす	よびおこし
はなせる	はなせ
冷える	冷え
読みくだす	読みくだし
盛り返す	盛り返し
わきたつ	わきたっ
溺らす	溺らし
やきあげる	やきあげ
振り落とせる	振り落とせ
まきつく	まきつい
ひっ返す	ひっ返し
引っぱる	引っぱっ
まちかまえる	まちかまえ
よこす	よこし
使われだす	使われだし
じゃれる	じゃれ
賞する	じゃれ
借り越す	借り越し
買いつける	買いつけ
はおる	はおっ
はしる	はしっ
焦げ付く	焦げ付い
借受ける	借受け
さしでる	さしで
さかまく	さかまい
きんじる	きんじ
はらせる	はらせ
生める	生め
つるし上げる	つるし上げ
口説ける	口説け
まねく	まねい
あやす	あやし
染る	染っ
かじりつく	かじりつい
煮える	煮え
持直す	持直し
かきちらす	かきちらし
慕う	慕っ
載る	載っ
頼みこむ	頼みこん
引っ篭る	引っ篭っ
更ける	更け
咳き込む	咳き込ん
押しかける	押しかけ
引っ剥がす	引っ剥がし
はずれる	はずれ
切り合う	切り合っ
あやぶむ	あやぶん
捉える	捉え
むすべる	むすべ
取り替える	取り替え
寝返る	寝返っ
そっする	寝返っ
乗込む	乗込ん
こころえる	こころえ
潰せる	潰せ
持越す	持越し
混ぜっ返す	混ぜっ返し
こいねがう	こいねがっ
ちゃかす	ちゃかし
焚きしめる	焚きしめ
打ち落とす	打ち落とし
け飛ばす	け飛ばし
まぜ返す	まぜ返し
よう	よう
ふりあう	ふりあっ
わらわす	わらわし
寄りつく	寄りつい
はじきだせる	はじきだせ
ひらめかす	ひらめかし
嗣げる	嗣げ
かきまぜる	かきまぜ
怖じける	怖じけ
うりだせる	うりだせ
擦り込む	擦り込ん
ゆきたつ	ゆきたっ
しかける	しかけ
うつしだせる	うつしだせ
押しきる	押しきっ
勿体ぶる	勿体ぶっ
ふる	ふっ
尽くす	尽くし
みてとる	みてとっ
まるめ込む	まるめ込ん
束ねる	束ね
ねがいさげる	ねがいさげ
もじる	もじっ
粒立つ	粒立っ
まよわす	まよわし
たがう	たがっ
集える	集え
寄り掛る	寄り掛っ
じとつく	じとつい
払える	払え
つきあわせる	つきあわせ
嫌う	嫌っ
奉る	奉っ
受けとめる	受けとめ
息詰まる	息詰まっ
紛う	紛っ
ゆきかえる	ゆきかえっ
うつしだす	うつしだし
したてる	したて
押しつめる	押しつめ
悲しむ	悲しん
あずかる	あずかっ
年寄る	年寄っ
かぶせる	かぶせ
むける	むけ
泣き伏す	泣き伏し
ちゃらつかす	ちゃらつかし
さぐり合う	さぐり合っ
絶する	さぐり合っ
縮かむ	縮かん
よばれる	よばれ
おどりでる	おどりで
うちとる	うちとっ
泣沈む	泣沈ん
おちつく	おちつい
すいだす	すいだし
貴べる	貴べ
心づく	心づい
握り締める	握り締め
負える	負え
はりめぐらせる	はりめぐらせ
刺す	刺し
作りあげる	作りあげ
訊く	訊い
ふさぐ	ふさい
脅し取る	脅し取っ
召し上がれる	召し上がれ
かたちづくれる	かたちづくれ
ためこめる	ためこめ
わすれる	わすれ
つくり上げる	つくり上げ
競い合う	競い合っ
こる	こっ
ききあわせる	ききあわせ
のぞき込める	のぞき込め
追っぱらう	追っぱらっ
受け合える	受け合え
ぎゅうじる	ぎゅうじっ
ふみはずす	ふみはずし
はたせる	はたせ
賺す	賺し
かきむしる	かきむしっ
踏出す	踏出し
つかれはてる	つかれはて
やり過す	やり過し
仕上がる	仕上がっ
取回す	取回し
ズレる	ズレ
面する	ズレ
言尽す	言尽し
割当てる	割当て
怒れる	怒れ
ときおこす	ときおこし
引立てる	引立て
競合う	競合っ
素見す	素見し
切り返す	切り返し
砕く	砕い
しめきる	しめきっ
息づく	息づい
囲える	囲え
引っ張る	引っ張っ
打ち壊す	打ち壊し
いう	いう
押し返せる	押し返せ
入り浸る	入り浸っ
いら立つ	いら立っ
襲いかかる	襲いかかっ
熾きる	熾き
くり出す	くり出し
きかざれる	きかざれ
かられる	かられ
呼ぶ	呼ん
書出す	書出し
くぐり抜ける	くぐり抜け
ざんする	くぐり抜け
そりおとす	そりおとし
しめつける	しめつけ
たんずる	しめつけ
好む	好ん
競べる	競べ
切り捨てる	切り捨て
ほりあげる	ほりあげ
のたうちまわる	のたうちまわっ
捕らわれる	捕らわれ
凍みる	凍み
こころゆく	こころゆき
つっきる	つっきっ
どやす	どやし
笑い転げる	笑い転げ
掛る	掛っ
住む	住ん
約まる	約まっ
あいしあう	あいしあっ
頑張れる	頑張れ
させる	させ
おかす	おかし
あます	あまし
泣き付く	泣き付い
あわれむ	あわれん
積み重ねる	積み重ね
うちあわす	うちあわし
訳せる	訳せ
詫びる	詫び
創り出せる	創り出せ
担げる	担げ
追い上げる	追い上げ
根づく	根づい
立ち会える	立ち会え
祭り上げる	祭り上げ
こもどす	こもどし
乗かかる	乗かかっ
創る	創っ
練直す	練直し
かがやく	かがやい
うちあわせる	うちあわせ
遜る	遜っ
かする	遜っ
戦く	戦い
腹立てる	腹立て
擦り込める	擦り込め
勝ち得る	勝ち得
みごもる	みごもっ
討ち果たせる	討ち果たせ
野次る	野次っ
よみがえる	よみがえっ
踏み抜く	踏み抜い
生かす	生かし
おいつめる	おいつめ
採れる	採れ
つきやぶる	つきやぶっ
めぐりあう	めぐりあっ
尽くせる	尽くせ
進む	進ん
赴く	赴い
くりいれる	くりいれ
しゃっちょこ張る	しゃっちょこ張っ
めしぐす	めしぐし
煮つまる	煮つまっ
渦巻く	渦巻い
動く	動い
くり抜く	くり抜い
試みる	試み
汚す	汚し
食い入る	食い入っ
反らせる	反らせ
晴らせる	晴らせ
取っ組める	取っ組め
選ぶ	選ん
彫る	彫っ
振りしぼる	振りしぼっ
吸寄せる	吸寄せ
かぎだす	かぎだし
紛らす	紛らし
詰めこむ	詰めこん
どうきづける	どうきづけ
見過す	見過し
つけ入る	つけ入っ
ぬきあわせる	ぬきあわせ
巻き込む	巻き込ん
結上げる	結上げ
才弾ける	才弾け
ときほぐす	ときほぐし
結ぼれる	結ぼれ
まいれる	まいれ
うりとばす	うりとばし
すりむく	すりむい
剥げる	剥げ
たくする	剥げ
したがう	したがっ
見せる	見せ
そまる	そまっ
煮付ける	煮付け
ぶっつける	ぶっつけ
しずむ	しずん
切り結ぶ	切り結ん
納める	納め
引さがる	引さがっ
陥れる	陥れ
つまみだす	つまみだし
引き絞れる	引き絞れ
取留める	取留め
預かる	預かっ
図抜ける	図抜け
安らぐ	安らい
瞬ぐ	瞬い
くべる	くべ
おちくぼむ	おちくぼん
擦り付ける	擦り付け
組合う	組合っ
たすかる	たすかっ
俯ける	俯け
かみあわせる	かみあわせ
購う	購っ
はね返る	はね返っ
振れる	振れ
とびまわる	とびまわっ
廻らす	廻らし
持ち寄れる	持ち寄れ
折りあえる	折りあえ
めかす	めかし
来れる	来れ
えりわける	えりわけ
ふんぞる	ふんぞっ
おせる	おせ
搖れる	搖れ
にえたつ	にえたっ
罵る	罵っ
欺ける	欺け
まがりくねる	まがりくねっ
涼む	涼ん
祝する	涼ん
立ち合う	立ち合っ
疑る	疑っ
慶べる	慶べ
連れ添える	連れ添え
やり返せる	やり返せ
燃えたつ	燃えたっ
あがりこむ	あがりこん
拗れる	拗れ
かつぎこむ	かつぎこん
ひきずる	ひきずっ
埋れる	埋れ
ほかす	ほかし
静める	静め
成かわる	成かわっ
かげる	かげっ
つぶれる	つぶれ
出し切る	出し切っ
吸い取れる	吸い取れ
諭す	諭し
取り紛れる	取り紛れ
取りまわす	取りまわし
おしむ	おしん
みだれとぶ	みだれとん
買い進む	買い進ん
うる	買い進ん
あう	あっ
捕まる	捕まっ
足せる	足せ
うわむく	うわむい
だれる	だれ
わかいしあう	わかいしあっ
振り返る	振り返っ
おいすがる	おいすがっ
はねる	はね
直せる	直せ
重ね合う	重ね合っ
いたす	いたし
埋もる	埋もっ
取り崩す	取り崩し
かける	かけ
かみくだける	かみくだけ
見る	見
中る	中っ
あらいおとす	あらいおとし
おしながせる	おしながせ
蹴倒す	蹴倒し
噛みくだく	噛みくだい
まなぶ	まなん
あおばむ	あおばん
攻め懸ける	攻め懸け
研ぎ澄ます	研ぎ澄まし
訛る	訛っ
おがめる	おがめ
吊りあがる	吊りあがっ
履き違える	履き違え
封じこめる	封じこめ
ねめる	ねめ
魘われる	魘われ
押し付ける	押し付け
散残る	散残っ
書き古す	書き古し
抜きとる	抜きとっ
わき起こせる	わき起こせ
絞り出せる	絞り出せ
逃げ出せる	逃げ出せ
うかれでる	うかれで
相次ぐ	相次い
差付ける	差付け
聞取る	聞取っ
どうける	どうけ
被れる	被れ
とり入れる	とり入れ
飛び乗る	飛び乗っ
乗捨てる	乗捨て
うけつげる	うけつげ
しぼりだせる	しぼりだせ
刺し殺す	刺し殺し
追いちらす	追いちらし
かいいれる	かいいれ
とりみだす	とりみだし
おもほす	おもほし
すぼまる	すぼまっ
殴り飛ばす	殴り飛ばし
思い知らせる	思い知らせ
甘える	甘え
きりかかる	きりかかっ
坐す	坐し
おもいあわせる	おもいあわせ
ぎしきばる	ぎしきばっ
取りつぐ	取りつい
延ばす	延ばし
報える	報え
うまれかわれる	うまれかわれ
組み直せる	組み直せ
うりさばける	うりさばけ
うりつくす	うりつくし
仕分ける	仕分け
こだわる	こだわっ
崇める	崇め
味わう	味わっ
ふりはなす	ふりはなし
しゃちほこばる	しゃちほこばっ
ぶっ飛ばす	ぶっ飛ばし
おぼえこむ	おぼえこん
痺れる	痺れ
なぎ払う	なぎ払っ
保つ	保っ
抱き上げる	抱き上げ
紡ぐ	紡い
切返す	切返し
しかりつける	しかりつけ
ひあがる	ひあがっ
へがす	へがし
戦がす	戦がし
煌めく	煌めい
見当たる	見当たっ
雑ざる	雑ざっ
うごめく	うごめい
見込める	見込め
飛廻る	飛廻っ
引っ張れる	引っ張れ
飲み明かす	飲み明かし
負かせる	負かせ
張りつめる	張りつめ
検する	張りつめ
打ち込む	打ち込ん
のせる	のせ
うなづける	うなづけ
もらう	もらっ
請け合う	請け合っ
考え付く	考え付い
成すます	成すまし
はべる	はべっ
挑める	挑め
みちゆく	みちゆき
はね返す	はね返し
繰り越せる	繰り越せ
即する	繰り越せ
さっきだつ	さっきだっ
触れまわる	触れまわっ
押し流す	押し流し
碾く	碾い
隠し持つ	隠し持っ
詰め込める	詰め込め
追い付ける	追い付け
まくる	まくっ
欺く	欺い
うだる	うだっ
取上せる	取上せ
摺れる	摺れ
あずかれる	あずかれ
アテる	アテ
けあげる	けあげ
ふりほどく	ふりほどい
張れる	張れ
たる	たっ
だましこむ	だましこん
頼み入る	頼み入っ
取りつくろう	取りつくろっ
かいうける	かいうけ
きりきざむ	きりきざん
はぎ合せる	はぎ合せ
かえる	かえ
引絞る	引絞っ
曲りくねる	曲りくねっ
養う	養っ
笑割れる	笑割れ
走り出す	走り出し
取廻す	取廻し
にくめる	にくめ
打続く	打続い
うるむ	うるん
めしとる	めしとっ
漕ぐ	漕い
担わす	担わし
めしだす	めしだし
厭う	厭う
泣き伏せる	泣き伏せ
たぎつ	たぎっ
なれあう	なれあっ
しみる	しみ
みつけだす	みつけだし
仰れる	仰れ
しみとおる	しみとおっ
こげつかす	こげつかし
おもいもうける	おもいもうけ
断ち切れる	断ち切れ
取決める	取決め
ぬぐい去れる	ぬぐい去れ
やって来る	やって来
あいせる	あいせ
つっ走る	つっ走っ
おとしめる	おとしめ
開け払う	開け払っ
関連付ける	関連付け
誇れる	誇れ
かいす	かいし
踏んづける	踏んづけ
動き回る	動き回っ
炒める	炒め
になえる	になえ
がめる	がめっ
受け止める	受け止め
消す	消し
擡げる	擡げ
うりこむ	うりこん
よみふける	よみふけっ
差しかえる	差しかえ
擂りつぶす	擂りつぶし
ゆする	ゆすっ
見積もる	見積もっ
めいじる	めいじ
もちまわれる	もちまわれ
てりつける	てりつけ
かきだせる	かきだせ
容体ぶる	容体ぶっ
立ち入れる	立ち入れ
待ち侘びる	待ち侘び
捜し出せる	捜し出せ
申し込める	申し込め
取直す	取直し
かたりあえる	かたりあえ
振捨てる	振捨て
のりあわす	のりあわし
いななく	いなない
しそこなう	しそこなっ
招く	招い
つき合える	つき合え
曲げる	曲げ
すり寄る	すり寄っ
語り明かせる	語り明かせ
苛める	苛め
通う	通っ
巻込む	巻込ん
暖める	暖め
まちあぐむ	まちあぐん
いかりくるう	いかりくるっ
組む	組ん
殴る	殴っ
たちかかる	たちかかっ
たなびく	たなびい
差し越す	差し越し
さしころせる	さしころせ
まぎらかす	まぎらかし
冷ませる	冷ませ
しくめる	しくめ
引き延ばせる	引き延ばせ
つかみかかる	つかみかかっ
付従う	付従っ
わかがえれる	わかがえれ
ふりすてる	ふりすて
ひかす	ひかし
たちゆく	たちゆき
悄気込む	悄気込ん
引きあげる	引きあげ
引っ繰り返す	引っ繰り返し
取り纏める	取り纏め
うかびあがる	うかびあがっ
照り映える	照り映え
きく	きい
飛び越える	飛び越え
つけこむ	つけこん
そめかえす	そめかえし
かちとれる	かちとれ
慢ずる	かちとれ
打ちあける	打ちあけ
さそいあわせる	さそいあわせ
ききながす	ききながし
かざれる	かざれ
まける	まけ
かきみだす	かきみだし
いせる	いせ
脅かす	脅かし
やすむ	やすん
溶け込む	溶け込ん
済ます	済まし
いきつく	いきつい
見当る	見当っ
崩れさる	崩れさっ
くいきる	くいきっ
じんどる	じんどっ
かんがえこむ	かんがえこん
よこたえる	よこたえ
居並ぶ	居並ん
見過ごす	見過ごし
持ち掛ける	持ち掛け
あとづける	あとづけ
想う	想う
勧める	勧め
つのめだつ	つのめだっ
画く	画い
かえりざく	かえりざい
やってのける	やってのけ
のみつぶす	のみつぶし
打抜く	打抜い
参ずる	打抜い
かきふるす	かきふるし
たむける	たむけ
旅立つ	旅立っ
フッカケる	フッカケ
御する	フッカケ
踏む	踏ん
あわれがる	あわれがっ
移り変わる	移り変わっ
たげる	たげ
打ち寄せる	打ち寄せ
寝静まる	寝静まっ
さきんずる	寝静まっ
うかぶ	うかん
しょぼぬれる	しょぼぬれ
ゆきくれる	ゆきくれ
おける	おけ
組みたてる	組みたて
押し詰める	押し詰め
駆りたてる	駆りたて
押しまくる	押しまくっ
ぶち込む	ぶち込ん
すべりおちる	すべりおち
抜かわる	抜かわっ
いなす	いなし
総毛立つ	総毛立っ
裏返せる	裏返せ
かす	かし
はりつける	はりつけ
みはからう	みはからっ
めがける	めがけ
流れ出す	流れ出し
もてあつかう	もてあつかっ
経つ	経っ
眩く	眩い
うねる	うねっ
くちずさむ	くちずさん
どなりつける	どなりつけ
湧き出る	湧き出
いいつける	いいつけ
つれ去る	つれ去っ
引き合う	引き合っ
よりつく	よりつい
奪い合う	奪い合っ
終える	終え
潤す	潤し
食う	食う
旧びる	旧び
切下げる	切下げ
いきおいこむ	いきおいこん
くる	き
なじむ	なじん
ふるいたつ	ふるいたっ
責立てる	責立て
しるす	しるし
連れ合う	連れ合っ
引っぱたく	引っぱたい
建て直す	建て直し
とりかたづける	とりかたづけ
押しつける	押しつけ
足す	足し
行き着ける	行き着け
わかる	わかっ
愛する	わかっ
いばえる	いばえ
粧う	粧っ
おくりだせる	おくりだせ
説ける	説け
ながれつける	ながれつけ
せり出す	せり出し
芽だつ	芽だっ
鑑みる	鑑み
たちいれる	たちいれ
突き立てる	突き立て
めり込む	めり込ん
言い張る	言い張っ
くくる	くくっ
ついばむ	ついばん
かろしめる	かろしめ
引離す	引離し
しだく	しだい
つくる	つくっ
懸隔たる	懸隔たっ
うわむける	うわむけ
乗後れる	乗後れ
泣きはらす	泣きはらし
立ちふさがる	立ちふさがっ
わがねる	わがね
取離す	取離し
ねじ上げる	ねじ上げ
うずく	うずい
取り壊す	取り壊し
でなおす	でなおし
あてこする	あてこすっ
つげる	つげ
光る	光っ
くされる	くされ
くぐれる	くぐれ
押し退ける	押し退け
くどく	くどい
のぼせあがる	のぼせあがっ
死ねる	死ね
ながれる	ながれ
落ちのびる	落ちのび
おしたおす	おしたおし
継ぐ	継い
勤める	勤め
詰む	詰ん
こらえる	こらえ
連れ込める	連れ込め
蒸せる	蒸せ
依る	依っ
したしめる	したしめ
要する	したしめ
粟立つ	粟立っ
使いこなす	使いこなし
物慣れる	物慣れ
かちすすめる	かちすすめ
よびもどす	よびもどし
みだせる	みだせ
捩じくれる	捩じくれ
取りもつ	取りもっ
かけあわす	かけあわし
しにかわる	しにかわっ
終わらす	終わらし
見い出す	見い出し
伐る	伐っ
うみおとす	うみおとし
ほうじる	ほうじ
泡立てる	泡立て
誉める	誉め
ながしこめる	ながしこめ
伏し拝む	伏し拝ん
取り結ぶ	取り結ん
のりくむ	のりくん
企む	企ん
独りごつ	独りごっ
とりけせる	とりけせ
調子付く	調子付い
縫える	縫え
なくす	なくし
からみつく	からみつい
愚図る	愚図っ
持ち込める	持ち込め
しょっぴく	しょっぴい
尖らす	尖らし
送れる	送れ
吹きとばす	吹きとばし
撫でる	撫で
差せる	差せ
潜む	潜ん
おしうつる	おしうつっ
質す	質し
付ける	付け
取り回す	取り回し
みはらせる	みはらせ
勝ち進む	勝ち進ん
ふるえあがる	ふるえあがっ
見下す	見下し
伸べる	伸べ
取り揃う	取り揃っ
うちしずむ	うちしずん
をろがむ	をろがん
ぬきんでる	ぬきんで
一皮むく	一皮むい
ふうじこむ	ふうじこん
抱きつく	抱きつい
混ぜ合わせる	混ぜ合わせ
荒らせる	荒らせ
おわす	おわし
なぐさむ	なぐさん
伏し沈む	伏し沈ん
失ふ	失ひ
追い払う	追い払っ
かぎわける	かぎわけ
凭れる	凭れ
歓べる	歓べ
つれる	つれ
持ち回れる	持ち回れ
はくす	はくし
規則立つ	規則立っ
ねじける	ねじけ
りゃくせる	りゃくせ
摸する	りゃくせ
泊まれる	泊まれ
とりこす	とりこし
つらねる	つらね
付け足せる	付け足せ
待合せる	待合せ
立て直す	立て直し
あらえる	あらえ
入れかえる	入れかえ
ビビる	ビビっ
祷る	祷っ
みおとす	みおとし
くう	くっ
かいこす	かいこし
結びつく	結びつい
与える	与え
得る	与え
撃止める	撃止め
増せる	増せ
溶く	溶い
逃げ延びる	逃げ延び
ねがいでる	ねがいで
勝れる	勝れ
うらぎる	うらぎっ
きょうずる	うらぎっ
ひきまわす	ひきまわし
だらける	だらけ
和む	和ん
くらす	くらし
つっ切る	つっ切っ
きりむすぶ	きりむすん
追い抜く	追い抜い
うるおう	うるおっ
つかる	つかっ
そんずる	つかっ
くみ出す	くみ出し
なり変わる	なり変わっ
うかびでる	うかびで
くみたてる	くみたて
差し入れる	差し入れ
つかまる	つかまっ
歪む	歪ん
抜かす	抜かし
干からびる	干からび
扠措く	扠措い
寝忘れる	寝忘れ
旅立てる	旅立て
崩せる	崩せ
引き合せる	引き合せ
えがける	えがけ
類える	類え
継ぎ合せる	継ぎ合せ
突っ返せる	突っ返せ
うみつける	うみつけ
ねだる	ねだっ
打合う	打合っ
飛び降りる	飛び降り
ぬるむ	ぬるん
ほっする	ぬるん
噛み分ける	噛み分け
置き忘れる	置き忘れ
もみ消す	もみ消し
尋め行く	尋め行き
かっとばす	かっとばし
かつぎこめる	かつぎこめ
釣り上げる	釣り上げ
取り込める	取り込め
逆上せる	逆上せ
おしわける	おしわけ
打ち取る	打ち取っ
引きずり回せる	引きずり回せ
後れる	後れ
住み替える	住み替え
成り下がる	成り下がっ
せかせる	せかせ
責め付ける	責め付け
差し回す	差し回し
いいかえす	いいかえし
減らす	減らし
あてる	あて
しらちゃける	しらちゃけ
とけこめる	とけこめ
さく	さい
ねとつく	ねとつい
飾り付ける	飾り付け
生み出せる	生み出せ
切羽詰る	切羽詰っ
きりさく	きりさい
すりむける	すりむけ
ばける	ばけ
居残る	居残っ
せいする	居残っ
こみあげる	こみあげ
たぶ	たび
引き下ろせる	引き下ろせ
偲ぶ	偲ん
張り倒す	張り倒し
おかせる	おかせ
肥る	肥っ
引裂く	引裂い
染み透る	染み透っ
騰がる	騰がっ
散り残る	散り残っ
梳く	梳い
綴り合せる	綴り合せ
うりなやむ	うりなやん
賄う	賄っ
ふきこむ	ふきこん
賭ける	賭け
事足る	事足っ
ころげる	ころげ
ポシャる	ポシャっ
飛びだす	飛びだし
明け払う	明け払っ
噛みころす	噛みころし
ねとる	ねとっ
ズレ込む	ズレ込ん
成す	成し
覚え込む	覚え込ん
おくりだす	おくりだし
運び込める	運び込め
はぎ合わす	はぎ合わし
はらえる	はらえ
立ちのぼる	立ちのぼっ
咽ぶ	咽ん
さしきる	さしきっ
慶ぶ	慶ん
張回す	張回し
根差す	根差し
辷る	辷っ
もうしつける	もうしつけ
立合う	立合っ
思い出せる	思い出せ
読み分ける	読み分け
くらう	くらっ
うねりくねる	うねりくねっ
泣崩れる	泣崩れ
蝕む	蝕ん
たくす	たくし
とどまる	とどまっ
やせほそる	やせほそっ
打込める	打込め
もうしうける	もうしうけ
だしあう	だしあっ
うちあげる	うちあげ
押し出す	押し出し
いどむ	いどん
拉げる	拉げ
がいす	がいし
見おろす	見おろし
切り払う	切り払っ
ひんまがる	ひんまがっ
打付ける	打付け
投げ込む	投げ込ん
ねつく	ねつい
乗り掛る	乗り掛っ
踏みならせる	踏みならせ
さえぎる	さえぎっ
いやまさる	いやまさっ
ようだてる	ようだて
波うつ	波うっ
差し掛ける	差し掛け
詰切る	詰切っ
はりとばす	はりとばし
出かける	出かけ
すぐる	すぐっ
頑張る	頑張っ
織りなす	織りなし
生延びる	生延び
スレ違う	スレ違っ
投げ飛ばす	投げ飛ばし
おごる	おごっ
せきいる	せきいっ
判じる	判じ
さしまわせる	さしまわせ
だきおこす	だきおこし
勝ち誇る	勝ち誇っ
押隠す	押隠し
へこたれる	へこたれ
でばる	でばっ
脱す	脱し
生きながらえる	生きながらえ
戦慄く	戦慄い
すたれる	すたれ
張り上げる	張り上げ
よみこなせる	よみこなせ
待ちかねる	待ちかね
ほうる	ほうっ
ろくする	ほうっ
くわれる	くわれ
すすり上げる	すすり上げ
担う	担っ
まかなう	まかなっ
騰る	騰っ
さからえる	さからえ
はせまわる	はせまわっ
読む	読ん
受け入れる	受け入れ
引き連れる	引き連れ
儲ける	儲け
ハマる	ハマっ
もちこす	もちこし
押し上げる	押し上げ
召上がる	召上がっ
割込む	割込ん
くりだせる	くりだせ
もつれ込む	もつれ込ん
こまりはてる	こまりはて
立てかける	立てかけ
いきかえれる	いきかえれ
こぎ着く	こぎ着い
立去る	立去っ
りっする	立去っ
取り上げる	取り上げ
ひれ伏す	ひれ伏し
思い知る	思い知っ
下掛る	下掛っ
差迫る	差迫っ
くみかえる	くみかえ
差し合う	差し合っ
出立つ	出立っ
ひもとく	ひもとい
うずくまる	うずくまっ
温む	温ん
あけはなせる	あけはなせ
洒落る	洒落
こそぐる	こそぐっ
はばむ	はばん
積み出せる	積み出せ
くいのばす	くいのばし
なずらえる	なずらえ
乗り込める	乗り込め
しねる	しね
押し流せる	押し流せ
雇う	雇っ
模する	雇っ
嘆く	嘆い
しぐれる	しぐれ
したう	したっ
投げ飛ばせる	投げ飛ばせ
起きる	起き
切払う	切払っ
やけだす	やけだし
ふき取る	ふき取っ
知れ渡る	知れ渡っ
訳す	訳し
住み込む	住み込ん
荒れる	荒れ
こごむ	こごん
まつりあげる	まつりあげ
休する	まつりあげ
あらわす	あらわし
智慧づく	智慧づい
生い茂る	生い茂っ
垂れ篭める	垂れ篭め
翔ぶ	翔ん
あみあげる	あみあげ
なまける	なまけ
取り切れる	取り切れ
もり立てる	もり立て
飲みほす	飲みほし
まきこむ	まきこん
纏う	纏っ
乗り回せる	乗り回せ
すすりあげる	すすりあげ
助け合える	助け合え
ものもうす	ものもうし
すてさる	すてさっ
免じる	免じ
うけだせる	うけだせ
和解し合う	和解し合っ
とりくめる	とりくめ
受け持つ	受け持っ
振りほどく	振りほどい
卒する	振りほどい
つづりあわす	つづりあわし
一皮剥ける	一皮剥け
先駆ける	先駆け
えらびだす	えらびだし
うちすえる	うちすえ
使い込む	使い込ん
さまたげる	さまたげ
すたる	すたっ
書する	すたっ
不貞てる	不貞て
とびこめる	とびこめ
見蕩れる	見蕩れ
慥かめる	慥かめ
つまみ上げる	つまみ上げ
のます	のまし
涸らす	涸らし
撰する	涸らし
寝かしつける	寝かしつけ
歩きつめる	歩きつめっ
診る	診
ぬいこむ	ぬいこん
きりこむ	きりこん
膨らます	膨らまし
ちゃう	ちゃっ
宿る	宿っ
取りかかる	取りかかっ
巻き返せる	巻き返せ
すり込む	すり込ん
追回す	追回し
登れる	登れ
差し立てる	差し立て
打ち勝てる	打ち勝て
ふきぬける	ふきぬけ
切回す	切回し
うつす	うつし
つみだせる	つみだせ
切合う	切合っ
はいする	切合っ
裏切る	裏切っ
かいきれる	かいきれ
埋め込む	埋め込ん
取りあわせる	取りあわせ
閉め出す	閉め出し
出来合う	出来合っ
騒がせる	騒がせ
ほどこす	ほどこし
習わせる	習わせ
ぬけだす	ぬけだし
追越す	追越し
ばらつく	ばらつい
ばてる	ばて
傷付ける	傷付け
うちやぶれる	うちやぶれ
ふきわける	ふきわけ
棲む	棲ん
頻る	頻っ
きそう	きそっ
ねじ込む	ねじ込ん
たてこむ	たてこん
いく	いっ
ひずむ	ひずん
取り置く	取り置い
はしゃぐ	はしゃい
とう	とっ
どかす	どかし
あらわれる	あらわれ
かりうける	かりうけ
繰り寄せる	繰り寄せ
まくれる	まくれ
とりちらす	とりちらし
ものなれる	ものなれ
角ぐむ	角ぐん
思いまどう	思いまどっ
押し隠す	押し隠し
あらそう	あらそっ
取っ付く	取っ付い
血迷う	血迷っ
だする	血迷っ
絡げる	絡げ
言い合せる	言い合せ
かかげる	かかげ
おいかえせる	おいかえせ
かつぎ込む	かつぎ込ん
切替える	切替え
軋む	軋ん
切り捲る	切り捲っ
綻ばす	綻ばし
しのびなく	しのびない
つくりだせる	つくりだせ
ひきしぼれる	ひきしぼれ
乗回す	乗回し
かんじとる	かんじとっ
控える	控え
わりびく	わりびい
呼びいれる	呼びいれ
切伏せる	切伏せ
掻きたてる	掻きたて
煮えたつ	煮えたっ
補い合う	補い合っ
住み着ける	住み着け
寝付く	寝付い
念じる	念じ
きりまわせる	きりまわせ
吹っ切る	吹っ切っ
甘ったれる	甘ったれ
勝ち残る	勝ち残っ
慌てる	慌て
癒せる	癒せ
乗組む	乗組ん
咳き上げる	咳き上げ
つきとめる	つきとめ
潰れる	潰れ
わりだせる	わりだせ
博す	博し
組み入れる	組み入れ
かしぐ	かしい
やり過ごせる	やり過ごせ
崩ずる	やり過ごせ
言いおく	言いおい
有り余る	有り余っ
わらいとばす	わらいとばし
逃がす	逃がし
まちがう	まちがっ
ねじきる	ねじきっ
神しずまる	神しずまっ
やとえる	やとえ
切り伏せる	切り伏せ
滲む	滲ん
あせる	あせ
ひょうする	あせ
吸取る	吸取っ
よじのぼる	よじのぼっ
殖やせる	殖やせ
ちんずる	殖やせ
またげる	またげ
繰回す	繰回し
笑わせる	笑わせ
ふりしぼる	ふりしぼっ
かつぎあげる	かつぎあげ
使い切る	使い切っ
脅す	脅し
歩き疲れる	歩き疲れ
かたよる	かたよっ
裂ける	裂け
帰す	帰し
かみ合う	かみ合っ
分る	分っ
戦える	戦え
切りつめる	切りつめ
言い表せる	言い表せ
啼く	啼い
たたむ	たたん
おこたる	おこたっ
せめる	せめ
もちなおす	もちなおし
譲り渡せる	譲り渡せ
よみする	譲り渡せ
彌増さる	彌増さっ
やむ	やん
長ける	長け
おとせる	おとせ
きがまえる	きがまえ
乗越す	乗越し
見渡せる	見渡せ
かくしもてる	かくしもて
かんがえる	かんがえ
うたがう	うたがっ
損する	うたがっ
うめく	うめい
くらいつく	くらいつい
返せる	返せ
すっこむ	すっこん
運べる	運べ
まわる	まわっ
おとる	おとっ
萌え出る	萌え出
晴渡る	晴渡っ
果てる	果て
録する	果て
移せる	移せ
悄気げる	悄気げ
言い返せる	言い返せ
ぎんずる	言い返せ
止る	止っ
みさげる	みさげ
阻む	阻ん
来なさる	来なさっ
折重なる	折重なっ
ふっ飛ぶ	ふっ飛ん
通がる	通がっ
てまどる	てまどっ
しにはてる	しにはて
向かい合わす	向かい合わし
当てはめる	当てはめ
とびこせる	とびこせ
ためる	ため
なきふす	なきふし
さらう	さらっ
ぬりたてる	ぬりたて
かたりあかせる	かたりあかせ
接ぎ合せる	接ぎ合せ
とりだせる	とりだせ
募る	募っ
ひっこぬく	ひっこぬい
つけ足す	つけ足し
見通せる	見通せ
みあきる	みあき
思いあまる	思いあまっ
追う	追っ
もれきく	もれきい
ふゆごもる	ふゆごもっ
飛び歩く	飛び歩い
刷り込む	刷り込ん
くいつめる	くいつめ
くぐる	くぐっ
いいきる	いいきっ
かき合せる	かき合せ
荒立てる	荒立て
閲する	荒立て
焦げつかす	焦げつかし
のりまわせる	のりまわせ
隠す	隠し
そだつ	そだっ
被える	被え
でる	で
殴れる	殴れ
洩れる	洩れ
いびりだす	いびりだし
しがみつく	しがみつい
いただく	いただい
打見る	打見
討取る	討取っ
誤る	誤っ
受流す	受流し
責め立てる	責め立て
尋ねる	尋ね
かびる	かび
ほおばる	ほおばっ
射抜く	射抜い
啄む	啄ん
よりすがる	よりすがっ
浸ける	浸け
撃ち破れる	撃ち破れ
突合せる	突合せ
謡う	謡っ
立ち篭める	立ち篭め
のりだす	のりだし
立ちつくす	立ちつくし
吹き分ける	吹き分け
香る	香っ
せめあぐむ	せめあぐん
払い戻せる	払い戻せ
さしかざす	さしかざし
ひっぱる	ひっぱっ
似つく	似つい
用いる	用い
とりさげる	とりさげ
取り混ぜる	取り混ぜ
ほだされる	ほだされ
いきつける	いきつけ
目指す	目指し
立ち直れる	立ち直れ
惑う	惑っ
てつだえる	てつだえ
きりたおせる	きりたおせ
ならう	ならっ
拝める	拝め
落ちこむ	落ちこん
かつ	かっ
ねらう	ねらっ
焙る	焙っ
としとる	としとっ
犇めく	犇めい
ごろつく	ごろつい
翻せる	翻せ
くずす	くずし
扱える	扱え
哭く	哭い
とびでる	とびで
書き留める	書き留め
悩む	悩ん
のがれる	のがれ
突き刺さる	突き刺さっ
役だつ	役だっ
とげる	とげ
勝る	勝っ
ぶった切る	ぶった切っ
読み解く	読み解い
惹く	惹い
きらす	きらし
穿つ	穿っ
巻き付ける	巻き付け
るいする	巻き付け
うけあえる	うけあえ
差し響く	差し響い
ふみつける	ふみつけ
ならわせる	ならわせ
りゃくする	ならわせ
へせる	へせ
通いつめる	通いつめ
なげく	なげい
みつぐ	みつい
かがす	かがし
伸し歩く	伸し歩い
くばれる	くばれ
縛り付ける	縛り付け
みすえる	みすえ
暮らす	暮らし
持ちこむ	持ちこん
掛かる	掛かっ
掻い繕う	掻い繕っ
噎せ返る	噎せ返っ
混じる	混じっ
付きまとう	付きまとっ
しんじこめる	しんじこめ
ゆであがる	ゆであがっ
寇する	ゆであがっ
振りだす	振りだし
にごらせる	にごらせ
取繕う	取繕っ
みくだせる	みくだせ
巻き起こす	巻き起こし
せり合う	せり合っ
こいしたう	こいしたっ
焼付ける	焼付け
ほとびる	ほとび
怨む	怨ん
はじまる	はじまっ
取り直せる	取り直せ
飽かす	飽かし
おしいれる	おしいれ
まぎれる	まぎれ
かぶりつく	かぶりつい
あつまる	あつまっ
にげまどう	にげまどっ
誤らせる	誤らせ
生き抜く	生き抜い
急がす	急がし
煽る	煽っ
ひねくれる	ひねくれ
とめゆく	とめゆき
働き掛ける	働き掛け
やきなます	やきなまし
引きずり回す	引きずり回し
ゆれうごく	ゆれうごい
伸し掛る	伸し掛っ
消える	消え
習う	習っ
振掛ける	振掛け
おぼめく	おぼめい
もうしおくれる	もうしおくれ
しゃぶりつく	しゃぶりつい
浮出す	浮出し
喚く	喚い
染みとおる	染みとおっ
標す	標し
奪える	奪え
縁付く	縁付い
歩み寄れる	歩み寄れ
たいす	たいし
だまかす	だまかし
湧く	湧い
コケる	コケ
ひっ付く	ひっ付い
思いつく	思いつい
焚ける	焚け
溺れる	溺れ
はかなむ	はかなん
きりはらえる	きりはらえ
みまわす	みまわし
巣ごもる	巣ごもっ
そびやかす	そびやかし
きずつける	きずつけ
傷つける	傷つけ
のっとれる	のっとれ
えつにいる	えつにいっ
はらだつ	はらだっ
預かれる	預かれ
たる	たっ
煎じる	煎じ
毀れる	毀れ
おいさらばえる	おいさらばえ
おれあう	おれあっ
つき刺さる	つき刺さっ
笑われる	笑われ
かき回す	かき回し
かみあわす	かみあわし
たかる	たかっ
はたらかす	はたらかし
織りまぜる	織りまぜ
縁る	縁っ
取りすがる	取りすがっ
うっちゃらかす	うっちゃらかし
表わす	表わし
型どる	型どっ
乗り越せる	乗り越せ
作り直す	作り直し
さしちがえる	さしちがえ
浮き上がる	浮き上がっ
かけはなれる	かけはなれ
眺める	眺め
見離す	見離し
説き明かす	説き明かし
すっぽかす	すっぽかし
いなむ	いなん
てく	てっ
とうずる	てっ
連れ込む	連れ込ん
漉す	漉し
持ち回る	持ち回っ
しとげる	しとげ
かき混ぜる	かき混ぜ
差し掛かる	差し掛かっ
取り散らす	取り散らし
癒える	癒え
晴れ上がる	晴れ上がっ
失する	晴れ上がっ
つぎこむ	つぎこん
言い漏らす	言い漏らし
おぼす	おぼし
バレる	バレ
ほそる	ほそっ
とまどう	とまどっ
ゆる	ゆっ
こさえる	こさえ
鬻ぐ	鬻い
めざす	めざし
蕾む	蕾ん
ぬがす	ぬがし
しゃがめる	しゃがめ
追い詰める	追い詰め
押し通せる	押し通せ
戸惑う	戸惑っ
とりはずせる	とりはずせ
そむく	そむい
浮かす	浮かし
選びとれる	選びとれ
からむ	からん
銘打つ	銘打っ
振るえる	振るえ
心得る	心得
混じる	混じ
付け足す	付け足し
立ちこめる	立ちこめ
跳ぶ	跳ん
引抜く	引抜い
出向ける	出向け
差つかえる	差つかえ
わたりあるく	わたりあるい
つぶる	つぶっ
打捨てる	打捨て
申しかねる	申しかね
速める	速め
賜わる	賜わっ
怒らす	怒らし
なだめる	なだめ
きどる	きどっ
追い散らす	追い散らし
知る	知っ
かかれる	かかれ
かいもどせる	かいもどせ
笑わす	笑わし
振舞う	振舞っ
うりまくる	うりまくっ
きぶくれる	きぶくれ
借る	借っ
呼び込む	呼び込ん
蹴違える	蹴違え
そくす	そくし
いましめる	いましめ
さそいあわす	さそいあわし
ふるい落とせる	ふるい落とせ
扱く	扱い
平伏す	平伏し
あぶらぎる	あぶらぎっ
わりだす	わりだし
突っ放す	突っ放し
へだてる	へだて
なりさがれる	なりさがれ
呼掛ける	呼掛け
点く	点い
せきこむ	せきこん
かくばる	かくばっ
涙ぐむ	涙ぐん
画する	涙ぐん
つまむ	つまん
靠れる	靠れ
つかえる	つかえ
にぎりしめる	にぎりしめ
小戻す	小戻し
減ずる	小戻し
にぎやかす	にぎやかし
ぶら下がる	ぶら下がっ
売りさばける	売りさばけ
さておく	さておい
伸び上がる	伸び上がっ
よびつづける	よびつづけ
託つ	託っ
たずさえる	たずさえ
つき合せる	つき合せ
吊り上がる	吊り上がっ
出廻る	出廻っ
かき消える	かき消え
したたらす	したたらし
すがめる	すがめ
ことづかる	ことづかっ
見通す	見通し
はがせる	はがせ
手慣れる	手慣れ
聞き分ける	聞き分け
きあわす	きあわし
しりあえる	しりあえ
見破る	見破っ
反る	反っ
しぼむ	しぼん
才走る	才走っ
形作る	形作っ
片付ける	片付け
くる	き
いあわせる	いあわせ
引っ被る	引っ被っ
噛み合せる	噛み合せ
振りさけみる	振りさけみ
見回す	見回し
あおむく	あおむい
すだく	すだい
えんする	すだい
結え付ける	結え付け
病む	病ん
膨らむ	膨らん
追いまくる	追いまくっ
捲揚げる	捲揚げ
引き返す	引き返し
寝ころべる	寝ころべ
擦り剥ける	擦り剥け
出つくす	出つくし
思い設ける	思い設け
しめせる	しめせ
終える	終え
落とし込める	落とし込め
呼寄せる	呼寄せ
いきのびる	いきのび
施せる	施せ
たもつ	たもっ
立てこもれる	立てこもれ
ふんづける	ふんづけ
こわす	こわし
嵩張る	嵩張っ
区切れる	区切れ
押し込む	押し込ん
あらいながす	あらいながし
おびき出せる	おびき出せ
とけ込む	とけ込ん
持ち寄る	持ち寄っ
もちあるく	もちあるい
振絞る	振絞っ
しりあう	しりあっ
とまりこむ	とまりこん
談ずる	とまりこん
かてる	かて
焦がす	焦がし
思える	思え
たどり着ける	たどり着け
ひきあわせる	ひきあわせ
泊り込む	泊り込ん
追いはらう	追いはらっ
目ざす	目ざし
割り切れる	割り切れ
科する	割り切れ
みはなす	みはなし
しむける	しむけ
ねじ伏せる	ねじ伏せ
かえりみる	かえりみ
引き回す	引き回し
しく	しい
かする	かすっ
みちびく	みちびい
載っかる	載っかっ
ほめる	ほめ
さきのこる	さきのこっ
悩ます	悩まし
世慣れる	世慣れ
にらみ合う	にらみ合っ
だぶつく	だぶつい
住み成す	住み成し
わく	わい
垣間見る	垣間見
かくせる	かくせ
論る	論っ
あたう	あたっ
かけ込む	かけ込ん
融かす	融かし
簸る	簸
きあわせる	きあわせ
わりつける	わりつけ
つきあわす	つきあわし
ひきあう	ひきあっ
まわせる	まわせ
切裂く	切裂い
たくましゅうする	切裂い
かきのこす	かきのこし
浮く	浮い
いじめる	いじめ
食らえる	食らえ
飛び下りる	飛び下り
踏み止まる	踏み止まっ
囲う	囲っ
なきくずれる	なきくずれ
賣る	賣っ
掛け合せる	掛け合せ
射し込む	射し込ん
御座る	御座っ
さしあげる	さしあげ
ふるいおこす	ふるいおこし
しょぼたれる	しょぼたれ
ちょろまかす	ちょろまかし
使いこなせる	使いこなせ
もえうつる	もえうつっ
いいつかる	いいつかっ
はねのける	はねのけ
焼払う	焼払っ
楽しめる	楽しめ
たらし込む	たらし込ん
這いだす	這いだし
呼び続ける	呼び続け
あわ立つ	あわ立っ
めす	めし
句切る	句切っ
触れこむ	触れこん
いなおる	いなおっ
分捕る	分捕っ
葺く	葺い
痩せる	痩せ
引き受ける	引き受け
寂れる	寂れ
たたき込む	たたき込ん
判る	判っ
暖まる	暖まっ
漕ぎつける	漕ぎつけ
咲く	咲い
ほりこめる	ほりこめ
かみくだく	かみくだい
伸び上がれる	伸び上がれ
かいあさる	かいあさっ
すが立つ	すが立っ
いきせききる	いきせききっ
もえつきる	もえつき
ひねりまわす	ひねりまわし
おいこす	おいこし
からげる	からげ
践む	践ん
割り込む	割り込ん
受け継ぐ	受け継い
思ひ寄る	思ひ寄っ
こじらす	こじらし
おしもどす	おしもどし
はじき返す	はじき返し
冷やせる	冷やせ
まじる	まじっ
きりおとす	きりおとし
さらせる	さらせ
食い下がれる	食い下がれ
つくす	つくし
時雨れる	時雨れ
座る	座っ
まねる	まね
済む	済ん
疎んずる	済ん
すべりだす	すべりだし
霜枯れる	霜枯れ
かんじる	かんじ
えづく	えづい
煮立てる	煮立て
あびせかける	あびせかけ
もつれる	もつれ
押し遣る	押し遣っ
凍りつく	凍りつい
達っする	凍りつい
資する	凍りつい
透かす	透かし
濁る	濁っ
込み合う	込み合っ
えっする	込み合っ
絞り上げる	絞り上げ
擦り切る	擦り切っ
産す	産し
仰げる	仰げ
まいくるう	まいくるっ
寄せ掛ける	寄せ掛け
陳ずる	寄せ掛け
捲き込む	捲き込ん
うちとめる	うちとめ
ふすべる	ふすべ
得する	ふすべ
ずり上がる	ずり上がっ
踏まえる	踏まえ
まわれる	まわれ
いいけす	いいけし
じゅんじる	じゅんじ
いてつく	いてつい
ちらす	ちらし
遺す	遺し
拱く	拱い
のめる	のめ
となりあわす	となりあわし
ふみこえる	ふみこえ
誘ふ	誘ひ
まいあがる	まいあがっ
打ちだせる	打ちだせ
蹴返す	蹴返し
浴びせる	浴びせ
背く	背い
きめつける	きめつけ
暮す	暮し
継る	継っ
問ただす	問ただし
つかわれだす	つかわれだし
なさる	なさっ
連れあう	連れあっ
ぶんどる	ぶんどっ
押詰める	押詰め
ちらかす	ちらかし
おどしとる	おどしとっ
ひっこせる	ひっこせ
介す	介し
ぱさつく	ぱさつい
抜放つ	抜放っ
取出す	取出し
であえる	であえ
損なう	損なっ
ほどく	ほどい
刃向かえる	刃向かえ
苦しむ	苦しん
身ごもる	身ごもっ
うすずく	うすずい
生れる	生れ
かきのこせる	かきのこせ
行きつく	行きつい
飛び違う	飛び違っ
むらす	むらし
やにさがる	やにさがっ
うたう	うたっ
見知る	見知っ
ききとれる	ききとれ
おいつく	おいつい
語らう	語らっ
武張る	武張っ
請じ入れる	請じ入れ
さきだてる	さきだて
あがなう	あがなっ
かけ合う	かけ合っ
さしころす	さしころし
ほする	さしころし
もがける	もがけ
尽くす	尽くし
塗る	塗っ
引き取る	引き取っ
出る	出
手掛ける	手掛け
かいまみる	かいまみ
かたむく	かたむい
開きなおる	開きなおっ
映ろう	映ろっ
にこむ	にこん
たちどまる	たちどまっ
こいする	たちどまっ
現す	現し
すいつける	すいつけ
ひき殺す	ひき殺し
いびる	いびっ
引き退ける	引き退け
愛し合える	愛し合え
生る	生っ
ぬぐい去る	ぬぐい去っ
表れる	表れ
寄り添える	寄り添え
てばなせる	てばなせ
表す	表し
動きだす	動きだし
せりあえる	せりあえ
おいあげる	おいあげ
いいおよぼす	いいおよぼし
吼える	吼え
へんする	吼え
ひきかえせる	ひきかえせ
在りあわせる	在りあわせ
聞込む	聞込ん
よせる	よせ
ゆりうごかせる	ゆりうごかせ
むしゃぶりつく	むしゃぶりつい
にぎりつぶせる	にぎりつぶせ
おいはらえる	おいはらえ
見つかる	見つかっ
閃かす	閃かし
浮き足立つ	浮き足立っ
廃る	廃っ
振り向く	振り向い
書き表す	書き表し
燃え尽きる	燃え尽き
生みつける	生みつけ
みつめる	みつめ
のぞき込む	のぞき込ん
交わる	交わっ
思わす	思わし
やる	やっ
聴く	聴い
にる	に
つまる	つまっ
上せる	上せ
たきしめる	たきしめ
げする	たきしめ
うちきる	うちきっ
触込む	触込ん
靡く	靡い
さしつかわす	さしつかわし
遣りこなす	遣りこなし
青みがかる	青みがかっ
攻め落す	攻め落し
掻き混ぜる	掻き混ぜ
蹶る	蹶っ
せめつける	せめつけ
引き抜く	引き抜い
ふりおこす	ふりおこし
仰向ける	仰向け
定義付ける	定義付け
染めわける	染めわけ
押し出せる	押し出せ
しす	しし
うかれだす	うかれだし
申し立てる	申し立て
いだける	いだけ
好き好む	好き好ん
点ずる	好き好ん
枯らす	枯らし
のびる	のび
綴り合す	綴り合し
見紛う	見紛っ
澱む	澱ん
巣立てる	巣立て
知合う	知合っ
紐解ける	紐解け
わき起こす	わき起こし
おもいおよぶ	おもいおよん
暮れる	暮れ
かんがえぬく	かんがえぬい
吐かす	吐かし
俯く	俯い
空惚ける	空惚け
にげだす	にげだし
色めく	色めい
からめる	からめ
いう	いっ
だんずる	いっ
こびへつらう	こびへつらっ
読み込む	読み込ん
よじる	よじっ
いたわる	いたわっ
引合う	引合っ
行う	行っ
押し掛ける	押し掛け
捏ねる	捏ね
ひきわける	ひきわけ
分かれる	分かれ
習わす	習わし
立のく	立のい
見やる	見やっ
引き留める	引き留め
入り込める	入り込め
ひっくり返す	ひっくり返し
べたつく	べたつい
のす	のし
かきすてる	かきすて
こびり付く	こびり付い
うきあがる	うきあがっ
吸い込む	吸い込ん
きよめる	きよめ
だいする	きよめ
写せる	写せ
さめる	さめ
補う	補っ
起き上がれる	起き上がれ
とりこめる	とりこめ
攻める	攻め
待ち焦がれる	待ち焦がれ
にらみ合わす	にらみ合わし
跡づける	跡づけ
よりたおせる	よりたおせ
わりきれる	わりきれ
報ずる	わりきれ
およぶ	およん
備わる	備わっ
晴れ渡る	晴れ渡っ
とりはこべる	とりはこべ
つつみこむ	つつみこん
てわたせる	てわたせ
値切る	値切っ
干す	干し
浮かび上がる	浮かび上がっ
おくりかえす	おくりかえし
ふっとぶ	ふっとん
張り合わす	張り合わし
逃げる	逃げ
吹まくる	吹まくっ
いいたてる	いいたて
行き届く	行き届い
罹る	罹っ
汚れる	汚れ
罷る	罷っ
立て掛ける	立て掛け
すむ	すん
ぎす	ぎし
書散らす	書散らし
涌かす	涌かし
伝える	伝え
そえる	そえ
打ち消せる	打ち消せ
ずらかる	ずらかっ
やすらぐ	やすらい
はしりさる	はしりさっ
乱せる	乱せ
うわまわる	うわまわっ
剥く	剥い
巣くう	巣くっ
引きずる	引きずっ
ゆでこぼす	ゆでこぼし
押切る	押切っ
草生す	草生し
撒ける	撒け
昂る	昂っ
ひきあわす	ひきあわし
ぬう	ぬっ
うらがえる	うらがえっ
受け流せる	受け流せ
たでる	たで
つつく	つつい
籠る	籠っ
余す	余し
くれのこる	くれのこっ
書き入れる	書き入れ
取りつける	取りつけ
飾れる	飾れ
まねきいれる	まねきいれ
買いためる	買いため
ぬぐい取る	ぬぐい取っ
焼け付く	焼け付い
衰える	衰え
げすばる	げすばっ
言捨てる	言捨て
開け放つ	開け放っ
躍り出る	躍り出
おぼらす	おぼらし
ため込める	ため込め
竄する	ため込め
ぬいあわせる	ぬいあわせ
しゃくれる	しゃくれ
かせげる	かせげ
素っ破抜く	素っ破抜い
突破る	突破っ
うつろう	うつろっ
もちこたえる	もちこたえ
見合せる	見合せ
なびかす	なびかし
旧る	旧っ
行き暮す	行き暮し
食い延す	食い延し
行ける	行け
ごまかす	ごまかし
でっち上げる	でっち上げ
ひびかす	ひびかし
もたらす	もたらし
置く	置い
聞き合わせる	聞き合わせ
さわげる	さわげ
勉める	勉め
ひびわれる	ひびわれ
競い立つ	競い立っ
瞬く	瞬い
売飛ばす	売飛ばし
かどわかす	かどわかし
遷り変る	遷り変っ
ささる	ささっ
たりる	たり
け落とせる	け落とせ
いきむ	いきん
攻め上る	攻め上っ
みれる	みれ
和する	みれ
ふるい落す	ふるい落し
あおのける	あおのけ
ひきぬける	ひきぬけ
みはれる	みはれ
為成す	為成し
まきちらす	まきちらし
ねじ合う	ねじ合っ
なやみぬく	なやみぬい
わたりあえる	わたりあえ
思い切る	思い切っ
できあう	できあっ
とろける	とろけ
迷う	迷っ
おぎなえる	おぎなえ
熾す	熾し
高鳴る	高鳴っ
つかわす	つかわし
立まじる	立まじっ
渫う	渫っ
暮れ残る	暮れ残っ
穢す	穢し
組合す	組合し
膨らせる	膨らせ
反らす	反らし
練り歩く	練り歩い
反っくり返る	反っくり返っ
使い古す	使い古し
けなす	けなし
措く	措い
踏みやぶる	踏みやぶっ
殺気だつ	殺気だっ
開く	開い
つけたす	つけたし
ゆき過ぎる	ゆき過ぎ
刑する	ゆき過ぎ
おます	おまし
すみつべる	すみつべ
付き添える	付き添え
うらやむ	うらやん
しばれる	しばれ
言い触らす	言い触らし
委する	言い触らし
燃やす	燃やし
おしかえす	おしかえし
はせ向う	はせ向っ
たどれる	たどれ
ねじる	ねじっ
やせおとろえる	やせおとろえ
相うつ	相うっ
いいくるめる	いいくるめ
さざめく	さざめい
連れ去る	連れ去っ
つらぬける	つらぬけ
熟す	熟し
呼び出せる	呼び出せ
書き表せる	書き表せ
削げる	削げ
つとまる	つとまっ
舐る	舐っ
涼める	涼め
隠し持てる	隠し持て
切りくずす	切りくずし
眠り込む	眠り込ん
つきもどす	つきもどし
打消せる	打消せ
激つ	激っ
さる	さっ
混ぜる	混ぜ
言い残す	言い残し
雪崩込む	雪崩込ん
登りつめる	登りつめ
銘ずる	登りつめ
ふせる	ふせ
みそなはす	みそなはし
なきしきる	なきしきっ
聞きおよぶ	聞きおよん
もどす	もどし
苅る	苅っ
押し寄せる	押し寄せ
騒ぎ出す	騒ぎ出し
思う	思う
みくらべる	みくらべ
まわりこむ	まわりこん
曲がる	曲がっ
てびかえる	てびかえ
含む	含ん
費える	費え
ずるける	ずるけ
ばたつかせる	ばたつかせ
能くする	ばたつかせ
捩じ上げる	捩じ上げ
くみかわす	くみかわし
煤ける	煤け
入りかわる	入りかわっ
見詰める	見詰め
仰せる	仰せ
ひきよせる	ひきよせ
うちかさなる	うちかさなっ
獲る	獲
差し遣わす	差し遣わし
温める	温め
吐き出せる	吐き出せ
問合せる	問合せ
満たせる	満たせ
すすり泣く	すすり泣い
ひっこもる	ひっこもっ
うなだれる	うなだれ
振り切れる	振り切れ
味わえる	味わえ
摂る	摂っ
押しだす	押しだし
ふみこめる	ふみこめ
待ち受ける	待ち受け
事足りる	事足り
とりすがる	とりすがっ
喰える	喰え
憾む	憾ん
こきまぜる	こきまぜ
済す	済し
抜連ねる	抜連ね
入れ合せる	入れ合せ
天てらす	天てらし
言い旧す	言い旧し
秋めく	秋めい
払い下げる	払い下げ
禁ずる	払い下げ
つりあう	つりあっ
あみ出す	あみ出し
封じこむ	封じこん
ひっつく	ひっつい
なのりでる	なのりで
作り上げる	作り上げ
すみこむ	すみこん
持あがる	持あがっ
吹すさぶ	吹すさん
ランクづける	ランクづけ
野次れる	野次れ
削り倒せる	削り倒せ
切あがる	切あがっ
しゃがむ	しゃがん
突っ転ばす	突っ転ばし
はしれる	はしれ
のぞける	のぞけ
取り抑える	取り抑え
奮いおこす	奮いおこし
つるせる	つるせ
やすんずる	つるせ
充たす	充たし
かけこむ	かけこん
捲ける	捲け
いたす	いたし
積重なる	積重なっ
言いだす	言いだし
燃え立つ	燃え立っ
はきかける	はきかけ
引きしぼる	引きしぼっ
経る	経
しでかす	しでかし
交ぜっ返す	交ぜっ返し
欠かす	欠かし
きらめく	きらめい
綯い交ぜる	綯い交ぜ
恥づ	恥ぢ
はき出す	はき出し
引っ提げる	引っ提げ
好く	好い
ぬく	ぬい
鋤き起す	鋤き起し
みいだす	みいだし
撃ち込む	撃ち込ん
繰広げる	繰広げ
走りでる	走りで
もうしわたす	もうしわたし
取り次ぐ	取り次い
座れる	座れ
夾める	夾め
ききすます	ききすまし
紛らわす	紛らわし
装束く	装束い
圧する	装束い
ハネ上がる	ハネ上がっ
もちさる	もちさっ
食荒らす	食荒らし
のみほす	のみほし
取り組む	取り組ん
はせる	はせ
ひっ込める	ひっ込め
突き飛ばす	突き飛ばし
当てる	当て
込み入る	込み入っ
痛み入る	痛み入っ
申しあげる	申しあげ
ではずれる	ではずれ
やすらう	やすらっ
即す	即し
ゆりうごかす	ゆりうごかし
律する	ゆりうごかし
言い募る	言い募っ
発す	発し
煮え立つ	煮え立っ
まくしたてる	まくしたて
突きだす	突きだし
言張る	言張っ
でさかる	でさかっ
ききただす	ききただし
書捨てる	書捨て
用立てる	用立て
迷い込む	迷い込ん
申し付ける	申し付け
こきつかう	こきつかっ
ほころばす	ほころばし
寝っ転がる	寝っ転がっ
わだかまる	わだかまっ
くじける	くじけ
世離れる	世離れ
しみ付く	しみ付い
すいこめる	すいこめ
剰る	剰っ
揺り動かす	揺り動かし
起る	起っ
掻い込む	掻い込ん
撥ねつける	撥ねつけ
刷り上げる	刷り上げ
恋焦がれる	恋焦がれ
覆す	覆し
脈打つ	脈打っ
包み込める	包み込め
思い煩う	思い煩っ
咎める	咎め
ひとなれる	ひとなれ
ぬぐ	ぬい
まぜあわす	まぜあわし
ぶらさげる	ぶらさげ
当る	当っ
のみこめる	のみこめ
這いまつわる	這いまつわっ
ふさぎ込む	ふさぎ込ん
つぐなう	つぐなっ
曲がれる	曲がれ
歩み寄る	歩み寄っ
はじらう	はじらっ
ちびる	ちび
かき暮れる	かき暮れ
突きぬける	突きぬけ
取立てる	取立て
己惚れる	己惚れ
噛みつく	噛みつい
打返せる	打返せ
からまる	からまっ
もとづく	もとづい
まみえる	まみえ
かんする	まみえ
擂る	擂っ
薙ぎ払う	薙ぎ払っ
高ずる	薙ぎ払っ
ゆく	ゆい
かくしもつ	かくしもっ
悟れる	悟れ
欠ける	欠け
切離す	切離し
諌む	諌ん
めもる	めもっ
食い潰す	食い潰し
組み込める	組み込め
もぐる	もぐっ
凄む	凄ん
おいぼれる	おいぼれ
小切る	小切っ
諷する	小切っ
否む	否ん
くいつなぐ	くいつない
ことたる	ことたっ
引っ立てる	引っ立て
そめだせる	そめだせ
ひっかかる	ひっかかっ
しぼりだす	しぼりだし
乗り出す	乗り出し
弛む	弛ん
とりかわせる	とりかわせ
ききあきる	ききあき
流し込める	流し込め
みせる	みせ
たずねあわせる	たずねあわせ
走り込む	走り込ん
ぶっぱなす	ぶっぱなし
おりたつ	おりたっ
供える	供え
振り替える	振り替え
笑い返す	笑い返し
憑かれる	憑かれ
とえる	とえ
めく	めい
買い越す	買い越し
むれる	むれ
でんぐり返る	でんぐり返っ
書きとる	書きとっ
振払う	振払っ
引き起こす	引き起こし
降り暮す	降り暮し
よづく	よづい
にらみあわせる	にらみあわせ
みかわす	みかわし
もちまわる	もちまわっ
節くれだつ	節くれだっ
増やせる	増やせ
のぞかせる	のぞかせ
そよがす	そよがし
退る	退っ
紛れこむ	紛れこん
繰上げる	繰上げ
くっつく	くっつい
ばらす	ばらし
かんぐる	かんぐっ
解きほぐす	解きほぐし
おどりあがる	おどりあがっ
彌次る	彌次っ
せまる	せまっ
列ねる	列ね
うつ向く	うつ向い
溶合う	溶合っ
配れる	配れ
ずりあがる	ずりあがっ
困りきる	困りきっ
謂う	謂っ
うちつれる	うちつれ
打くつろぐ	打くつろい
安んずる	打くつろい
いいあう	いいあっ
おこなう	おこなっ
示し合せる	示し合せ
しなす	しなし
たたきおこせる	たたきおこせ
向かい合う	向かい合っ
飲み回す	飲み回し
評する	飲み回し
言い返す	言い返し
立直る	立直っ
遠ざかる	遠ざかっ
くりぬける	くりぬけ
とり除く	とり除い
みかねる	みかね
びくつく	びくつい
ぎょする	びくつい
振りまわす	振りまわし
けつまずく	けつまずい
のぼりつめるる	のぼりつめる
支える	支え
にらみあう	にらみあっ
割振る	割振っ
われる	われ
行き当る	行き当っ
切りつける	切りつけ
引き起す	引き起し
売りまくれる	売りまくれ
狂する	売りまくれ
厭く	厭い
住替る	住替っ
うかれる	うかれ
折り畳める	折り畳め
しょうじいれる	しょうじいれ
あそびほうける	あそびほうけ
見分ける	見分け
慰む	慰ん
立上がる	立上がっ
あたえる	あたえ
駆けずりまわる	駆けずりまわっ
項垂れる	項垂れ
ふるまう	ふるまっ
かたぶく	かたぶい
おさえつける	おさえつけ
探し求める	探し求め
投ずる	探し求め
まげる	まげ
点てる	点て
蹴っとばす	蹴っとばし
富める	富め
片づく	片づい
作り替える	作り替え
おもいたつ	おもいたっ
祷れる	祷れ
まとめる	まとめ
だしきる	だしきっ
させる	させ
とびちがう	とびちがっ
かけよる	かけよっ
うちぬける	うちぬけ
つみかえる	つみかえ
けし飛ぶ	けし飛ん
もちかける	もちかけ
呼び戻せる	呼び戻せ
浮かぶ	浮かん
そだてる	そだて
うちこむ	うちこん
しっける	しっけ
飛び越せる	飛び越せ
くつがえす	くつがえし
かんづく	かんづい
忍び泣く	忍び泣い
いきあたる	いきあたっ
めくる	めくっ
つきだす	つきだし
責める	責め
咲におう	咲におっ
くらます	くらまし
うらなう	うらなっ
言付かる	言付かっ
バラつく	バラつい
始める	始め
引き止める	引き止め
引っかかる	引っかかっ
製する	引っかかっ
寝ぼける	寝ぼけ
尽かす	尽かし
そらんずる	尽かし
搗く	搗い
思いやる	思いやっ
引受ける	引受け
はきかえる	はきかえ
だきつく	だきつい
醸し出せる	醸し出せ
来合せる	来合せ
睨み合せる	睨み合せ
すくむ	すくん
さませる	さませ
ならせる	ならせ
燃え広がる	燃え広がっ
紛れ込む	紛れ込ん
張り足す	張り足し
垂こめる	垂こめ
漉せる	漉せ
打抜ける	打抜け
はさまる	はさまっ
差っ引く	差っ引い
炊く	炊い
とりおく	とりおい
倦む	倦ん
組み合う	組み合っ
つくばう	つくばっ
立ちはだかる	立ちはだかっ
打ち返せる	打ち返せ
繰り出す	繰り出し
ちかよせる	ちかよせ
噛む	噛ん
べんずる	噛ん
わりふれる	わりふれ
計らう	計らっ
駁する	計らっ
力づける	力づけ
書きたてる	書きたて
せおいこむ	せおいこん
乗りかかる	乗りかかっ
取り除ける	取り除け
らっしゃる	らっしゃっ
見下ろす	見下ろし
召し寄せる	召し寄せ
浮かべる	浮かべ
あばれる	あばれ
醒める	醒め
つくりあげる	つくりあげ
憎む	憎ん
こけむす	こけむし
突付ける	突付け
きざみつける	きざみつけ
すり混ぜる	すり混ぜ
こわせる	こわせ
塗りつぶす	塗りつぶし
ほける	ほけ
おもいなおせる	おもいなおせ
押しつぶせる	押しつぶせ
引きだす	引きだし
あむ	あん
はしりまわる	はしりまわっ
すくいだせる	すくいだせ
開き直る	開き直っ
打連れる	打連れ
わきばさむ	わきばさん
おもいとどまる	おもいとどまっ
だしきれる	だしきれ
下る	下っ
鯱張る	鯱張っ
覆る	覆っ
ふきでる	ふきで
とりころす	とりころし
ながしこむ	ながしこん
受けあう	受けあっ
おっぱらう	おっぱらっ
積める	積め
清める	清め
有る	有っ
到る	到っ
吸いつける	吸いつけ
取り離す	取り離し
突きあわせる	突きあわせ
貼る	貼っ
片づける	片づけ
おっことす	おっことし
掻きまぜる	掻きまぜ
がんばれる	がんばれ
撤する	がんばれ
飛び出でる	飛び出で
追い込む	追い込ん
きたえる	きたえ
取り外す	取り外し
ふみにじれる	ふみにじれ
さしひびく	さしひびい
放りだす	放りだし
ゆらす	ゆらし
けたてる	けたて
立ちあがる	立ちあがっ
くりこめる	くりこめ
さけべる	さけべ
きめこむ	きめこん
飛び越す	飛び越し
しむ	しん
だせる	だせ
霜がれる	霜がれ
だっする	霜がれ
ふやせる	ふやせ
言い誤る	言い誤っ
引っ越す	引っ越し
あるきまわれる	あるきまわれ
むしかえす	むしかえし
のりきれる	のりきれ
打立てる	打立て
合す	合し
とりのぼせる	とりのぼせ
やり直せる	やり直せ
務まる	務まっ
炊ける	炊け
かう	かっ
ぬげる	ぬげ
数えたてる	数えたて
きりすてる	きりすて
見出す	見出し
うえつける	うえつけ
くちごもる	くちごもっ
こう	こっ
読みかける	読みかけ
おだてる	おだて
とじこむ	とじこん
ゆう	ゆっ
綴じる	綴じ
悦に入る	悦に入っ
せせら笑う	せせら笑っ
申し上げる	申し上げ
寝過ごす	寝過ごし
作りだす	作りだし
うちとれる	うちとれ
たしかめる	たしかめ
なづける	なづけ
あっする	なづけ
きわだつ	きわだっ
打合わす	打合わし
けんする	打合わし
そい遂げる	そい遂げ
推し移る	推し移っ
擦れあう	擦れあっ
相成る	相成っ
口走る	口走っ
為損なう	為損なっ
変わる	変わっ
抑える	抑え
継ぎ足せる	継ぎ足せ
振向ける	振向け
溶かせる	溶かせ
打ちつける	打ちつけ
煤ばむ	煤ばん
よろめく	よろめい
見切れる	見切れ
とり上げる	とり上げ
虐げる	虐げ
おいもとめる	おいもとめ
燻らす	燻らし
立ち直る	立ち直っ
ふりはらう	ふりはらっ
すくみあがる	すくみあがっ
とりあわせる	とりあわせ
突っきる	突っきっ
誘く	誘い
漬ける	漬け
そわる	そわっ
つみたてる	つみたて
はかどる	はかどっ
萌す	萌し
きりとる	きりとっ
あやまらす	あやまらし
乾く	乾い
打砕ける	打砕け
たのみこめる	たのみこめ
並び立てる	並び立て
痛む	痛ん
冒す	冒し
買いたたく	買いたたい
選びだす	選びだし
渡り歩く	渡り歩い
張り切れる	張り切れ
爪繰る	爪繰っ
取りのける	取りのけ
切放す	切放し
いつくしむ	いつくしん
ゆきとどく	ゆきとどい
ぐちる	ぐちっ
耳だつ	耳だっ
またせる	またせ
さがしあてる	さがしあて
成り変わる	成り変わっ
待たす	待たし
みはる	みはっ
そめつける	そめつけ
取り仕切る	取り仕切っ
呪う	呪っ
とりよせる	とりよせ
さそいだせる	さそいだせ
すいよせる	すいよせ
汲みだす	汲みだし
立て直せる	立て直せ
うごける	うごけ
うずまる	うずまっ
しらける	しらけ
零れる	零れ
くける	くけ
けずる	けずっ
おしつぶせる	おしつぶせ
明け暮れる	明け暮れ
おどりあかす	おどりあかし
勇み立つ	勇み立っ
ふるえ上がる	ふるえ上がっ
塞げる	塞げ
かすめる	かすめ
乗りこなせる	乗りこなせ
抉る	抉っ
差し上げる	差し上げ
行きあたる	行きあたっ
薄らぐ	薄らい
救ける	救け
きりそろえる	きりそろえ
ぬらつく	ぬらつい
けどる	けどっ
成りすます	成りすまし
移す	移し
推せる	推せ
当て嵌る	当て嵌っ
はり合う	はり合っ
馴れあう	馴れあっ
繰越す	繰越し
刈り取る	刈り取っ
ぬりたくる	ぬりたくっ
見霽かす	見霽かし
断ち切る	断ち切っ
捲したてる	捲したて
まとめあげる	まとめあげ
うちみる	うちみ
添わせる	添わせ
釣上がる	釣上がっ
すみつぶ	すみつん
こぎつく	こぎつい
涙す	涙し
待ち合わせる	待ち合わせ
くみだす	くみだし
貼れる	貼れ
願える	願え
詰め寄る	詰め寄っ
ゆき着く	ゆき着い
属す	属し
通える	通え
焼き切る	焼き切っ
干上がる	干上がっ
縫い合わす	縫い合わし
かたりあう	かたりあっ
しおたれる	しおたれ
断ずる	しおたれ
うきあしだつ	うきあしだっ
そぼつ	そぼっ
おしひろめる	おしひろめ
追付く	追付い
急き込む	急き込ん
射すくめる	射すくめ
話しこむ	話しこん
うらがれる	うらがれ
煮えくり返る	煮えくり返っ
組立てる	組立て
煌む	煌ん
おもいかえす	おもいかえし
捧げる	捧げ
すく	すい
会う	会っ
はんする	会っ
つかみあう	つかみあっ
はらいだせる	はらいだせ
いきおいづく	いきおいづい
剪む	剪ん
泣きじゃくる	泣きじゃくっ
とびまわれる	とびまわれ
押し開く	押し開い
くだける	くだけ
そめる	そめ
上げる	上げ
溯る	溯っ
長らえる	長らえ
ちらかる	ちらかっ
相継ぐ	相継い
引越す	引越し
ふりさけみる	ふりさけみ
ちらつく	ちらつい
透る	透っ
ほお張る	ほお張っ
干割れる	干割れ
骨張る	骨張っ
打ち破れる	打ち破れ
こする	打ち破れ
尋ね合せる	尋ね合せ
成り代わる	成り代わっ
まがれる	まがれ
とりくずす	とりくずし
揺るぐ	揺るい
略せる	略せ
かまえる	かまえ
組み伏せる	組み伏せ
具する	組み伏せ
傾く	傾い
生き残る	生き残っ
のし上がれる	のし上がれ
命ずる	のし上がれ
よろこぶ	よろこん
狩る	狩っ
繋がる	繋がっ
すぼむ	すぼん
ねらいうてる	ねらいうて
さわがす	さわがし
竦める	竦め
そぼ降る	そぼ降っ
うりこめる	うりこめ
負う	負う
くすぶる	くすぶっ
みなれる	みなれ
知り抜く	知り抜い
とりまく	とりまい
こころざす	こころざし
吹雪く	吹雪い
用だつ	用だっ
もどれる	もどれ
ころげこむ	ころげこん
くいとめる	くいとめ
かんれんづける	かんれんづけ
曲る	曲っ
出会す	出会し
透す	透し
涙する	透し
そうなる	そうなっ
生き返る	生き返っ
損ずる	生き返っ
鋏む	鋏ん
軋る	軋っ
おじゃる	おじゃっ
やって退ける	やって退け
さらす	さらし
いんしょうづける	いんしょうづけ
いからせる	いからせ
似せる	似せ
立ち代る	立ち代っ
みやぶる	みやぶっ
まぎらす	まぎらし
ささやきあう	ささやきあっ
身じろぐ	身じろい
しりぞく	しりぞい
おきだせる	おきだせ
記す	記し
攻め落とせる	攻め落とせ
そそぎいれる	そそぎいれ
透き通る	透き通っ
かいこむ	かいこん
みせかける	みせかけ
片付く	片付い
釣上げる	釣上げ
のける	のけ
おもいしらせる	おもいしらせ
やせ細る	やせ細っ
理解し合える	理解し合え
ていぎづける	ていぎづけ
つなぎとめる	つなぎとめ
残せる	残せ
突放す	突放し
請する	突放し
落とせる	落とせ
縮らす	縮らし
うつ伏す	うつ伏し
絶え果てる	絶え果て
起きあがれる	起きあがれ
まつれる	まつれ
でる	で
力む	力ん
ダブる	ダブっ
一皮むける	一皮むけ
糺す	糺し
抜きだす	抜きだし
逃げ切る	逃げ切っ
すべれる	すべれ
突っ撥ねる	突っ撥ね
秀でる	秀で
つけ狙う	つけ狙っ
抱込む	抱込ん
きっする	抱込ん
泣かせる	泣かせ
打ち据える	打ち据え
酔潰れる	酔潰れ
捜し出す	捜し出し
たたす	たたし
くるめく	くるめい
充つ	充っ
巫山戯る	巫山戯
暴く	暴い
蹴上げる	蹴上げ
咲き揃う	咲き揃っ
そぐう	そぐっ
捏ち上げる	捏ち上げ
躍り上がる	躍り上がっ
乗りかえる	乗りかえ
約める	約め
読み取れる	読み取れ
漂わす	漂わし
あせする	漂わし
瞑する	漂わし
けおとせる	けおとせ
めぐる	めぐっ
きりはなせる	きりはなせ
差替える	差替え
もちこせる	もちこせ
打ち払う	打ち払っ
たえしのべる	たえしのべ
坐り込む	坐り込ん
読みふける	読みふけっ
かじける	かじけ
聞入れる	聞入れ
呻く	呻い
けんしきばる	けんしきばっ
書き込む	書き込ん
仄めく	仄めい
滲みる	滲み
言える	言え
解き離す	解き離し
口説き落とす	口説き落とし
引回す	引回し
買い取れる	買い取れ
出し抜く	出し抜い
めんずる	出し抜い
立迷う	立迷っ
いいはなつ	いいはなっ
すかす	すかし
やくだつ	やくだっ
消え去る	消え去っ
待ちこがれる	待ちこがれ
長びく	長びい
しぼりとる	しぼりとっ
斎う	斎っ
脂下がる	脂下がっ
かきしるす	かきしるし
知ろし食す	知ろし食し
やきはらう	やきはらっ
めぐむ	めぐん
働かす	働かし
手間どる	手間どっ
呟く	呟い
投げだす	投げだし
かぶる	かぶっ
くりゃる	くりゃっ
凍る	凍っ
書き出す	書き出し
喋る	喋っ
へいする	喋っ
言い表す	言い表し
ふきこぼれる	ふきこぼれ
疵付ける	疵付け
はねあげる	はねあげ
吹飛ばす	吹飛ばし
有りふれる	有りふれ
行き詰る	行き詰っ
りきむ	りきん
おもいとまる	おもいとまっ
にたつ	にたっ
追っ掛ける	追っ掛け
しめる	しめっ
侍る	侍っ
しおる	しおっ
へるる	へる
攻め立てる	攻め立て
ついやす	ついやし
づく	づい
説き付ける	説き付け
振り出す	振り出し
おどりこむ	おどりこん
吟ずる	おどりこん
篭める	篭め
近寄れる	近寄れ
きばれる	きばれ
すみきる	すみきっ
訪ねる	訪ね
そわせる	そわせ
しのばせる	しのばせ
接ぐ	接い
たぐる	たぐっ
せぎる	せぎっ
耐える	耐え
よりあう	よりあっ
あいてどる	あいてどっ
攻寄せる	攻寄せ
棚びく	棚びい
うながす	うながし
射止める	射止め
担ぐ	担い
よびたてる	よびたて
落ち着ける	落ち着け
吊るせる	吊るせ
広める	広め
うらがえす	うらがえし
ねむる	ねむっ
ふんぞり返る	ふんぞり返っ
骨折る	骨折っ
托す	托し
どく	どい
さんじる	さんじ
撃ち取る	撃ち取っ
取りあつめる	取りあつめ
並み居る	並み居
集める	集め
給わる	給わっ
逢える	逢え
端折る	端折っ
たちわる	たちわっ
取崩す	取崩し
あるきはじめる	あるきはじめ
ひきしめる	ひきしめ
かきなす	かきなし
決めつける	決めつけ
くみいれる	くみいれ
はげる	はげ
めぐまれる	めぐまれ
為る	為っ
強がる	強がっ
鳴らせる	鳴らせ
舁く	舁い
かきくだす	かきくだし
浮かれだす	浮かれだし
達す	達し
つるむ	つるん
詰め切る	詰め切っ
訳する	詰め切っ
淀む	淀ん
はなしあう	はなしあっ
かっぱらう	かっぱらっ
聞き出す	聞き出し
持ち堪える	持ち堪え
たばさむ	たばさん
切り落とせる	切り落とせ
散らかる	散らかっ
載っける	載っけ
笑い飛ばす	笑い飛ばし
かいする	笑い飛ばし
かきならす	かきならし
吹こぼれる	吹こぼれ
考え出せる	考え出せ
よくする	考え出せ
裁く	裁い
ふみやぶる	ふみやぶっ
組み付く	組み付い
繰り広げる	繰り広げ
きりつめる	きりつめ
翳す	翳し
閊える	閊え
さす	さし
ききかじる	ききかじっ
欹てる	欹て
投棄てる	投棄て
かたる	かたっ
馨る	馨っ
おほとのごもる	おほとのごもっ
かち取れる	かち取れ
存える	存え
さまよえる	さまよえ
切りとる	切りとっ
ゆがく	ゆがい
すれる	すれ
徹する	すれ
燃え付く	燃え付い
かどばる	かどばっ
まいる	まいっ
結び付く	結び付い
気負い立つ	気負い立っ
組みつける	組みつけ
代われる	代われ
舞える	舞え
しみ入る	しみ入っ
つきたてる	つきたて
入りこむ	入りこん
包む	包ん
咬める	咬め
飾りつける	飾りつけ
はらだてる	はらだて
あえぐ	あえい
鳴り渡る	鳴り渡っ
執り行える	執り行え
忍ばす	忍ばし
召捕る	召捕っ
突き通す	突き通し