引き込む	引き込み
すきかえす	すきかえし
看取る	看取り
睦む	睦み
きこす	きこし
つける	つけ
封切る	封切り
逃げまどう	逃げまどい
さしだす	さしだし
わりきる	わりきり
飛び抜ける	飛び抜け
書き直せる	書き直せ
ひしめきあう	ひしめきあい
乗り組む	乗り組み
引き戻す	引き戻し
持てる	持て
立あう	立あい
基づく	基づき
弓引く	弓引き
ぶち壊す	ぶち壊し
わきあがる	わきあがり
語りつぐ	語りつぎ
問掛ける	問掛け
狙われる	狙われ
埋めあわす	埋めあわし
喚ぶ	喚び
しりぞける	しりぞけ
こす	こし
大人ぶる	大人ぶり
居る	居
ねじふせる	ねじふせ
しゃくりあげる	しゃくりあげ
にごせる	にごせ
較べる	較べ
罷り越す	罷り越し
射せる	射せ
描きだす	描きだし
けっとばす	けっとばし
満つ	満ち
明け放す	明け放し
返り咲ける	返り咲け
誘い合わせる	誘い合わせ
つきつける	つきつけ
埋る	埋り
かき乱す	かき乱し
だまし取る	だまし取り
配り歩く	配り歩き
抱き込む	抱き込み
めしあがる	めしあがり
つうずる	めしあがり
ずば抜ける	ずば抜け
泣きぬれる	泣きぬれ
くしけずる	くしけずり
つみとる	つみとり
割戻す	割戻し
さだまる	さだまり
睨み合う	睨み合い
かわれる	かわれ
そむ	そみ
後らす	後らし
ごわする	後らし
迷わす	迷わし
泥む	泥み
仕出す	仕出し
おくする	仕出し
逆らえる	逆らえ
居あわせる	居あわせ
苛立つ	苛立ち
堕ちる	堕ち
慮る	慮り
怖じ気立つ	怖じ気立ち
きずく	きずき
とりあつかえる	とりあつかえ
扱き雑ぜる	扱き雑ぜ
はじける	はじけ
ふしおがむ	ふしおがみ
黙る	黙り
のめす	のめし
危ぶむ	危ぶみ
いりびたる	いりびたり
洗い流す	洗い流し
呉れる	呉れ
定まる	定まり
ばかせる	ばかせ
語りあう	語りあい
敬える	敬え
食らわせる	食らわせ
わたる	わたり
いいまわす	いいまわし
打ち抜ける	打ち抜け
ヒネる	ヒネり
転げでる	転げで
打ちのめす	打ちのめし
思い合せる	思い合せ
萎れる	萎れ
総べる	総べ
鳴らす	鳴らし
貸出す	貸出し
差し換える	差し換え
もぐり込む	もぐり込み
睨む	睨み
打ちつづく	打ちつづき
おいかける	おいかけ
ふりつもる	ふりつもり
かわく	かわき
はしりだせる	はしりだせ
省みる	省み
出合う	出合い
といかえす	といかえし
かぶさる	かぶさり
こづく	こづき
這う	這い
縫う	縫い
降込む	降込み
はめこむ	はめこみ
すみわたる	すみわたり
いふ	いひ
思へる	思へ
刷りこむ	刷りこみ
くらわせる	くらわせ
ゆすぶる	ゆすぶり
触れ合える	触れ合え
はねあがる	はねあがり
察する	はねあがり
ころげおちる	ころげおち
すぐす	すぐし
押しかえす	押しかえし
ただよわす	ただよわし
結論づける	結論づけ
しばり上げる	しばり上げ
欠く	欠き
乗り継ぐ	乗り継ぎ
ひめる	ひめ
むせびなく	むせびなき
やじる	やじり
けっする	やじり
みかぎる	みかぎり
わりあてる	わりあて
かき立てる	かき立て
あわてふためく	あわてふためき
吸付ける	吸付け
ごねる	ごね
ほざく	ほざき
せめぐ	せめぎ
食さがる	食さがり
追い打つ	追い打ち
休まれる	休まれ
動じる	動じ
染まる	染まり
立ち迷う	立ち迷い
染め上げる	染め上げ
たちむかう	たちむかい
はかれる	はかれ
巻き付く	巻き付き
光らせる	光らせ
挫ける	挫け
燃え移る	燃え移り
鈍する	燃え移り
ふくれあがる	ふくれあがり
いいそこなう	いいそこない
ぶんなげる	ぶんなげ
生い立つ	生い立ち
ごたつく	ごたつき
うろたえる	うろたえ
燃える	燃え
はむかう	はむかい
推する	はむかい
取逃す	取逃し
乗り通す	乗り通し
よそおう	よそおい
さむけだつ	さむけだち
こぼれおちる	こぼれおち
かいつくす	かいつくし
祀る	祀り
痛め付ける	痛め付け
持ちきる	持ちきり
疑える	疑え
掻き曇る	掻き曇り
返り咲く	返り咲き
うばえる	うばえ
願い出る	願い出
落ち延びる	落ち延び
辱める	辱め
おったてる	おったて
編み出す	編み出し
呼び止める	呼び止め
澄みきる	澄みきり
踏みきる	踏みきり
寄り付く	寄り付き
だきこむ	だきこみ
轟かせる	轟かせ
仰ける	仰け
毒する	仰け
かかえる	かかえ
ほふる	ほふり
捻る	捻り
触り合う	触り合い
角張る	角張り
悦ぶ	悦び
いちづける	いちづけ
仕込める	仕込め
くいこめる	くいこめ
組みこむ	組みこみ
おそう	おそい
あつかえる	あつかえ
嘱する	あつかえ
なげきくらす	なげきくらし
けやぶる	けやぶり
つくりなおす	つくりなおし
まるめる	まるめ
しびれる	しびれ
溶けあう	溶けあい
突き合わす	突き合わし
はぐる	はぐり
頼む	頼み
ゆがむ	ゆがみ
はみ出る	はみ出
あおむ	あおみ
玩ぶ	玩び
裁てる	裁て
ちりいそぐ	ちりいそぎ
棚引く	棚引き
引き下がる	引き下がり
てぐすねひく	てぐすねひき
括れる	括れ
引き締まる	引き締まり
参れる	参れ
立ちならぶ	立ちならび
そらうそぶく	そらうそぶき
羨む	羨み
ふきかえす	ふきかえし
はぐ	はぎ
みはらす	みはらし
けおされる	けおされ
洒落れる	洒落れ
おもいやる	おもいやり
ふとる	ふとり
ちぢらす	ちぢらし
うちまくる	うちまくり
明け残る	明け残り
ひきわたす	ひきわたし
ならびたてる	ならびたて
書き出せる	書き出せ
聞きつける	聞きつけ
研ぐ	研ぎ
つきはなせる	つきはなせ
萌む	萌み
ませる	ませ
折り込める	折り込め
ふり入れる	ふり入れ
押し分ける	押し分け
見慣れる	見慣れ
跳ねのける	跳ねのけ
染む	染み
訃ぐ	訃ぎ
拒める	拒め
貫き通せる	貫き通せ
くねる	くねり
ふりやむ	ふりやみ
ゆらぐ	ゆらぎ
読み切れる	読み切れ
ようだつ	ようだち
またす	またし
畳み込める	畳み込め
掛け合える	掛け合え
誘い出す	誘い出し
のりまわす	のりまわし
ほぐせる	ほぐせ
ぜっする	ほぐせ
蔵する	ほぐせ
食い違う	食い違い
印す	印し
手古摺る	手古摺り
まびける	まびけ
わりこむ	わりこみ
しくむ	しくみ
怪しむ	怪しみ
締めつける	締めつけ
受ける	受け
立ちどまる	立ちどまり
はいりきる	はいりきり
証す	証し
漕げる	漕げ
捜しまわる	捜しまわり
ゆきわたる	ゆきわたり
相入れる	相入れ
奏す	奏し
悦べる	悦べ
料る	料り
吸い寄せる	吸い寄せ
せぐくまる	せぐくまり
よえる	よえ
阻める	阻め
くるわす	くるわし
わすれさる	わすれさり
隠る	隠り
おもいのこす	おもいのこし
探し出せる	探し出せ
成さがる	成さがり
およげる	およげ
引き換える	引き換え
引き離せる	引き離せ
さえわたる	さえわたり
抱き起こせる	抱き起こせ
むち打つ	むち打ち
抗う	抗い
しょげかえる	しょげかえり
取り調べる	取り調べ
捕われる	捕われ
なる	なり
ふししずむ	ふししずみ
寂する	ふししずみ
取り持つ	取り持ち
おもいあたる	おもいあたり
語りかける	語りかけ
引っ越せる	引っ越せ
おもいなす	おもいなし
けす	けし
ぎらつく	ぎらつき
きりくむ	きりくみ
刻める	刻め
世ばなれる	世ばなれ
ひっくくる	ひっくくり
そぼぬれる	そぼぬれ
教え諭す	教え諭し
織り込める	織り込め
仰け反る	仰け反り
けがれる	けがれ
聞漏らす	聞漏らし
あざける	あざけり
飼う	飼い
引っ括める	引っ括め
ひょうげる	ひょうげ
延べる	延べ
かけ隔てる	かけ隔て
播く	播き
かすめ取る	かすめ取り
くだす	くだし
角立つ	角立ち
ほこる	ほこり
芽ぶく	芽ぶき
疲れはてる	疲れはて
くわわる	くわわり
追い付く	追い付き
差し上る	差し上り
踏ん切る	踏ん切り
ぬきはなつ	ぬきはなち
言い付ける	言い付け
そよ吹く	そよ吹き
ぼる	ぼり
蹲る	蹲り
繰下げる	繰下げ
率いる	率い
化かす	化かし
労する	化かし
持ちかえれる	持ちかえれ
つぎたす	つぎたし
住成す	住成し
締切る	締切り
挙がる	挙がり
突っぱる	突っぱり
出歩ける	出歩け
せる	せり
躙り寄る	躙り寄り
排す	排し
いさよう	いさよい
飲み潰す	飲み潰し
迎える	迎え
参らす	参らし
張りつく	張りつき
にげまわる	にげまわり
押掛ける	押掛け
掻き集める	掻き集め
住みつぶ	住みつび
妬む	妬み
愁える	愁え
はりつめる	はりつめ
追い立てる	追い立て
そりかえる	そりかえり
演ずる	そりかえり
取り立てる	取り立て
縁どる	縁どり
侍れる	侍れ
飛び跳ねる	飛び跳ね
つかいこむ	つかいこみ
忌む	忌み
ひとかわむける	ひとかわむけ
くりよせる	くりよせ
掛け離れる	掛け離れ
立替える	立替え
蹴落す	蹴落し
寝そべる	寝そべり
ひいでる	ひいで
ほりつける	ほりつけ
拾う	拾い
もうしかねる	もうしかね
明るむ	明るみ
張詰める	張詰め
吸いこむ	吸いこみ
流れ着く	流れ着き
降り懸る	降り懸り
植わる	植わり
追いやれる	追いやれ
すり付ける	すり付け
乗りつける	乗りつけ
飛あがる	飛あがり
いきおいづける	いきおいづけ
もどく	もどき
うつむける	うつむけ
たもちあう	たもちあい
かっきづく	かっきづき
取れる	取れ
語り合う	語り合い
討ち果たす	討ち果たし
まわす	まわし
たちあがれる	たちあがれ
取り毀す	取り毀し
跡絶える	跡絶え
裏がえる	裏がえり
解明かす	解明かし
加え持つ	加え持ち
あてこめる	あてこめ
せき立てる	せき立て
くちる	くち
きがえる	きがえ
輝り返す	輝り返し
じれる	じれ
やっかむ	やっかみ
あそびまわれる	あそびまわれ
書入れる	書入れ
のり出す	のり出し
あてはまる	あてはまり
ふえる	ふえ
折れ曲がる	折れ曲がり
惜しむ	惜しみ
かきおくる	かきおくり
つきさせる	つきさせ
ひりつく	ひりつき
うかす	うかし
薫ずる	うかし
めしあげる	めしあげ
ききかえす	ききかえし
焼け出す	焼け出し
掛ける	掛け
置忘れる	置忘れ
筋ばる	筋ばり
浮腫む	浮腫み
散らばる	散らばり
与する	散らばり
負かる	負かり
願える	願え
重なる	重なり
弑する	重なり
つんざく	つんざき
読通す	読通し
まるめこむ	まるめこみ
息張る	息張り
きおう	きおい
直る	直り
回り込む	回り込み
つんのめる	つんのめり
おいしげる	おいしげり
屈む	屈み
孵す	孵し
取散らす	取散らし
つぎあわせる	つぎあわせ
まちあわせる	まちあわせ
思い起す	思い起し
決める	決め
漉く	漉き
引きおこす	引きおこし
貧する	引きおこし
まるまる	まるまり
うまれかわる	うまれかわり
さきでる	さきで
突き合せる	突き合せ
しわめる	しわめ
出し切れる	出し切れ
居直る	居直り
よびだせる	よびだせ
なんなんとする	よびだせ
出会う	出会い
叶える	叶え
かいくぐる	かいくぐり
遵う	遵い
混ざる	混ざり
ずり落ちる	ずり落ち
挙げる	挙げ
減る	減り
はきちがえる	はきちがえ
解け合う	解け合い
せぐりあげる	せぐりあげ
みまわる	みまわり
飲み込める	飲み込め
拭き込む	拭き込み
田舎びる	田舎び
かもしだせる	かもしだせ
行なう	行ない
うるおす	うるおし
とがらす	とがらし
来あわす	来あわし
みせつける	みせつけ
かたよせる	かたよせ
拒む	拒み
閉じ込もる	閉じ込もり
かりとる	かりとり
おびやかす	おびやかし
比す	比し
仕損じる	仕損じ
打切れる	打切れ
息巻く	息巻き
追っ払う	追っ払い
扠置く	扠置き
飛びのる	飛びのり
さかのぼる	さかのぼり
休らう	休らい
生れかわる	生れかわり
かきたてる	かきたて
くっつける	くっつけ
寝とぼける	寝とぼけ
擂れる	擂れ
瀬切る	瀬切り
試せる	試せ
託す	託し
洩る	洩り
向ける	向け
ぬすめる	ぬすめ
つれそう	つれそい
もりたてる	もりたて
ふみこたえる	ふみこたえ
とりあつめる	とりあつめ
哮る	哮り
見初める	見初め
突っ返す	突っ返し
立ち退ける	立ち退け
寝ころぶ	寝ころび
試す	試し
だきあわせる	だきあわせ
てっする	だきあわせ
しのげる	しのげ
チラつく	チラつき
書抜く	書抜き
後ずさる	後ずさり
起す	起し
さえずる	さえずり
裂く	裂き
そこなう	そこない
みいる	みいり
突ぷす	突ぷし
はじき出す	はじき出し
うめこむ	うめこみ
出ばる	出ばり
乗り切れる	乗り切れ
ふくせる	ふくせ
かいもどす	かいもどし
仕舞う	仕舞い
かける	かけ
往ぬ	往に
聞える	聞え
読替える	読替え
はこびこむ	はこびこみ
暇どる	暇どり
頂ける	頂け
競り落す	競り落し
立込む	立込み
晴あがる	晴あがり
費す	費し
けたおす	けたおし
いいのこす	いいのこし
きりだす	きりだし
とりくずせる	とりくずせ
くいあう	くいあい
ほそめる	ほそめ
切取る	切取り
吐く	吐き
のろける	のろけ
しろしめす	しろしめし
じする	しろしめし
具える	具え
取りこむ	取りこみ
渡せる	渡せ
ほめそやす	ほめそやし
彩れる	彩れ
むくむ	むくみ
与る	与り
そろえる	そろえ
ねがう	ねがい
嵌る	嵌り
沖する	嵌り
持する	嵌り
もがく	もがき
おれ込む	おれ込み
運び出す	運び出し
いがみあう	いがみあい
はさみ切る	はさみ切り
ふんだくる	ふんだくり
まなべる	まなべ
にごる	にごり
すきこのむ	すきこのみ
座す	座し
頑ばる	頑ばり
ずぬける	ずぬけ
縛りつける	縛りつけ
くみ取る	くみ取り
履く	履き
とりおさえる	とりおさえ
話し込む	話し込み
駆立てる	駆立て
のりつぐ	のりつぎ
あらす	あらし
はきだす	はきだし
いたむ	いたみ
売りはらう	売りはらい
ひきかえる	ひきかえ
ふりしきる	ふりしきり
やすまる	やすまり
きたす	きたし
ようする	きたし
かきしるせる	かきしるせ
はせむかう	はせむかい
近寄せる	近寄せ
錬れる	錬れ
挙る	挙り
差回す	差回し
鬱ぐ	鬱ぎ
含まる	含まり
遷す	遷し
練る	練り
寛げる	寛げ
ころがりこむ	ころがりこみ
汲み取れる	汲み取れ
仕掛ける	仕掛け
めさる	めさり
はいる	はいり
造る	造り
抱留める	抱留め
啜り上げる	啜り上げ
堕す	堕し
はやまる	はやまり
入りびたる	入りびたり
つったてる	つったて
きわだたす	きわだたし
みせびらかす	みせびらかし
めあわせる	めあわせ
あやしむ	あやしみ
乞う	乞い
あざなう	あざない
切り回す	切り回し
ながれでる	ながれで
伴う	伴い
宛てがう	宛てがい
取り直す	取り直し
摘む	摘み
見て取る	見て取り
ひっかつぐ	ひっかつぎ
引具する	ひっかつぎ
引き伸ばせる	引き伸ばせ
考えつく	考えつき
しわる	しわり
揺する	揺すり
みちたりる	みちたり
聞返す	聞返し
作る	作り
くやむ	くやみ
ふり向く	ふり向き
手折る	手折り
ぬえる	ぬえ
残れる	残れ
下さる	下さい
てんずる	下さい
やみほうける	やみほうけ
駆け込める	駆け込め
やしなう	やしない
冷める	冷め
むかえいれる	むかえいれ
慰する	むかえいれ
あきあきする	むかえいれ
勤まる	勤まり
移れる	移れ
吹掛ける	吹掛け
盛上げる	盛上げ
落し入れる	落し入れ
はせ着ける	はせ着け
しこめる	しこめ
きりまくる	きりまくり
引ける	引け
凌ぐ	凌ぎ
張り合える	張り合え
みまかる	みまかり
言いなす	言いなし
説おこす	説おこし
くっする	説おこし
懸かる	懸かり
ふさげる	ふさげ
いそがす	いそがし
唄える	唄え
もる	もり
こびりつく	こびりつき
引換える	引換え
はじめる	はじめ
よろこびあう	よろこびあい
すみなす	すみなし
ともす	ともし
食散らす	食散らし
つみのこす	つみのこし
伺う	伺い
導く	導き
たたみこむ	たたみこみ
寛ぐ	寛ぎ
折り畳む	折り畳み
はらいこむ	はらいこみ
しゃがれる	しゃがれ
垣間みる	垣間み
みすごせる	みすごせ
差し昇る	差し昇り
うごかす	うごかし
黒みがかる	黒みがかり
垂れこめる	垂れこめ
持上げる	持上げ
立働く	立働き
あみだす	あみだし
つきのける	つきのけ
返す	返し
整える	整え
食み出でる	食み出で
ききおよぶ	ききおよび
進ぜる	進ぜ
かなぐりすてる	かなぐりすて
送り込む	送り込み
かみ締める	かみ締め
振り乱す	振り乱し
見失う	見失い
彷徨く	彷徨き
離れる	離れ
張り飛ばす	張り飛ばし
白茶ける	白茶け
はちきれる	はちきれ
漬かる	漬かり
振乱す	振乱し
筋張る	筋張り
わめく	わめき
張りきる	張りきり
差す	差し
つきとばす	つきとばし
賦する	つきとばし
そりくり返る	そりくり返り
ひわれる	ひわれ
押さえつける	押さえつけ
振り撒く	振り撒き
切り抜く	切り抜き
舐めずる	舐めずり
振り翳す	振り翳し
連ねる	連ね
生き延びる	生き延び
まぶす	まぶし
たて込む	たて込み
ひく	ひき
鋳込む	鋳込み
滑べる	滑べり
みすごす	みすごし
感極まる	感極まり
言いくるめる	言いくるめ
いみきらう	いみきらい
刈り急ぐ	刈り急ぎ
賭す	賭し
僻する	賭し
競り合える	競り合え
泣ぬれる	泣ぬれ
みまもれる	みまもれ
怒り狂う	怒り狂い
撓める	撓め
つがえる	つがえ
待ち合わす	待ち合わし
盗む	盗み
側める	側め
先細る	先細り
うけつぐ	うけつぎ
探れる	探れ
鼻じろむ	鼻じろみ
挟む	挟み
いこむ	いこみ
たのしむ	たのしみ
うりまくれる	うりまくれ
混ぜかえす	混ぜかえし
取り出す	取り出し
よびとめる	よびとめ
抜き出す	抜き出し
跨る	跨り
ほかなる	ほかなり
あり合せる	あり合せ
なきこむ	なきこみ
つけ込む	つけ込み
競り上げる	競り上げ
言い繕う	言い繕い
繙く	繙き
推し進める	推し進め
価する	推し進め
もりあわせる	もりあわせ
いじる	いじり
釣り出す	釣り出し
やっつける	やっつけ
ひり出す	ひり出し
言い逃れる	言い逃れ
とびだせる	とびだせ
かえす	かえし
しょう	しょい
いじける	いじけ
もたげる	もたげ
出ぱる	出ぱり
こう	こい
騙かす	騙かし
苦しめる	苦しめ
やみつく	やみつき
打出せる	打出せ
ひっ掻く	ひっ掻き
えんづく	えんづき
窪める	窪め
ちまよう	ちまよい
すぎる	すぎ
転がせる	転がせ
たちいる	たちいり
着飾れる	着飾れ
つきしたがう	つきしたがい
ふりこむ	ふりこみ
書き分ける	書き分け
浴する	書き分け
編出す	編出し
飛込む	飛込み
驚き入る	驚き入り
笑み割れる	笑み割れ
とりはからえる	とりはからえ
掬ぶ	掬び
暗ます	暗まし
茹でる	茹で
取り戻せる	取り戻せ
病みつく	病みつき
ネグる	ネグり
卷く	卷き
はこぶ	はこび
せんじる	せんじ
祈れる	祈れ
命じる	命じ
喜ぶ	喜び
みしる	みしり
爛れる	爛れ
囀る	囀り
さきだつ	さきだち
薨ずる	さきだち
見兼ねる	見兼ね
あいともなう	あいともない
小突く	小突き
おりあげる	おりあげ
きらめむ	きらめみ
掻き起す	掻き起し
思いかえす	思いかえし
やりかえせる	やりかえせ
ちばしる	ちばしり
かみわける	かみわけ
さしおく	さしおき
なれ合う	なれ合い
見かける	見かけ
おおわれる	おおわれ
かちあう	かちあい
たたき起こせる	たたき起こせ
成り済ます	成り済まし
おじけづく	おじけづき
くみ出せる	くみ出せ
なやむ	なやみ
頼み込む	頼み込み
ゆずる	ゆずり
転ずる	ゆずり
息まく	息まき
ひぞる	ひぞり
青む	青み
づける	づけ
ひろう	ひろい
ござる	ござい
蹴出す	蹴出し
ふする	蹴出し
きりはらう	きりはらい
遣いこむ	遣いこみ
もたせ掛ける	もたせ掛け
遣り込める	遣り込め
なかす	なかし
ちえづく	ちえづき
混ぜ合う	混ぜ合い
噛める	噛め
煮え返る	煮え返り
飾り立てる	飾り立て
古びる	古び
とび出る	とび出
感じる	感じ
奬める	奬め
吊す	吊し
つれもどせる	つれもどせ
握れる	握れ
えり分ける	えり分け
焚き染める	焚き染め
由る	由り
あまんじる	あまんじ
振替える	振替え
産みつける	産みつけ
植え込める	植え込め
沸き起これる	沸き起これ
目覚める	目覚め
委せる	委せ
住み慣れる	住み慣れ
思ほす	思ほし
みちがえる	みちがえ
せめのぼる	せめのぼり
気どる	気どり
したしむ	したしみ
持ち合わせる	持ち合わせ
置換わる	置換わり
聞流す	聞流し
追い落とす	追い落とし
焦れ込む	焦れ込み
歌う	歌い
極める	極め
ねせる	ねせ
つづめる	つづめ
ろんずる	つづめ
書き下ろす	書き下ろし
綴れる	綴れ
かねる	かね
凍り付く	凍り付き
見損なう	見損ない
すんたる	すんたり
計る	計り
開き直れる	開き直れ
取りそろえる	取りそろえ
割り戻せる	割り戻せ
しみこむ	しみこみ
にげうせる	にげうせ
しつける	しつけ
すりまぜる	すりまぜ
とりあう	とりあい
匂わせる	匂わせ
転がり込む	転がり込み
貸切る	貸切り
縫い込む	縫い込み
ひきつづける	ひきつづけ
割りあてる	割りあて
ぼうする	割りあて
ひたす	ひたし
振り落とす	振り落とし
ひきおろす	ひきおろし
みおろせる	みおろせ
立ふさがる	立ふさがり
切付ける	切付け
目慣れる	目慣れ
ころがる	ころがり
付き従う	付き従い
はたらきかける	はたらきかけ
ちかづける	ちかづけ
立ち返る	立ち返り
むかつく	むかつき
芽生える	芽生え
侮れる	侮れ
取り去れる	取り去れ
ぶちこわす	ぶちこわし
期す	期し
伝わる	伝わり
任じる	任じ
つま先立つ	つま先立ち
うけあう	うけあい
垂れ込む	垂れ込み
勝取る	勝取り
ちからつきる	ちからつき
踏んばる	踏んばり
かちこせる	かちこせ
たがる	たがり
おく	おき
咲き乱れる	咲き乱れ
ねんじる	ねんじ
留める	留め
打ちよせる	打ちよせ
つっこめる	つっこめ
おもう	おもい
已める	已め
つちかう	つちかい
ききかえせる	ききかえせ
みやる	みやり
仇する	みやり
きょうする	みやり
むきなおる	むきなおり
突き放す	突き放し
引き立てる	引き立て
やききる	やききり
取上げる	取上げ
あばれまわる	あばれまわり
きりとれる	きりとれ
忍び込める	忍び込め
取りあつかう	取りあつかい
掻っ切る	掻っ切り
突き止める	突き止め
もえひろがる	もえひろがり
ねぼける	ねぼけ
むかいあわす	むかいあわし
捏ね返す	捏ね返し
拘わる	拘わり
遣う	遣い
たまわる	たまわり
ひっ篭る	ひっ篭り
酔いしれる	酔いしれ
とどろく	とどろき
かかわりあう	かかわりあい
カミつく	カミつき
いいきかせる	いいきかせ
隔てる	隔て
攻あぐむ	攻あぐみ
ハサむ	ハサみ
かざりたてる	かざりたて
呷る	呷り
てわたす	てわたし
取もつ	取もち
はぎとれる	はぎとれ
組替える	組替え
寝過す	寝過し
けむる	けむり
ゆらせる	ゆらせ
畏れ入る	畏れ入り
歩ける	歩け
すりつぶす	すりつぶし
踏める	踏め
臆する	踏め
踏み越える	踏み越え
けかえす	けかえし
疼く	疼き
語りこめる	語りこめ
ぬきとれる	ぬきとれ
つけ加える	つけ加え
なきさけぶ	なきさけび
くじく	くじき
名指す	名指し
しょたいじみる	しょたいじみ
焦がれる	焦がれ
会わす	会わし
坐る	坐り
入れ揚げる	入れ揚げ
舐める	舐め
うけながす	うけながし
てつだう	てつだい
慈しむ	慈しみ
握り潰す	握り潰し
たえいる	たえいり
さばける	さばけ
からみあう	からみあい
おる	おり
まきおこせる	まきおこせ
はげおちる	はげおち
よめる	よめ
かきぬける	かきぬけ
打ち捨てる	打ち捨て
みやぶれる	みやぶれ
受入れる	受入れ
掛合う	掛合い
はなしあえる	はなしあえ
迫り出す	迫り出し
すする	すすり
見極める	見極め
畳み込む	畳み込み
擦りむける	擦りむけ
脱捨てる	脱捨て
訃げる	訃げ
しずれる	しずれ
取りなす	取りなし
咲きそろう	咲きそろい
あたりちらす	あたりちらし
取り落す	取り落し
押し迫る	押し迫り
けぶる	けぶり
途絶える	途絶え
熔ける	熔け
かんがみる	かんがみ
かけへだてる	かけへだて
あかちゃける	あかちゃけ
懐く	懐き
来あわせる	来あわせ
叱りつける	叱りつけ
ながれあるく	ながれあるき
伸び悩む	伸び悩み
おえる	おえ
験する	おえ
略する	おえ
追いすがる	追いすがり
かがめる	かがめ
さうぞく	さうぞき
溶きほぐす	溶きほぐし
すりきれる	すりきれ
とりとめる	とりとめ
立ち塞がる	立ち塞がり
たくむ	たくみ
便じる	便じ
聘する	便じ
破ける	破け
行き過ぎる	行き過ぎ
うきだす	うきだし
ひくまる	ひくまり
恋い焦がれる	恋い焦がれ
糊する	恋い焦がれ
すみかわる	すみかわり
死におくれる	死におくれ
理る	理り
こと切れる	こと切れ
採りあげる	採りあげ
かけこめる	かけこめ
倍する	かけこめ
へこます	へこまし
燃えつきる	燃えつき
す	し
引っさげる	引っさげ
破る	破り
へる	へ
閉じ込める	閉じ込め
ひしぐ	ひしぎ
つかれ果てる	つかれ果て
くろめる	くろめ
たちかえる	たちかえり
かざる	かざり
酔いつぶれる	酔いつぶれ
仕あがる	仕あがり
持ち込む	持ち込み
嘆き暮す	嘆き暮し
垂れる	垂れ
あえる	あえ
篩い落す	篩い落し
いきとどく	いきとどき
付まとう	付まとい
ぶつける	ぶつけ
こみいる	こみいり
ゆずれる	ゆずれ
うらびれる	うらびれ
哮り立つ	哮り立ち
くいさがる	くいさがり
上げる	上げ
回す	回し
生れ変る	生れ変り
滅ぶ	滅び
利す	利し
ちらめく	ちらめき
伍する	ちらめき
たてかえる	たてかえ
伺ふ	伺ひ
絶つ	絶ち
透きとおる	透きとおり
布く	布き
とがる	とがり
こなれる	こなれ
とっちめる	とっちめ
ふめる	ふめ
出す	出し
おしかくす	おしかくし
こぐらかる	こぐらかり
そう	そい
突っ切る	突っ切り
締め出す	締め出し
のぞめる	のぞめ
読み破る	読み破り
弛める	弛め
仰ぐ	仰ぎ
ねじ切る	ねじ切り
迸る	迸り
かちほこる	かちほこり
有り得る	有り得
掻き消える	掻き消え
よみくだす	よみくだし
煎じつめる	煎じつめ
泣き腫らす	泣き腫らし
貶する	泣き腫らし
突飛ばす	突飛ばし
とぎれる	とぎれ
明らむ	明らみ
あさる	あさり
待ちかまえる	待ちかまえ
したがえる	したがえ
畳める	畳め
呼び戻す	呼び戻し
打上げる	打上げ
言放つ	言放ち
抱き込める	抱き込め
そめあがる	そめあがり
見繕う	見繕い
若返れる	若返れ
つかいこなす	つかいこなし
泣き沈む	泣き沈み
釈ける	釈け
跳びつく	跳びつき
きたえあげる	きたえあげ
うけとれる	うけとれ
ねじまげる	ねじまげ
割り引ける	割り引け
陥る	陥り
沸きあがる	沸きあがり
嘶える	嘶え
立ち向かえる	立ち向かえ
引き降ろせる	引き降ろせ
替る	替り
よみかえす	よみかえし
ひきちぎれる	ひきちぎれ
弔える	弔え
汗する	弔え
窪まる	窪まり
配する	窪まり
せせる	せせり
褪める	褪め
さえ返る	さえ返り
よむ	よみ
すがりつく	すがりつき
理解し合う	理解し合い
験す	験し
まく	まき
たくらむ	たくらみ
みたてる	みたて
思い浮かべる	思い浮かべ
焚きつける	焚きつけ
作れる	作れ
のびあがる	のびあがり
あいす	あいし
あらだつ	あらだち
はりきれる	はりきれ
立ち退く	立ち退き
おびき寄せる	おびき寄せ
這いずる	這いずり
手折れる	手折れ
嘉する	手折れ
剃り落とせる	剃り落とせ
候う	候い
しゃくり上げる	しゃくり上げ
貫く	貫き
葬る	葬り
語り込む	語り込み
食い荒らす	食い荒らし
取り乱す	取り乱し
参らせる	参らせ
譏る	譏り
もうでる	もうで
死する	もうで
継ぎあわせる	継ぎあわせ
悴む	悴み
住みなす	住みなし
しとる	しとり
とんがらかす	とんがらかし
交ぜ返す	交ぜ返し
立ち止る	立ち止り
押黙る	押黙り
書きあげる	書きあげ
貸し切る	貸し切り
あつらえる	あつらえ
沸く	沸き
跳上がる	跳上がり
飲込む	飲込み
つみあげる	つみあげ
徹す	徹し
まどう	まどい
引き揚げる	引き揚げ
書き付ける	書き付け
見落とす	見落とし
掻き毟る	掻き毟り
付け廻す	付け廻し
消うせる	消うせ
さがしもとめる	さがしもとめ
かけあう	かけあい
慣らせる	慣らせ
とりやめる	とりやめ
痩ける	痩け
押し隠せる	押し隠せ
架かる	架かり
さわす	さわし
こころがける	こころがけ
ぬかす	ぬかし
飢える	飢え
ながせる	ながせ
成立つ	成立ち
はなしだす	はなしだし
弱める	弱め
打返す	打返し
打ち合わす	打ち合わし
打ち切る	打ち切り
うなずく	うなずき
ふくらます	ふくらまし
吐ける	吐け
差掛ける	差掛け
打ち返す	打ち返し
打払う	打払い
思う	思い
汲み乾す	汲み乾し
はね上がる	はね上がり
さんけづく	さんけづき
よこたわる	よこたわり
寝取る	寝取り
つっかえす	つっかえし
あびる	あび
冀う	冀い
刺さる	刺さり
ふきつける	ふきつけ
はせつける	はせつけ
乗り継げる	乗り継げ
改める	改め
吹き荒ぶ	吹き荒び
遠ざける	遠ざけ
輝る	輝り
懸隔てる	懸隔て
たちきる	たちきり
吹き飛ばせる	吹き飛ばせ
煩い付く	煩い付き
思い残す	思い残し
そっくり返る	そっくり返り
すておく	すておき
召しかかえる	召しかかえ
取り繕う	取り繕い
呆れかえる	呆れかえり
しみ込む	しみ込み
取消す	取消し
くさる	くさり
ほのめく	ほのめき
聞分ける	聞分け
たもちあえる	たもちあえ
ゆく	ゆき
切れ込む	切れ込み
ねれる	ねれ
むせる	むせ
たかぶる	たかぶり
ほどこせる	ほどこせ
かかり合う	かかり合い
染み込む	染み込み
積み残す	積み残し
食える	食え
張り付ける	張り付け
つり合う	つり合い
のし上がる	のし上がり
思い切れる	思い切れ
みかえる	みかえり
はしりぬける	はしりぬけ
拠る	拠り
てる	て
だきとる	だきとり
攀じ登る	攀じ登り
こいこがれる	こいこがれ
なみだする	こいこがれ
すべりこむ	すべりこみ
見粉う	見粉い
打落す	打落し
きする	打落し
ひきずりだせる	ひきずりだせ
ころげでる	ころげで
建ち並ぶ	建ち並び
往く	往き
みとる	みとり
巡る	巡り
読み流す	読み流し
代る	代り
罷める	罷め
かかえ込む	かかえ込み
まぜっかえす	まぜっかえし
おりあう	おりあい
ゐる	ゐ
見せかける	見せかけ
かつげる	かつげ
きりまわす	きりまわし
躊躇う	躊躇い
しんじる	しんじ
堪え忍ぶ	堪え忍び
すべりこめる	すべりこめ
おとす	おとし
射竦める	射竦め
付加わる	付加わり
捲れる	捲れ
たがえる	たがえ
かかわり合う	かかわり合い
はねだす	はねだし
うたいまくる	うたいまくり
過す	過し
こおりつく	こおりつき
科す	科し
連れ帰る	連れ帰り
まくる	まくり
抓む	抓み
おどり上がる	おどり上がり
切り立つ	切り立ち
見馴れる	見馴れ
振り分ける	振り分け
撃ち合う	撃ち合い
うかべる	うかべ
饐える	饐え
思いとどまる	思いとどまり
ふりおとす	ふりおとし
組付く	組付き
聞き落す	聞き落し
かき分ける	かき分け
洗える	洗え
うったえる	うったえ
借切る	借切り
こぎ着ける	こぎ着け
脹らす	脹らし
分かつ	分かち
言いならわす	言いならわし
挿頭す	挿頭し
飛び込める	飛び込め
切出す	切出し
いつぶす	いつぶし
休まる	休まり
降ろせる	降ろせ
はためく	はためき
もうす	もうし
死にかける	死にかけ
諌める	諌め
もとめる	もとめ
駆回る	駆回り
くりこせる	くりこせ
キメる	キメ
取片付ける	取片付け
いすくめる	いすくめ
へんじる	へんじ
ほつれる	ほつれ
交わす	交わし
うりはらえる	うりはらえ
混ぜ返す	混ぜ返し
あれくるう	あれくるい
摂する	あれくるい
ねがえる	ねがえ
ながす	ながし
言い過ぎる	言い過ぎ
すだてる	すだて
ぼかす	ぼかし
押込める	押込め
立ち遅れる	立ち遅れ
むくれる	むくれ
ひるむ	ひるみ
降くらす	降くらし
やすまれる	やすまれ
通れる	通れ
買いあさる	買いあさり
巡らす	巡らし
持ち去る	持ち去り
縅す	縅し
拭き取る	拭き取り
あまえる	あまえ
じゅくす	じゅくし
捻り回す	捻り回し
過る	過り
歩く	歩き
売りつくす	売りつくし
ひらめく	ひらめき
叙する	ひらめき
咲かせる	咲かせ
おどりかかる	おどりかかり
きかす	きかし
契れる	契れ
つきあげる	つきあげ
おっつける	おっつけ
恋う	恋い
くさらす	くさらし
にじむ	にじみ
みとれる	みとれ
欲張る	欲張り
つっこむ	つっこみ
呼び込める	呼び込め
取去る	取去り
嵌め込む	嵌め込み
焼きつける	焼きつけ
恵まれる	恵まれ
切かかる	切かかり
見晴らす	見晴らし
聞き出せる	聞き出せ
眩む	眩み
得る	得
さおさす	さおさし
かわす	かわし
替える	替え
といつめる	といつめ
濾せる	濾せ
突き抜ける	突き抜け
育て上げる	育て上げ
見すかせる	見すかせ
歴る	歴
生きる	生き
道ける	道け
願う	願い
噛みわける	噛みわけ
取り決める	取り決め
着ける	着け
気がつく	気がつき
つつしむ	つつしみ
泳げる	泳げ
おいる	おい
かいあげる	かいあげ
書き抜く	書き抜き
乾涸びる	乾涸び
繋げる	繋げ
割りふる	割りふり
縮れる	縮れ
紛らかす	紛らかし
驚く	驚き
失う	失い
かりかえる	かりかえ
かきそえる	かきそえ
買い取る	買い取り
口ごもる	口ごもり
くいつく	くいつき
突詰める	突詰め
とりけす	とりけし
しにたえる	しにたえ
煮詰まる	煮詰まり
あきれ果てる	あきれ果て
役立てる	役立て
ありつく	ありつき
動き出す	動き出し
切り詰める	切り詰め
行交う	行交い
求め行く	求め行き
枯ればむ	枯ればみ
バカげる	バカげ
絡まる	絡まり
下げる	下げ
曳ける	曳け
せっぱ詰まる	せっぱ詰まり
組みつく	組みつき
ほうりだす	ほうりだし
手馴れる	手馴れ
転がる	転がり
抱き合う	抱き合い
しおれる	しおれ
割り付ける	割り付け
飛ばせる	飛ばせ
にじる	にじり
よくばる	よくばり
つめこめる	つめこめ
夢見る	夢見
はんじる	はんじ
冷やす	冷やし
めしかかえる	めしかかえ
丸め込む	丸め込み
見落す	見落し
飲潰す	飲潰し
撃つ	撃ち
むくう	むくい
ありあまる	ありあまり
つまどる	つまどり
囃す	囃し
認める	認め
ときめかす	ときめかし
儀式張る	儀式張り
恍ける	恍け
あたける	あたけ
制する	あたけ
見せ付ける	見せ付け
流れる	流れ
はせ参ずる	流れ
掻き分ける	掻き分け
適す	適し
出歩く	出歩き
舞上がる	舞上がり
関係付ける	関係付け
舂く	舂き
縁付ける	縁付け
まかり間違う	まかり間違い
軽しめる	軽しめ
ひっこす	ひっこし
ゆき暮れる	ゆき暮れ
ほれ込む	ほれ込み
ふりはじめる	ふりはじめ
越える	越え
うめる	うめ
誅する	うめ
學ぶ	學び
被ける	被け
かきながす	かきながし
詰めかける	詰めかけ
窮め尽くす	窮め尽くし
整え直す	整え直し
遮れる	遮れ
しれわたる	しれわたり
すみなれる	すみなれ
なげこめる	なげこめ
投げ勝てる	投げ勝て
ていする	投げ勝て
なやます	なやまし
突きとばす	突きとばし
当たれる	当たれ
さかだつ	さかだち
なげだせる	なげだせ
かきこむ	かきこみ
振当てる	振当て
つかいわける	つかいわけ
誣いる	誣い
ゆき渡る	ゆき渡り
はたける	はたけ
碎く	碎き
抱き着く	抱き着き
ひっくるめる	ひっくるめ
吹っ飛ぶ	吹っ飛び
押しこめる	押しこめ
さいはじける	さいはじけ
ととのう	ととのい
誹る	誹り
わきおこれる	わきおこれ
はりあげる	はりあげ
折り合う	折り合い
置きわすれる	置きわすれ
ひざまずく	ひざまずき
かたまる	かたまり
言誤る	言誤り
うち続く	うち続き
有り触れる	有り触れ
生い育つ	生い育ち
擦寄る	擦寄り
書下す	書下し
のこる	のこり
当て擦る	当て擦り
思いなす	思いなし
杓う	杓い
とおせる	とおせ
住みかえる	住みかえ
そこしる	そこしり
責め落とす	責め落とし
染出す	染出し
つかめる	つかめ
いやます	いやまし
竦む	竦み
ならぶ	ならび
詰る	詰り
排する	詰り
のしかかる	のしかかり
集る	集り
振分ける	振分け
かんがえつく	かんがえつき
求まる	求まり
ゆわえ付ける	ゆわえ付け
吊れる	吊れ
聞き込む	聞き込み
もえあがる	もえあがり
さきみだれる	さきみだれ
侮る	侮り
まかり通る	まかり通り
押し切れる	押し切れ
見とれる	見とれ
つづまる	つづまり
みさだめる	みさだめ
こましゃくれる	こましゃくれ
遊び回れる	遊び回れ
うつしとる	うつしとり
鞣す	鞣し
でかける	でかけ
勝ちぬく	勝ちぬき
とって返す	とって返し
ねぐ	ねぎ
みいだせる	みいだせ
掃きだす	掃きだし
切り取る	切り取り
飛のく	飛のき
かみしだく	かみしだき
詛う	詛い
片寄る	片寄り
わき出る	わき出
ぞんじあげる	ぞんじあげ
寄り縋る	寄り縋り
もとる	もとり
めぐれる	めぐれ
重立つ	重立ち
黄ばむ	黄ばみ
書き散らす	書き散らし
刺し通す	刺し通し
おそれいる	おそれいり
優る	優り
もてなす	もてなし
しゃくにさわる	しゃくにさわり
よびあげる	よびあげ
食い合う	食い合い
いきぬく	いきぬき
鈍る	鈍り
しげりあう	しげりあい
話す	話し
言い損なう	言い損ない
押しつまる	押しつまり
踏み破る	踏み破り
請う	請い
たわむ	たわみ
降り積る	降り積り
打出す	打出し
響きわたる	響きわたり
もぎ落とす	もぎ落とし
膨れる	膨れ
借入れる	借入れ
翔る	翔り
いきまく	いきまき
そっくりかえる	そっくりかえり
となりあう	となりあい
相する	となりあい
まぬかれる	まぬかれ
逢う	逢い
逃れる	逃れ
食いつぶす	食いつぶし
すわりこめる	すわりこめ
強める	強め
剥ける	剥け
耳慣れる	耳慣れ
よいしれる	よいしれ
荒れ狂う	荒れ狂い
よみとれる	よみとれ
欲ばる	欲ばり
なげいれる	なげいれ
わすれかける	わすれかけ
てなずける	てなずけ
抱ける	抱け
とりさる	とりさり
課す	課し
焼き鈍す	焼き鈍し
うっする	焼き鈍し
りょうる	りょうり
わらいこける	わらいこけ
同ずる	わらいこけ
運び込む	運び込み
差向ける	差向け
もぐりこめる	もぐりこめ
安らう	安らい
紛える	紛え
ほころばせる	ほころばせ
犯せる	犯せ
読み出す	読み出し
なきぬれる	なきぬれ
祝える	祝え
おもんばかる	おもんばかり
たたえる	たたえ
よびよせる	よびよせ
手渡せる	手渡せ
いる	い
結い上げる	結い上げ
かつえる	かつえ
もったいぶる	もったいぶり
こせる	こせ
統べる	統べ
送りこむ	送りこみ
差上る	差上り
引き出す	引き出し
盗み見る	盗み見
おおせつかる	おおせつかり
くるまれる	くるまれ
区切る	区切り
折り曲げる	折り曲げ
逃げだす	逃げだし
けがす	けがし
要る	要り
拗じくれる	拗じくれ
及ぶ	及び
ねじこむ	ねじこみ
ひきおとせる	ひきおとせ
拗くれる	拗くれ
身まかる	身まかり
可愛がれる	可愛がれ
泣明かす	泣明かし
鳴しきる	鳴しきり
すえる	すえ
しばりつける	しばりつけ
にじみでる	にじみで
震わす	震わし
ぶら下げる	ぶら下げ
恋こがれる	恋こがれ
おもいあがる	おもいあがり
ひきしぼる	ひきしぼり
とりかえす	とりかえし
つかれる	つかれ
練り合わせる	練り合わせ
所帯染みる	所帯染み
おどろく	おどろき
はばかる	はばかり
活かす	活かし
打据える	打据え
うかがえる	うかがえ
輸する	うかがえ
察す	察し
振る舞う	振る舞い
諂う	諂い
取り去る	取り去り
目論む	目論み
殴り込む	殴り込み
言い直す	言い直し
のみつぶれる	のみつぶれ
隣合わす	隣合わし
おぎなう	おぎない
ひねり出す	ひねり出し
洗い直す	洗い直し
つかねる	つかね
おいちらす	おいちらし
うけいれる	うけいれ
かなう	かない
知抜く	知抜き
象れる	象れ
受け出す	受け出し
ゆすぐ	ゆすぎ
あそびあきる	あそびあき
次ぐ	次ぎ
さぐりあう	さぐりあい
える	えり
揚る	揚り
ねそびれる	ねそびれ
すすぐ	すすぎ
顕れる	顕れ
赤みがかる	赤みがかり
嗜める	嗜め
うがつ	うがち
掻き乱す	掻き乱し
生み付ける	生み付け
綴じ込む	綴じ込み
あつかう	あつかい
噛み砕ける	噛み砕け
祟る	祟り
さんざめく	さんざめき
話せる	話せ
打ちあわせる	打ちあわせ
ぐずる	ぐずり
べんじる	べんじ
携える	携え
請け負う	請け負い
ながしいれる	ながしいれ
くいさがれる	くいさがれ
たたき落とす	たたき落とし
飲明かす	飲明かし
似合う	似合い
きかせる	きかせ
寄越す	寄越し
湿す	湿し
にげのびる	にげのび
まかりでる	まかりで
たちのく	たちのき
つぼまる	つぼまり
よろこばす	よろこばし
いいつのる	いいつのり
耽ける	耽け
聞き置く	聞き置き
ふりまわせる	ふりまわせ
めとる	めとり
てる	てり
うたがえる	うたがえ
甘んずる	うたがえ
たちされる	たちされ
おののく	おののき
燃やせる	燃やせ
生ずる	燃やせ
導き出す	導き出し
嵩む	嵩み
ふみぬける	ふみぬけ
ひらめる	ひらめ
すれあう	すれあい
虐める	虐め
うけとる	うけとり
たたきおとす	たたきおとし
築ける	築け
どく	どき
蠢く	蠢き
たぎる	たぎり
呼び付ける	呼び付け
心掛ける	心掛け
のり出せる	のり出せ
ふりきれる	ふりきれ
汲みあげる	汲みあげ
捻り出す	捻り出し
はずかしめる	はずかしめ
交える	交え
いいおわる	いいおわり
組込む	組込み
打ち放す	打ち放し
拾える	拾え
おもいめぐらす	おもいめぐらし
つきとおる	つきとおり
みのる	みのり
革まる	革まり
引っ掛ける	引っ掛け
来る	来
抜取る	抜取り
よわいする	抜取り
抜出す	抜出し
大殿篭る	大殿篭り
ちゅうする	大殿篭り
したためる	したため
生ける	生け
ひっくり返せる	ひっくり返せ
あらためる	あらため
腐る	腐り
鞭打つ	鞭打ち
さわがせる	さわがせ
思いめぐらす	思いめぐらし
はくする	思いめぐらし
につまる	につまり
並外れる	並外れ
かがむ	かがみ
輝く	輝き
やく	やき
ある	あり
心温まる	心温まり
なぐ	なぎ
さきにおう	さきにおい
しみ渡る	しみ渡り
咲きみだれる	咲きみだれ
うばいあえる	うばいあえ
建てる	建て
頼める	頼め
かり集める	かり集め
ふみたおせる	ふみたおせ
やみほおける	やみほおけ
言習わす	言習わし
ありあわせる	ありあわせ
吐き出す	吐き出し
導ける	導け
止まる	止まり
正す	正し
盛り殺す	盛り殺し
しまう	しまい
磨ぐ	磨ぎ
におわす	におわし
さらえる	さらえ
しわける	しわけ
躱す	躱し
討ち止める	討ち止め
交ぜる	交ぜ
のける	のけ
といあわせる	といあわせ
嵌める	嵌め
憂ふ	憂へ
ひねりだす	ひねりだし
恐る	恐
居座れる	居座れ
塗り付ける	塗り付け
執り成す	執り成し
張る	張り
にえかえる	にえかえり
乗り掛ける	乗り掛け
帯する	乗り掛け
にやける	にやけ
しぶく	しぶき
戦ふ	戦ひ
てがける	てがけ
でく	でき
くいたおす	くいたおし
差し伸べる	差し伸べ
いきどおる	いきどおり
張り切る	張り切り
やめる	やめ
誘き寄せる	誘き寄せ
いきばる	いきばり
たたきだせる	たたきだせ
煎る	煎り
おうじる	おうじ
遊ばせる	遊ばせ
けしかける	けしかけ
突き出る	突き出
行かす	行かし
よくなる	よくなり
あがる	あがり
もつ	もち
迫り上げる	迫り上げ
鉗む	鉗み
たっする	鉗み
こえる	こえ
ぬがせる	ぬがせ
かみつく	かみつき
捌く	捌き
聞き流す	聞き流し
占める	占め
鳴りだす	鳴りだし
赦す	赦し
見返す	見返し
威張る	威張り
罅割れる	罅割れ
みまう	みまい
きはじめる	きはじめ
飛降りる	飛降り
なぎ倒す	なぎ倒し
振りまける	振りまけ
とりくむ	とりくみ
ひそまる	ひそまり
持ち直す	持ち直し
意気込む	意気込み
見つけ出す	見つけ出し
あきなう	あきない
見惚れる	見惚れ
けだす	けだし
占える	占え
持寄る	持寄り
染入る	染入り
ゆきあう	ゆきあい
そそぎ入れる	そそぎ入れ
もぎとれる	もぎとれ
癒す	癒し
氷る	氷り
引き続く	引き続き
買占める	買占め
哀れむ	哀れみ
叱れる	叱れ
のびあがれる	のびあがれ
茶化す	茶化し
申し入れる	申し入れ
借り倒す	借り倒し
押さえ込む	押さえ込み
乗り合わせる	乗り合わせ
あきらめる	あきらめ
渇する	あきらめ
見いだす	見いだし
掻く	掻き
話し出す	話し出し
先だつ	先だち
かっ切る	かっ切り
打放す	打放し
わりふる	わりふり
うろ抜く	うろ抜き
授ける	授け
のぞきこめる	のぞきこめ
はぐれる	はぐれ
つれあう	つれあい
引き絞る	引き絞り
グレる	グレ
聞き過す	聞き過し
ただせる	ただせ
それる	それ
見くびる	見くびり
買入れる	買入れ
買い換える	買い換え
抑え込む	抑え込み
そびえたつ	そびえたち
嗅ぎつける	嗅ぎつけ
ねころぶ	ねころび
える	え
ほのめかす	ほのめかし
面くらう	面くらい
こころづく	こころづき
摩り替える	摩り替え
かけ合せる	かけ合せ
言い出せる	言い出せ
詫び入る	詫び入り
つくす	つくし
亡くする	つくし
よみあわす	よみあわし
懸け離れる	懸け離れ
選び出せる	選び出せ
吐きだす	吐きだし
近付ける	近付け
やれる	やれ
過ぎる	過ぎ
めぐらせる	めぐらせ
まちがえる	まちがえ
ききながせる	ききながせ
扮する	ききながせ
乗外す	乗外し
取り結べる	取り結べ
かわせる	かわせ
取り囲める	取り囲め
噴ける	噴け
老込む	老込み
もうしでる	もうしで
あそばす	あそばし
儲かる	儲かり
つぎ込む	つぎ込み
ねばる	ねばり
縮こまる	縮こまり
うまれおちる	うまれおち
見つめる	見つめ
添う	添い
踏み切れる	踏み切れ
よみかける	よみかけ
うける	うけ
乗っ取る	乗っ取り
始める	始め
とりむすべる	とりむすべ
踏とどまる	踏とどまり
転じる	転じ
積み込む	積み込み
参る	参り
つるす	つるし
はける	はけ
ふきだす	ふきだし
成り上がる	成り上がり
匂う	匂い
もたせる	もたせ
読取る	読取り
ひまどる	ひまどり
志す	志し
けずりたおす	けずりたおし
だしぬく	だしぬき
聞き取れる	聞き取れ
もたれかかる	もたれかかり
はずす	はずし
おしひらく	おしひらき
まえる	まえ
待ちくたびれる	待ちくたびれ
苛む	苛み
ふみたおす	ふみたおし
切り上げる	切り上げ
はち切れる	はち切れ
取り合わす	取り合わし
借り換える	借り換え
力尽きる	力尽き
みえる	みえ
組み付ける	組み付け
そり返る	そり返り
作り出す	作り出し
おしこむ	おしこみ
せまれる	せまれ
食つなぐ	食つなぎ
擦込む	擦込み
くむ	くみ
相まつ	相まち
わき起これる	わき起これ
焼ける	焼け
緘する	焼け
貢げる	貢げ
かたづける	かたづけ
まもる	まもり
ふやす	ふやし
晒す	晒し
たすけあえる	たすけあえ
粘り抜く	粘り抜き
なげつける	なげつけ
引っこ抜く	引っこ抜き
焙じる	焙じ
舞い降りる	舞い降り
やぶける	やぶけ
ときめく	ときめき
引っ掛る	引っ掛り
聞き糺す	聞き糺し
くる	くり
みあらわす	みあらわし
ひとりごつ	ひとりごち
譲り合う	譲り合い
ツッパる	ツッパり
策する	ツッパり
気張る	気張り
しゃちこ張る	しゃちこ張り
差合う	差合い
言い及す	言い及し
伏す	伏し
病みほおける	病みほおけ
取り返す	取り返し
消え入る	消え入り
こがす	こがし
焼く	焼き
はやし立てる	はやし立て
いきすぎる	いきすぎ
腰かける	腰かけ
かおる	かおり
にがりきる	にがりきり
抱きとる	抱きとり
はじきかえす	はじきかえし
ぶばる	ぶばり
ながめる	ながめ
潜る	潜り
惚れ込む	惚れ込み
掘り下げる	掘り下げ
くばりあるく	くばりあるき
哀しむ	哀しみ
向かわる	向かわり
おし黙る	おし黙り
追払う	追払い
ざらつく	ざらつき
滾る	滾り
褒めそやす	褒めそやし
うばいかえす	うばいかえし
そめなおせる	そめなおせ
優れる	優れ
弾き返す	弾き返し
重んずる	弾き返し
見入る	見入り
とびつく	とびつき
うりさばく	うりさばき
築き上げる	築き上げ
混ずる	築き上げ
突き除ける	突き除け
分合う	分合い
とりかえる	とりかえ
水漬く	水漬き
考へる	考へ
洗い落とせる	洗い落とせ
とりこぼす	とりこぼし
かちえる	かちえ
張倒す	張倒し
にあう	にあい
はねかえる	はねかえり
とどむる	とどむり
いみづける	いみづけ
つながる	つながり
巻き込める	巻き込め
持て囃す	持て囃し
引きずり込める	引きずり込め
報せる	報せ
際す	際し
差しのべる	差しのべ
醸す	醸し
積み上げる	積み上げ
うらぶれる	うらぶれ
うみだせる	うみだせ
かずける	かずけ
見おろせる	見おろせ
ひんする	見おろせ
ひきかえす	ひきかえし
繰入れる	繰入れ
動機付ける	動機付け
存ずる	動機付け
取仕切る	取仕切り
おいやる	おいやり
表する	おいやり
艷めく	艷めき
喋れる	喋れ
かきけせる	かきけせ
聞きいれる	聞きいれ
飛び出せる	飛び出せ
そよぐ	そよぎ
おおせる	おおせ
よびかわす	よびかわし
向かえる	向かえ
振り上げる	振り上げ
慰める	慰め
にくがる	にくがり
言いつける	言いつけ
あびせる	あびせ
誘える	誘え
極め込む	極め込み
くどきおとす	くどきおとし
聞き入る	聞き入り
呼び上げる	呼び上げ
訝る	訝り
かつぐ	かつぎ
引掻く	引掻き
擦切れる	擦切れ
属する	擦切れ
せりあげる	せりあげ
泡だつ	泡だち
下廻る	下廻り
失す	失し
討ち取る	討ち取り
仕組める	仕組め
読み合わせる	読み合わせ
掻っ込む	掻っ込み
攻め込む	攻め込み
たたきつける	たたきつけ
ささくれる	ささくれ
いいならわす	いいならわし
売り急ぐ	売り急ぎ
繰りかえる	繰りかえ
ぐする	繰りかえ
轟かす	轟かし
おしはかれる	おしはかれ
曵ける	曵け
忍ばせる	忍ばせ
隣合わせる	隣合わせ
取り合せる	取り合せ
ゆきづまる	ゆきづまり
組みかえる	組みかえ
ゆうきづける	ゆうきづけ
描く	描き
伸し上がる	伸し上がり
けおとす	けおとし
取寄せる	取寄せ
たちあがる	たちあがり
恵む	恵み
抜け出る	抜け出
引きつける	引きつけ
錆びる	錆び
つらぬく	つらぬき
言いのがれる	言いのがれ
ともなう	ともない
繰り上げる	繰り上げ
ねる	ねり
押しやる	押しやり
寝かし付ける	寝かし付け
につける	につけ
ならわす	ならわし
ぶりかえす	ぶりかえし
つがう	つがい
沈める	沈め
ぶんなぐる	ぶんなぐり
待ちあぐむ	待ちあぐみ
やけだされる	やけだされ
取り組める	取り組め
おちつきはらう	おちつきはらい
断る	断り
いれる	いれ
冷す	冷し
はねかす	はねかし
諳んじる	諳んじ
くぐまる	くぐまり
くらむ	くらみ
走らす	走らし
さし当たる	さし当たり
追いこむ	追いこみ
引き抜ける	引き抜け
まごつく	まごつき
嚇す	嚇し
叩き込む	叩き込み
養える	養え
準じる	準じ
かきけす	かきけし
可愛がる	可愛がり
軽んずる	可愛がり
飛び交う	飛び交い
かく	かき
治める	治め
泣き崩れる	泣き崩れ
充てる	充て
誇る	誇り
浚う	浚い
明くらす	明くらし
とりおとす	とりおとし
ことわる	ことわり
交す	交し
拭える	拭え
ひきもどせる	ひきもどせ
むせかえる	むせかえり
ヤジる	ヤジり
飽く	飽き
相変わる	相変わり
呼び寄せる	呼び寄せ
ほほ笑みかける	ほほ笑みかけ
戻る	戻り
堕する	戻り
飲める	飲め
きりぬく	きりぬき
写す	写し
むかいあわせる	むかいあわせ
扱きおろす	扱きおろし
震え上がる	震え上がり
書き落とす	書き落とし
ふまえる	ふまえ
はむかえる	はむかえ
覚す	覚し
彫り込む	彫り込み
聞きすごす	聞きすごし
空とぼける	空とぼけ
書換える	書換え
ひっぱれる	ひっぱれ
贖う	贖い
しょする	贖い
塗り潰す	塗り潰し
はまりこむ	はまりこみ
うばいあう	うばいあい
たどり着く	たどり着き
脱がせる	脱がせ
つけまわす	つけまわし
入替える	入替え
攻め落とす	攻め落とし
積み込める	積み込め
歌い上げる	歌い上げ
見掛ける	見掛け
為遂げる	為遂げ
腹ばう	腹ばい
燃えさかる	燃えさかり
へずる	へずり
うちたおせる	うちたおせ
題す	題し
行ずる	題し
ひょろつく	ひょろつき
精出せる	精出せ
言い尽くす	言い尽くし
てむかう	てむかい
詰め込む	詰め込み
喰らう	喰らい
射掛ける	射掛け
思い返す	思い返し
瀕する	思い返し
ちりはてる	ちりはて
武ばる	武ばり
跼る	跼り
残る	残り
のばす	のばし
つき合う	つき合い
ときふせる	ときふせ
みこむ	みこみ
ひたる	ひたり
妨げる	妨げ
忍ぶ	忍び
唱える	唱え
差し出す	差し出し
見上ぐ	見上げ
とおる	とおり
ねじむける	ねじむけ
どよめく	どよめき
物語る	物語り
酔払う	酔払い
はぶける	はぶけ
まいらす	まいらし
長ずる	まいらし
超す	超し
かしらだつ	かしらだち
かたらう	かたらい
引つる	引つり
ききほれる	ききほれ
わきかえる	わきかえり
掘り返せる	掘り返せ
知らす	知らし
果す	果し
咳きあげる	咳きあげ
燃あがる	燃あがり
見切る	見切り
気負う	気負い
息づまる	息づまり
仕出かす	仕出かし
たいらげる	たいらげ
見棄てる	見棄て
しかめる	しかめ
散る	散り
とばせる	とばせ
押し戻す	押し戻し
おしえる	おしえ
陣取る	陣取り
口説く	口説き
上向ける	上向け
すくえる	すくえ
爪立てる	爪立て
ひっくり返る	ひっくり返り
引き取れる	引き取れ
蹲う	蹲い
うずめる	うずめ
見据える	見据え
てなれる	てなれ
ときあるく	ときあるき
取持つ	取持ち
横たわる	横たわり
おもんじる	おもんじ
溢れる	溢れ
死に果てる	死に果て
立至る	立至り
亘る	亘り
手挟む	手挟み
書留める	書留め
うりはらう	うりはらい
覆せる	覆せ
抜けでる	抜けで
すり抜ける	すり抜け
売りまくる	売りまくり
倣う	倣い
きりさいなむ	きりさいなみ
なりさがる	なりさがり
おきわすれる	おきわすれ
折れ合える	折れ合え
禿げる	禿げ
切りそろえる	切りそろえ
立ち合える	立ち合え
居る	居り
払う	払い
盛り潰す	盛り潰し
踏み出せる	踏み出せ
ゆする	踏み出せ
差引く	差引き
太れる	太れ
まきあげる	まきあげ
弄う	弄い
乗りきる	乗りきり
汲める	汲め
行く	行き
いむ	いみ
撮む	撮み
わたれる	わたれ
自惚れる	自惚れ
たびだつ	たびだち
伝え聞く	伝え聞き
押し切る	押し切り
わらいとばせる	わらいとばせ
れいする	わらいとばせ
たゆたう	たゆたい
もだす	もだし
驕る	驕り
起つ	起ち
ゆわえつける	ゆわえつけ
おれまがる	おれまがり
たのみこむ	たのみこみ
飛び込む	飛び込み
うちしおれる	うちしおれ
まかりとおる	まかりとおり
ひび割れる	ひび割れ
なぎふせる	なぎふせ
刳り貫く	刳り貫き
潤む	潤み
ときはなつ	ときはなち
際だつ	際だち
煮つける	煮つけ
吹き払える	吹き払え
へたばる	へたばり
はばたく	はばたき
切り放す	切り放し
切抜ける	切抜け
競う	競い
いいかねる	いいかね
とりはなせる	とりはなせ
見倣す	見倣し
煽ぐ	煽ぎ
かばう	かばい
唆す	唆し
飲干す	飲干し
すわり込む	すわり込み
狙う	狙い
とりかこむ	とりかこみ
彫りあげる	彫りあげ
打ち合う	打ち合い
みうける	みうけ
捕れる	捕れ
のりすごす	のりすごし
組み敷く	組み敷き
読みかえる	読みかえ
突き当る	突き当り
背ける	背け
あるきつかれる	あるきつかれ
そそり立つ	そそり立ち
出直す	出直し
震る	震り
振い落す	振い落し
舞あがる	舞あがり
置きかえる	置きかえ
務める	務め
とじこもる	とじこもり
脹れる	脹れ
やせ衰える	やせ衰え
瞑る	瞑り
駆け出す	駆け出し
賜ぶ	賜び
聞外す	聞外し
売り捌く	売り捌き
了する	売り捌き
おきあがる	おきあがり
切り離せる	切り離せ
据えつける	据えつけ
のびゆく	のびゆき
書き下す	書き下し
司る	司り
咳きこむ	咳きこみ
ひったくる	ひったくり
みる	み
致す	致し
ごわつく	ごわつき
引っこぬく	引っこぬき
たきあがる	たきあがり
掻き立てる	掻き立て
いろどる	いろどり
蔽う	蔽い
掻い摘む	掻い摘み
こじれる	こじれ
聞届ける	聞届け
洗上げる	洗上げ
容態ぶる	容態ぶり
老ける	老け
切り替る	切り替り
甘やかす	甘やかし
逐う	逐い
いいかえる	いいかえ
しょうこだてる	しょうこだて
さしこえる	さしこえ
聞及ぶ	聞及び
ひきわたせる	ひきわたせ
はなれる	はなれ
いさめる	いさめ
抄く	抄き
かけへだたる	かけへだたり
踏み込む	踏み込み
くらせる	くらせ
授かる	授かり
あじわう	あじわい
戒める	戒め
みとめる	みとめ
おしつける	おしつけ
凹ます	凹まし
塞き上げる	塞き上げ
ふすぼる	ふすぼり
かせる	かせ
荒らげる	荒らげ
営む	営み
考え直す	考え直し
おくれる	おくれ
駆込む	駆込み
あらしまわる	あらしまわり
居すくまる	居すくまり
切り開ける	切り開け
払い込む	払い込み
見つけだす	見つけだし
這い蹲う	這い蹲い
老いさらばえる	老いさらばえ
閉まる	閉まり
はなす	はなし
いすわれる	いすわれ
くらわす	くらわし
へしあう	へしあい
突きつめる	突きつめ
量り込む	量り込み
とくする	量り込み
取り戻す	取り戻し
とよむ	とよみ
やり込める	やり込め
しゃべる	しゃべり
嗅ぎ当てる	嗅ぎ当て
巻き起す	巻き起し
ととのえる	ととのえ
噤む	噤み
調子づく	調子づき
説明かす	説明かし
暮らせる	暮らせ
於く	於き
研ける	研け
なぐりとばす	なぐりとばし
語れる	語れ
行悩む	行悩み
ふんぎれる	ふんぎれ
持掛ける	持掛け
やけしぬ	やけしに
さしくる	さしくり
むしる	むしり
講じる	講じ
張り込む	張り込み
修まる	修まり
つれだす	つれだし
みとおす	みとおし
もらえる	もらえ
ふらつく	ふらつき
断わる	断わり
入れ違う	入れ違い
おりかえす	おりかえし
当て嵌める	当て嵌め
おちゆく	おちゆき
つくりかえる	つくりかえ
休む	休み
落ちつける	落ちつけ
つきのめす	つきのめし
古ぼける	古ぼけ
矯める	矯め
折り重なる	折り重なり
入びたる	入びたり
たてこもれる	たてこもれ
じょうずる	たてこもれ
あきれはてる	あきれはて
かりだす	かりだし
はみだす	はみだし
参じる	参じ
罷り通る	罷り通り
醸せる	醸せ
入り組む	入り組み
うれる	うれ
選る	選り
しる	しり
及ぼせる	及ぼせ
絎ける	絎け
除する	絎け
へりくだる	へりくだり
みゃくうつ	みゃくうち
はぐくめる	はぐくめ
打てる	打て
だまし込む	だまし込み
揺るがす	揺るがし
買い替える	買い替え
饗する	買い替え
汗ばむ	汗ばみ
ひきぐする	汗ばみ
刈る	刈り
走り出る	走り出
賣れる	賣れ
はめこめる	はめこめ
来たす	来たし
まじわる	まじわり
突当る	突当り
かさなる	かさなり
つりあがる	つりあがり
はせもどる	はせもどり
刈り込む	刈り込み
たおす	たおし
のたうち回る	のたうち回り
目がける	目がけ
碎ける	碎け
おもいうかべる	おもいうかべ
つっかえせる	つっかえせ
おわる	おわり
押寄せる	押寄せ
いれあわせる	いれあわせ
凍てる	凍て
鋳る	鋳
効く	効き
爪先立つ	爪先立ち
おこれる	おこれ
申し伝える	申し伝え
生す	生し
閉ざす	閉ざし
焼き付ける	焼き付け
借換える	借換え
坐りこむ	坐りこみ
あけわたる	あけわたり
おしかくせる	おしかくせ
育てる	育て
給ぶ	給び
書き上げる	書き上げ
えむ	えみ
配る	配り
のりこなす	のりこなし
あゆむ	あゆみ
矧げる	矧げ
突っ走る	突っ走り
さぐりあてる	さぐりあて
飛散る	飛散り
滅ぼす	滅ぼし
ふかめる	ふかめ
縛する	ふかめ
駈る	駈り
ほりさげる	ほりさげ
もたせかける	もたせかけ
わらえる	わらえ
こじる	こじり
泣腫らす	泣腫らし
据付ける	据付け
吐出す	吐出し
焦げる	焦げ
おしつめる	おしつめ
隠れる	隠れ
打倒す	打倒し
踏み鳴らす	踏み鳴らし
寄せ付ける	寄せ付け
切り掛る	切り掛り
在る	在り
だきこめる	だきこめ
言いたてる	言いたて
組み合せる	組み合せ
いる	いり
入れあげる	入れあげ
ごうする	入れあげ
ねいる	ねいり
亡くなす	亡くなし
暴れる	暴れ
まします	ましまし
ぬきだす	ぬきだし
なげかける	なげかけ
荒れ果てる	荒れ果て
きこしめす	きこしめし
噎せる	噎せ
ひきとれる	ひきとれ
あらしめる	あらしめ
うちくだける	うちくだけ
指す	指し
つどえる	つどえ
変える	変え
どやしつける	どやしつけ
消えうせる	消えうせ
叩き付ける	叩き付け
抜き連ねる	抜き連ね
飛かかる	飛かかり
突っころばす	突っころばし
のこせる	のこせ
表せる	表せ
であるく	であるき
とりにがす	とりにがし
差入れる	差入れ
とりさばく	とりさばき
取り外せる	取り外せ
まん延する	まん延す
嘶く	嘶き
ぶちかます	ぶちかまし
なでつける	なでつけ
平らぐ	平らぎ
吊上げる	吊上げ
いとう	いとい
吹きかける	吹きかけ
くぎる	くぎり
かい出す	かい出し
こき使える	こき使え
かこえる	かこえ
とりもどせる	とりもどせ
たたかう	たたかい
なげすてる	なげすて
刺違える	刺違え
汲み込む	汲み込み
つぶせる	つぶせ
のぼれる	のぼれ
帰る	帰り
忌み嫌う	忌み嫌い
熨す	熨し
盛り分ける	盛り分け
なじる	なじり
ばっする	なじり
偏する	なじり
うまれる	うまれ
ぬきとる	ぬきとり
大人びる	大人び
贏ち得える	贏ち得え
差しいれる	差しいれ
かきつける	かきつけ
うけたまわる	うけたまわり
捩じる	捩じり
重ねる	重ね
怖がる	怖がり
いこう	いこい
あかるむ	あかるみ
行着く	行着き
燃え上がる	燃え上がり
乗り後れる	乗り後れ
盛りあがる	盛りあがり
怠る	怠り
入れ代わる	入れ代わり
売れ残る	売れ残り
よりきる	よりきり
締付ける	締付け
しみつく	しみつき
取り揃える	取り揃え
のりかえる	のりかえ
ふき清める	ふき清め
言い込める	言い込め
諒する	言い込め
寝付ける	寝付け
肥える	肥え
よみあさる	よみあさり
ののしる	ののしり
終る	終り
わりもどす	わりもどし
うちのめす	うちのめし
上り詰めるる	上り詰める
買い漁る	買い漁り
捨てる	捨て
神さびる	神さび
根ざす	根ざし
添いとげる	添いとげ
さそいこむ	さそいこみ
きこえる	きこえ
連れ立つ	連れ立ち
さける	さけ
成りたつ	成りたち
あけはなす	あけはなし
遊ぶ	遊び
たちなおれる	たちなおれ
書ける	書け
なぐさめる	なぐさめ
出迎える	出迎え
つくろう	つくろい
おぎないあう	おぎないあい
申し送れる	申し送れ
冠す	冠し
仰せつける	仰せつけ
おいまわす	おいまわし
にんじる	にんじ
入れ換える	入れ換え
煮あがる	煮あがり
滑り出す	滑り出し
もてあそぶ	もてあそび
拭く	拭き
息吹く	息吹き
つれそえる	つれそえ
やしなえる	やしなえ
波立つ	波立ち
駆けずり回る	駆けずり回り
撲り飛ばす	撲り飛ばし
切り替わる	切り替わり
ふさがる	ふさがり
たがやせる	たがやせ
張り付く	張り付き
つぶだつ	つぶだち
奪い取る	奪い取り
汲み取る	汲み取り
泣き叫ぶ	泣き叫び
巣食う	巣食い
だべる	だべり
嵩ずる	だべり
できる	でき
わかせる	わかせ
ねぢ伏せる	ねぢ伏せ
問詰める	問詰め
ぶらさがれる	ぶらさがれ
たたきだす	たたきだし
だきすくめる	だきすくめ
打ち崩せる	打ち崩せ
切り換える	切り換え
青ばむ	青ばみ
ぬすむ	ぬすみ
腹だてる	腹だて
借れる	借れ
きわめつくす	きわめつくし
ひきうける	ひきうけ
並び立つ	並び立ち
たてこめる	たてこめ
窺える	窺え
たわむれる	たわむれ
彌増す	彌増し
ほっぽる	ほっぽり
はねつける	はねつけ
かさねる	かさね
擬する	かさね
うかび出る	うかび出
濁せる	濁せ
扱ぐ	扱ぎ
報じる	報じ
盗み出せる	盗み出せ
褪せる	褪せ
踏ん張れる	踏ん張れ
ねぎれる	ねぎれ
勝誇る	勝誇り
間違う	間違い
ずばぬける	ずばぬけ
とりなおす	とりなおし
畳みかける	畳みかけ
あまんずる	畳みかけ
しゃっちょこばる	しゃっちょこばり
きれる	きれ
くわせる	くわせ
打ち付ける	打ち付け
書取る	書取り
いける	いけ
結ぶ	結び
続く	続き
蒔く	蒔き
浮き立てる	浮き立て
くずれる	くずれ
射る	射
抜け出す	抜け出し
におわせる	におわせ
切り崩せる	切り崩せ
読み通す	読み通し
憎まれる	憎まれ
えいずる	憎まれ
預ける	預け
取りしきる	取りしきり
よせつける	よせつけ
わらわせる	わらわせ
うりだす	うりだし
縛る	縛り
註する	縛り
投げ捨てる	投げ捨て
つぐ	つぎ
のぞむ	のぞみ
振り掛ける	振り掛け
上ずる	上ずり
見出せる	見出せ
揚げる	揚げ
くもらす	くもらし
ゆきかかる	ゆきかかり
綴合せる	綴合せ
引去る	引去り
突き戻せる	突き戻せ
相寄る	相寄り
誤魔化す	誤魔化し
益する	誤魔化し
あかす	あかし
つたえる	つたえ
取止める	取止め
悶える	悶え
えんずる	悶え
害する	悶え
続ける	続け
掠る	掠り
かいたたける	かいたたけ
思い起こす	思い起こし
習える	習え
のしあるく	のしあるき
せめおとせる	せめおとせ
目差す	目差し
編み込む	編み込み
たけり立つ	たけり立ち
かしげる	かしげ
みのがせる	みのがせ
のりくめる	のりくめ
はる	はり
もちいる	もちい
かたむける	かたむけ
読み切る	読み切り
辞す	辞し
証拠立てる	証拠立て
屈める	屈め
くみあわす	くみあわし
凭せ掛ける	凭せ掛け
かこう	かこい
がる	がり
感じ取る	感じ取り
ひねる	ひね
出外れる	出外れ
立ち後れる	立ち後れ
うつりかわる	うつりかわり
いいあらわす	いいあらわし
糾う	糾い
つもる	つもり
ふんする	つもり
振りかぶる	振りかぶり
剥がす	剥がし
そめなおす	そめなおし
賄える	賄え
寫す	寫し
事欠く	事欠き
蒸かす	蒸かし
みのがす	みのがし
明け放つ	明け放ち
持ち運ぶ	持ち運び
いざる	いざり
組合せる	組合せ
減じる	減じ
投げ出せる	投げ出せ
見透かせる	見透かせ
にらみあわす	にらみあわし
持ち歩く	持ち歩き
しょびく	しょびき
浮上がる	浮上がり
かたりこめる	かたりこめ
おもいがける	おもいがけ
とりつげる	とりつげ
なだれ込む	なだれ込み
かぎる	かぎり
舞いあがる	舞いあがり
散らかす	散らかし
ほりおこす	ほりおこし
見付ける	見付け
切り落とす	切り落とし
あかめる	あかめ
生む	生み
貢ぐ	貢ぎ
おくる	おくり
攣れる	攣れ
挟まる	挟まり
とりまぜる	とりまぜ
あみこむ	あみこみ
つたえきく	つたえきき
外す	外し
交われる	交われ
わきおこす	わきおこし
煽てる	煽て
きりたつ	きりたち
替わる	替わり
舞い狂う	舞い狂い
憎がる	憎がり
乗り合わす	乗り合わし
打落とせる	打落とせ
とびたてる	とびたて
見習う	見習い
くださる	ください
ひそむ	ひそみ
跳ね除ける	跳ね除け
盗る	盗り
賑わす	賑わし
褄取る	褄取り
削ぎ落す	削ぎ落し
会す	会し
踏み抜ける	踏み抜け
仰せつかる	仰せつかり
さしたてる	さしたて
出し合う	出し合い
ちょうする	出し合い
しぬ	しに
ぽしゃる	ぽしゃり
さしつける	さしつけ
借り入れる	借り入れ
いいだす	いいだし
拗じる	拗じり
こおる	こおり
食わせる	食わせ
哀れがる	哀れがり
煉りあわせる	煉りあわせ
伏拝む	伏拝み
わかいしあえる	わかいしあえ
問いつめる	問いつめ
浮かれる	浮かれ
わめきたてる	わめきたて
学びとれる	学びとれ
読み下す	読み下し
首肯く	首肯き
請ける	請け
ぶっこぬく	ぶっこぬき
ぬらす	ぬらし
えいじる	えいじ
あれる	あれ
くつがえる	くつがえり
飛べる	飛べ
曳く	曳き
躍る	躍り
無くなる	無くなり
おしすすめる	おしすすめ
ちょうしづく	ちょうしづき
書添える	書添え
法る	法り
染め直す	染め直し
仄めかす	仄めかし
なみだぐむ	なみだぐみ
ゆきなやむ	ゆきなやみ
兆す	兆し
わずらいつく	わずらいつき
抱き竦める	抱き竦め
惚れる	惚れ
たえぬく	たえぬき
おしはかる	おしはかり
たすけあう	たすけあい
びびる	びびり
あふれる	あふれ
たちあう	たちあい
わりこめる	わりこめ
突き破る	突き破り
ききとがめる	ききとがめ
律す	律し
きづかう	きづかい
差違える	差違え
引き降ろす	引き降ろし
踏み躙る	踏み躙り
はやり立つ	はやり立ち
買い込める	買い込め
差し回せる	差し回せ
やせさらばえる	やせさらばえ
就ける	就け
魅せる	魅せ
売り飛ばす	売り飛ばし
こげる	こげ
たちふさがる	たちふさがり
くじる	くじり
あいせっする	くじり
うつる	うつり
受付ける	受付け
とりしまる	とりしまり
かちぬく	かちぬき
申し受ける	申し受け
つらぬきとおせる	つらぬきとおせ
おとろえる	おとろえ
まぎる	まぎり
かわりはてる	かわりはて
かけちがう	かけちがい
見回れる	見回れ
捩くれる	捩くれ
費やせる	費やせ
たてまつる	たてまつり
つかう	つかい
引き去る	引き去り
推める	推め
引きずり込む	引きずり込み
乗り越える	乗り越え
指し示せる	指し示せ
ほおえむ	ほおえみ
払い込める	払い込め
乾す	乾し
ねざす	ねざし
掘りだす	掘りだし
通わす	通わし
抱き締める	抱き締め
堪へる	堪へ
駆け回る	駆け回り
攻めかける	攻めかけ
いさみたつ	いさみたち
讚える	讚え
もちかえれる	もちかえれ
響く	響き
引っ担ぐ	引っ担ぎ
待ちあわせる	待ちあわせ
活かる	活かり
検める	検め
呑む	呑み
しだす	しだし
取りさばく	取りさばき
おきなおる	おきなおり
連添う	連添い
脱ぎ捨てる	脱ぎ捨て
ふきすさぶ	ふきすさび
噛み砕く	噛み砕き
使い慣れる	使い慣れ
とどく	とどき
入れちがう	入れちがい
ひっくりかえせる	ひっくりかえせ
くみなおせる	くみなおせ
走り出せる	走り出せ
みくだす	みくだし
かけずりまわる	かけずりまわり
噛みしだく	噛みしだき
おくりこめる	おくりこめ
位する	おくりこめ
貰える	貰え
意味付ける	意味付け
かくする	意味付け
別ける	別け
下りる	下り
引き摺る	引き摺り
とりきめる	とりきめ
打勝てる	打勝て
なぞる	なぞり
急き立てる	急き立て
逃げ失せる	逃げ失せ
嘗める	嘗め
だまる	だまり
助く	助け
うつれる	うつれ
さししめす	さししめし
逃げ帰る	逃げ帰り
そそりたてる	そそりたて
よみこなす	よみこなし
ちりのこる	ちりのこり
いそぐ	いそぎ
吊り上げる	吊り上げ
償える	償え
うやまう	うやまい
あげる	あげ
振り起す	振り起し
食い詰める	食い詰め
尊べる	尊べ
傭う	傭い
おりる	おり
乗り捨てる	乗り捨て
書きためる	書きため
見透かす	見透かし
突刺す	突刺し
頷ける	頷け
つむ	つみ
つかみあげる	つかみあげ
見放す	見放し
染め出せる	染め出せ
からびる	からび
差し押さえる	差し押さえ
面食らう	面食らい
締め切る	締め切り
切れる	切れ
食い散らす	食い散らし
潤う	潤い
追いつける	追いつけ
見取る	見取り
申送る	申送り
はぎあわせる	はぎあわせ
努める	努め
おおせつける	おおせつけ
向く	向き
乗上げる	乗上げ
足りる	足り
縛める	縛め
歌わす	歌わし
おもんみる	おもんみ
照る	照り
覚ます	覚まし
見ほれる	見ほれ
より抜く	より抜き
駆集める	駆集め
とめおく	とめおき
逞しゅうする	とめおき
とりはずす	とりはずし
睨みつける	睨みつけ
聞きただせる	聞きただせ
はいずる	はいずり
ゆきかう	ゆきかい
比する	ゆきかい
けちがえる	けちがえ
まさぐる	まさぐり
示し合わす	示し合わし
植え込む	植え込み
諮る	諮り
よじのぼれる	よじのぼれ
預る	預り
打ちすえる	打ちすえ
はだける	はだけ
写し出せる	写し出せ
ききだす	ききだし
あばきだす	あばきだし
投げ付ける	投げ付け
あまやかす	あまやかし
譬える	譬え
難ずる	譬え
のみくだす	のみくだし
つむぐ	つむぎ
飛び退く	飛び退き
える	え
ひったてる	ひったて
みがける	みがけ
はさむ	はさみ
ほこれる	ほこれ
譲る	譲り
行き違う	行き違い
落とし込む	落とし込み
懸る	懸り
尋ねあわせる	尋ねあわせ
添い遂げる	添い遂げ
踏み締める	踏み締め
飛下りる	飛下り
落くぼむ	落くぼみ
呑みつぶす	呑みつぶし
立ち回る	立ち回り
降注ぐ	降注ぎ
とりもつ	とりもち
跳べる	跳べ
乗合せる	乗合せ
呑みつぶれる	呑みつぶれ
遣り返す	遣り返し
能う	能い
きりふせる	きりふせ
呑める	呑め
へしおる	へしおり
まいもどる	まいもどり
示す	示し
とびかかれる	とびかかれ
つまされる	つまされ
統べくくる	統べくくり
積み替える	積み替え
召し上がる	召し上がり
はりさける	はりさけ
起こせる	起こせ
抜かる	抜かり
はしらす	はしらし
へばる	へばり
ふみしめる	ふみしめ
しにおくれる	しにおくれ
和える	和え
巻く	巻き
溶け合う	溶け合い
墜ちる	墜ち
ふんぎる	ふんぎり
焼切る	焼切り
駄べる	駄べり
ゆきくらす	ゆきくらし
収める	収め
道行く	道行き
わび入る	わび入り
とじこめる	とじこめ
もたれる	もたれ
よなれる	よなれ
ける	けり
解せる	解せ
なだれこむ	なだれこみ
讀む	讀み
とりもてる	とりもて
寝る	寝
ほろぼす	ほろぼし
臥す	臥し
すごむ	すごみ
威かす	威かし
見返せる	見返せ
めでる	めで
商う	商い
まびく	まびき
付き合う	付き合い
親しむ	親しみ
解き明かす	解き明かし
しいる	しい
切り苛む	切り苛み
ゆるす	ゆるし
掘る	掘り
怖気立つ	怖気立ち
はりつく	はりつき
擦れ合う	擦れ合い
見晴かす	見晴かし
やとう	やとい
吹き掛ける	吹き掛け
くりのべる	くりのべ
浮かれ出す	浮かれ出し
漏らす	漏らし
支払える	支払え
蹴破る	蹴破り
せりあう	せりあい
投捨てる	投捨て
固まる	固まり
届出る	届出
卸す	卸し
吟じる	吟じ
よたる	よたり
乗りこえる	乗りこえ
憩う	憩い
しらばくれる	しらばくれ
出合える	出合え
付入る	付入り
均す	均し
元気づける	元気づけ
打ち明ける	打ち明け
言いあわせる	言いあわせ
ほどける	ほどけ
浮かび上がれる	浮かび上がれ
つけ廻す	つけ廻し
どくづく	どくづき
おっしゃれる	おっしゃれ
啀み合う	啀み合い
押しつぶす	押しつぶし
ひからす	ひからし
押し黙る	押し黙り
ねじ込める	ねじ込め
くりさげる	くりさげ
たちあえる	たちあえ
思し召す	思し召し
かかわる	かかわり
群だつ	群だち
ありえる	ありえ
かぞえあげる	かぞえあげ
来る	来り
見合う	見合い
取巻く	取巻き
切りぬく	切りぬき
いそげる	いそげ
時化る	時化
召し出す	召し出し
うけひく	うけひき
切りはずせる	切りはずせ
奮いたつ	奮いたち
扼する	奮いたち
生まれ落ちる	生まれ落ち
かなえる	かなえ
なげる	なげ
あてはめる	あてはめ
冠する	あてはめ
ゆきすぎる	ゆきすぎ
よりかかる	よりかかり
とべる	とべ
取り計らう	取り計らい
見違える	見違え
立つくす	立つくし
成る	成り
ボヤく	ボヤき
持ちかける	持ちかけ
煙たがる	煙たがり
読みこなせる	読みこなせ
書き流す	書き流し
沁みる	沁み
押しわける	押しわけ
切り崩す	切り崩し
慣れる	慣れ
学び取れる	学び取れ
かつぎ込める	かつぎ込め
借り切る	借り切り
とりしきる	とりしきり
起き出す	起き出し
にらみ合せる	にらみ合せ
せっする	にらみ合せ
曲がりくねる	曲がりくねり
ひらつく	ひらつき
みこす	みこし
暈ける	暈け
編み上げる	編み上げ
かけぬける	かけぬけ
ふるいおとす	ふるいおとし
かじかむ	かじかみ
せがむ	せがみ
奥まる	奥まり
ゆみひく	ゆみひき
備付ける	備付け
かかす	かかし
うつぶす	うつぶし
はやりたつ	はやりたち
見合わす	見合わし
染み渡る	染み渡り
綯う	綯い
そめだす	そめだし
ふっかける	ふっかけ
埋め合す	埋め合し
かくしきばる	かくしきばり
押し詰まる	押し詰まり
蹴躓く	蹴躓き
ぬぐいさる	ぬぐいさり
まごう	まごい
外せる	外せ
承る	承り
抜き取れる	抜き取れ
のっける	のっけ
どる	どり
出遅れる	出遅れ
たくしこむ	たくしこみ
産気づく	産気づき
みとどける	みとどけ
振り回す	振り回し
例える	例え
すいとれる	すいとれ
脇挟む	脇挟み
差し支える	差し支え
浮ぶ	浮び
動ける	動け
吹き払う	吹き払い
やくす	やくし
言渡す	言渡し
ほっとく	ほっとき
仕込む	仕込み
立ち至る	立ち至り
折れ合う	折れ合い
燻べる	燻べ
誘う	誘い
あらたまる	あらたまり
造り出す	造り出し
あそびまわる	あそびまわり
計らえる	計らえ
ため込む	ため込み
きおいたつ	きおいたち
たまう	たまい
死に損なう	死に損ない
わるびれる	わるびれ
ひねこびる	ひねこび
よりぬける	よりぬけ
まちぶせる	まちぶせ
銜える	銜え
のぞく	のぞき
うらがえせる	うらがえせ
瘠せる	瘠せ
手懸ける	手懸け
はじめる	はじめ
いとおしむ	いとおしみ
奮い起こせる	奮い起こせ
わけあたえる	わけあたえ
取混ぜる	取混ぜ
突き進める	突き進め
生ながらえる	生ながらえ
でしゃばる	でしゃばり
ぞめく	ぞめき
しばたく	しばたき
立て込める	立て込め
かけあえる	かけあえ
ふりみだす	ふりみだし
抱き起こす	抱き起こし
行き悩む	行き悩み
咲き匂う	咲き匂い
おそわる	おそわり
やかす	やかし
濯う	濯い
ねりなおせる	ねりなおせ
いいかわす	いいかわし
隣り合わす	隣り合わし
飛びつく	飛びつき
泊まる	泊まり
悔やむ	悔やみ
探す	探し
やりなおせる	やりなおせ
おしだせる	おしだせ
閉じる	閉じ
出っぱる	出っぱり
掠れる	掠れ
せく	せき
弾き返せる	弾き返せ
くだせる	くだせ
召しあがる	召しあがり
傳える	傳え
もちよる	もちより
立向かう	立向かい
春めく	春めき
ころす	ころし
嗅ぎ出す	嗅ぎ出し
培う	培い
降り掛かる	降り掛かり
剽げる	剽げ
造りあげる	造りあげ
ときはなす	ときはなし
取下げる	取下げ
おもる	おもり
つめる	つめ
ほうむる	ほうむり
刻み込む	刻み込み
廃する	刻み込み
遅れる	遅れ
つけあわせる	つけあわせ
撲り付ける	撲り付け
いいおく	いいおき
荒す	荒し
書き記せる	書き記せ
揃う	揃い
しのびこむ	しのびこみ
投じる	投じ
填め込む	填め込み
もてる	もて
うりわたす	うりわたし
銜める	銜め
買い上げる	買い上げ
寝つける	寝つけ
染みつく	染みつき
取り集める	取り集め
すぎゆく	すぎゆき
耳馴れる	耳馴れ
ゆるまる	ゆるまり
練り合せる	練り合せ
途切れる	途切れ
かいすすむ	かいすすみ
狂わせる	狂わせ
興せる	興せ
停める	停め
け落とす	け落とし
燃す	燃し
のぼる	のぼり
のぼりつめる	のぼりつめ
うれのこる	うれのこり
酔っ払う	酔っ払い
嘆ずる	酔っ払い
あけくれる	あけくれ
たちまじる	たちまじり
くりあげる	くりあげ
攻懸ける	攻懸け
言い交す	言い交し
かぞえたてる	かぞえたて
ふさぎこむ	ふさぎこみ
伝へる	伝へ
冲する	伝へ
むき出す	むき出し
きりおとせる	きりおとせ
とじる	とじ
着せる	着せ
怨する	着せ
かいま見る	かいま見
いいふくめる	いいふくめ
けむたがる	けむたがり
紛れる	紛れ
取付ける	取付け
築く	築き
拓ける	拓け
引き離す	引き離し
凝固まる	凝固まり
焼き付く	焼き付き
痛めつける	痛めつけ
着替える	着替え
かためる	かため
気構える	気構え
突っつく	突っつき
すりあがる	すりあがり
引下がる	引下がり
いこう	いこい
かぎ出す	かぎ出し
ぼやかす	ぼやかし
みつける	みつけ
綾取る	綾取り
申し出る	申し出
すっぱぬく	すっぱぬき
降らす	降らし
すっぱ抜く	すっぱ抜き
迂る	迂り
すき通る	すき通り
献じる	献じ
ぶっ殺す	ぶっ殺し
支払う	支払い
打破れる	打破れ
産み落す	産み落し
ふりかえる	ふりかえ
出尽くす	出尽くし
つけいる	つけいり
もてはやす	もてはやし
含める	含め
困じる	困じ
かりる	かり
救い出す	救い出し
気に入る	気に入り
窮する	気に入り
ばる	ばり
はしりぬく	はしりぬき
捲く	捲き
てりはえる	てりはえ
おもてだつ	おもてだち
ちかよれる	ちかよれ
零す	零し
膿む	膿み
鋤く	鋤き
せおう	せおい
はりきる	はりきり
入れ忘れる	入れ忘れ
きずきあげる	きずきあげ
決込む	決込み
落ち行く	落ち行き
危惧す	危惧し
おいこせる	おいこせ
貸し付ける	貸し付け
連立つ	連立ち
むすぼれる	むすぼれ
差越す	差越し
芽ばえる	芽ばえ
まぜあわせる	まぜあわせ
汲み干す	汲み干し
執り行う	執り行い
領する	執り行い
走り去る	走り去り
やり合う	やり合い
見守る	見守り
取鎮める	取鎮め
りょうする	取鎮め
ほる	ほり
条件付ける	条件付け
時めく	時めき
ともなえる	ともなえ
たいおうづける	たいおうづけ
つりだす	つりだし
障る	障り
ぞうする	障り
投げかける	投げかけ
たれこむ	たれこみ
およぎつく	およぎつき
捕らえる	捕らえ
つみこめる	つみこめ
たすけだせる	たすけだせ
待受ける	待受け
おびきよせる	おびきよせ
順序づける	順序づけ
あまったれる	あまったれ
とおす	とおし
空嘯く	空嘯き
追い抜ける	追い抜け
夏めく	夏めき
乗掛ける	乗掛け
請け負える	請け負え
据える	据え
毀す	毀し
笑う	笑い
なみいる	なみい
笑いこける	笑いこけ
差しかかる	差しかかり
引っ下げる	引っ下げ
そそる	そそり
殺る	殺り
おびき出す	おびき出し
おっぽりだす	おっぽりだし
乗れる	乗れ
延びる	延び
つりあげる	つりあげ
やきつく	やきつき
はにかむ	はにかみ
向き合える	向き合え
研く	研き
探しあてる	探しあて
捩じ切る	捩じ切り
先ばしる	先ばしり
請け合える	請け合え
いかす	いかし
名乗り出る	名乗り出
混む	混み
すっぱ抜ける	すっぱ抜け
揉める	揉め
まよいこむ	まよいこみ
乱れ飛ぶ	乱れ飛び
則す	則し
当たる	当たり
焼け死ぬ	焼け死に
浮足立つ	浮足立ち
はずせる	はずせ
死そこなう	死そこない
寄り合う	寄り合い
つつめる	つつめ
取調べる	取調べ
列なる	列なり
題する	列なり
はらいのける	はらいのけ
なげとばせる	なげとばせ
えきする	なげとばせ
督する	なげとばせ
振り向ける	振り向け
ならす	ならし
はさみこむ	はさみこみ
とりのける	とりのけ
たっとぶ	たっとび
付く	付き
寄り倒せる	寄り倒せ
嫉む	嫉み
くたばる	くたばり
加わる	加わり
汲み上げる	汲み上げ
乗りはずす	乗りはずし
はらむ	はらみ
絞りあげる	絞りあげ
出食わす	出食わし
くんずる	出食わし
済ませる	済ませ
なしとげる	なしとげ
釣る	釣り
富む	富み
取計らう	取計らい
そばだてる	そばだて
ほつす	ほつし
切り出せる	切り出せ
流れ着ける	流れ着け
言い終わる	言い終わり
駆けつける	駆けつけ
みなせる	みなせ
のく	のき
くぼむ	くぼみ
読み取る	読み取り
うたえる	うたえ
にげまわれる	にげまわれ
類する	にげまわれ
立つ	立ち
おっしゃる	おっしゃり
弱る	弱り
サジェストする	弱り
写し取る	写し取り
泣き暮す	泣き暮し
受け流す	受け流し
サボる	サボり
張合う	張合い
絆される	絆され
張り替える	張り替え
引き渡せる	引き渡せ
掻い潜る	掻い潜り
もれる	もれ
ききあわす	ききあわし
もらえる	もらえ
差し迫る	差し迫り
撲る	撲り
擲つ	擲ち
割り振る	割り振り
鳴りわたる	鳴りわたり
ちがえる	ちがえ
しだれる	しだれ
くるめる	くるめ
いざなう	いざない
ごまかせる	ごまかせ
囁く	囁き
ずれる	ずれ
あけのこる	あけのこり
ひきつげる	ひきつげ
すべらす	すべらし
ぶん殴る	ぶん殴り
言い古す	言い古し
ついて行く	ついて行き
立直す	立直し
まにあう	まにあい
下がる	下がり
吹かす	吹かし
住み馴れる	住み馴れ
はじる	はじ
見せ掛ける	見せ掛け
ぶった斬る	ぶった斬り
こたえる	こたえ
蒸返す	蒸返し
踏み倒せる	踏み倒せ
鳴き頻る	鳴き頻り
たどる	たどり
時代掛る	時代掛り
踊りあかす	踊りあかし
踏みこむ	踏みこみ
吹きこぼれる	吹きこぼれ
頭立つ	頭立ち
おびきだす	おびきだし
もの問う	もの問い
つぎこめる	つぎこめ
そくする	つぎこめ
貯まる	貯まり
すりぬける	すりぬけ
比える	比え
くり貫ける	くり貫け
かすれる	かすれ
格式張る	格式張り
ふくらす	ふくらし
なんずる	ふくらし
踏こたえる	踏こたえ
踊れる	踊れ
書き残せる	書き残せ
なきふせる	なきふせ
逃うせる	逃うせ
たせる	たせ
休める	休め
いわう	いわい
攻寄る	攻寄り
そびれる	そびれ
ねすごす	ねすごし
聞き漏らす	聞き漏らし
溶ける	溶け
うつりすむ	うつりすみ
贈る	贈り
受け引く	受け引き
上回る	上回り
とびこす	とびこし
あぐむ	あぐみ
もうける	もうけ
ありふれる	ありふれ
はみでる	はみで
起こる	起こり
裏付ける	裏付け
こくする	裏付け
とりたてる	とりたて
馴らす	馴らし
たける	たけり
くみしく	くみしき
隔たる	隔たり
つぎ足す	つぎ足し
みそれる	みそれ
ちぬる	ちぬり
にせる	にせ
鳴かせる	鳴かせ
裏づける	裏づけ
こぎつける	こぎつけ
絡み合う	絡み合い
鳴ける	鳴け
賑わわす	賑わわし
いいあてる	いいあて
解ける	解け
差かかる	差かかり
住み荒らす	住み荒らし
ねしずまる	ねしずまり
染める	染め
打ちきる	打ちきり
とりあつかう	とりあつかい
先んじる	先んじ
世馴れる	世馴れ
はぶく	はぶき
写し取れる	写し取れ
うえこむ	うえこみ
泣き込む	泣き込み
突っ張る	突っ張り
すいこむ	すいこみ
まぬがれる	まぬがれ
引替える	引替え
とおりぬける	とおりぬけ
適する	とおりぬけ
打明ける	打明け
思いこむ	思いこみ
博する	思いこみ
満ちる	満ち
むけなおす	むけなおし
白ける	白け
申しつける	申しつけ
すすばむ	すすばみ
ゆきつく	ゆきつき
いいくらす	いいくらし
はい出す	はい出し
生み出す	生み出し
たのみいる	たのみいり
まぎれこめる	まぎれこめ
はばたける	はばたけ
差し掛る	差し掛り
かきあらわせる	かきあらわせ
こめる	こめ
とりだす	とりだし
せめあう	せめあい
きる	き
こまねく	こまねき
信じる	信じ
込入る	込入り
ほろぶ	ほろび
論ずる	ほろび
うちかてる	うちかて
おりかさねる	おりかさね
ぶり返す	ぶり返し
広まる	広まり
引きちぎる	引きちぎり
突ける	突け
がさつく	がさつき
恋いこがれる	恋いこがれ
ふっきる	ふっきり
頼れる	頼れ
召寄せる	召寄せ
ひえこむ	ひえこみ
顰める	顰め
踏みにじれる	踏みにじれ
食いつなぐ	食いつなぎ
そうけだつ	そうけだち
取り付く	取り付き
たてかける	たてかけ
かきわける	かきわけ
聴き込む	聴き込み
あやかる	あやかり
説きあるく	説きあるき
ふりきる	ふりきり
せめよる	せめより
蒸れる	蒸れ
あらいおとせる	あらいおとせ
連れ出す	連れ出し
よりきれる	よりきれ
言いくらす	言いくらし
のっとる	のっとり
抱える	抱え
へし合う	へし合い
とりはらう	とりはらい
冷やかせる	冷やかせ
嘆き明かす	嘆き明かし
刈取る	刈取り
ともる	ともり
称する	ともり
ほっつく	ほっつき
撃ちまくる	撃ちまくり
ほろびる	ほろび
みまわれる	みまわれ
かさむ	かさみ
融ける	融け
申し送る	申し送り
売り付ける	売り付け
だしぬける	だしぬけ
ひっくりかえる	ひっくりかえり
詰め替える	詰め替え
問える	問え
刻する	問え
踏みつける	踏みつけ
信じ込む	信じ込み
照り返す	照り返し
選り分ける	選り分け
くいる	くい
ゆうする	くい
乗入れる	乗入れ
注する	乗入れ
ゆるぐ	ゆるぎ
断ち割れる	断ち割れ
受け持てる	受け持て
吹き荒れる	吹き荒れ
見えすく	見えすき
となりあわせる	となりあわせ
あいなる	あいなり
求める	求め
置き換わる	置き換わり
たれる	たれ
うら枯れる	うら枯れ
沸き起こる	沸き起こり
ねぐる	ねぐり
押し広める	押し広め
みすます	みすまし
樵る	樵り
寝せる	寝せ
吹き返す	吹き返し
ささえる	ささえ
染めあげる	染めあげ
とりかえせる	とりかえせ
もりつける	もりつけ
索く	索き
ちぎれる	ちぎれ
脂ぎる	脂ぎり
思い描く	思い描き
ぬかる	ぬかり
かいとる	かいとり
かもす	かもし
くつろげる	くつろげ
そびえる	そびえ
遮る	遮り
くつろぐ	くつろぎ
遊び呆ける	遊び呆け
明ける	明け
につく	につき
せき入る	せき入り
澄み渡る	澄み渡り
ひきだす	ひきだし
言う	言い
のさばる	のさばり
みちる	みち
ひらける	ひらけ
鼻白む	鼻白み
いてる	いて
馴れる	馴れ
なまめく	なまめき
くれる	くれ
おしかぶさる	おしかぶさり
まくし立てる	まくし立て
接ぎ合わせる	接ぎ合わせ
かきおろす	かきおろし
差止める	差止め
きりかける	きりかけ
絶え入る	絶え入り
浮き上がれる	浮き上がれ
持ち切る	持ち切り
拵える	拵え
かみころせる	かみころせ
あきれかえる	あきれかえり
はげ上がる	はげ上がり
とり成す	とり成し
慨する	とり成し
飲み干せる	飲み干せ
揺出る	揺出
付け入る	付け入り
かぎだせる	かぎだせ
おもねる	おもねり
拐かす	拐かし
ねむらせる	ねむらせ
しゃべれる	しゃべれ
云う	云い
さしまわす	さしまわし
噴く	噴き
呼び交す	呼び交し
あなどれる	あなどれ
ぶっつかる	ぶっつかり
立ち添う	立ち添い
重る	重り
くみだせる	くみだせ
すすみでる	すすみで
架する	すすみで
復す	復し
ふける	ふけり
嗅ぎ付ける	嗅ぎ付け
事える	事え
希う	希い
酌み交す	酌み交し
聞かす	聞かし
進み出る	進み出
さまよう	さまよい
敷ける	敷け
吸う	吸い
みじろぐ	みじろぎ
もりあわす	もりあわし
ぶったくる	ぶったくり
ついてる	ついて
ばらまく	ばらまき
かぎあてる	かぎあて
かち取る	かち取り
つなぐ	つなぎ
漬込む	漬込み
引き続ける	引き続け
追使う	追使い
乗り遅れる	乗り遅れ
放り込む	放り込み
差し当る	差し当り
讒する	差し当り
見える	見え
見越せる	見越せ
聴き入る	聴き入り
仕掛る	仕掛
混じえる	混じえ
しぼりとれる	しぼりとれ
ふきとれる	ふきとれ
剃り忘れる	剃り忘れ
こんずる	剃り忘れ
たわめる	たわめ
創れる	創れ
締める	締め
取りはずす	取りはずし
談じ込む	談じ込み
決定づける	決定づけ
出し抜ける	出し抜け
だきおこせる	だきおこせ
言い落す	言い落し
吹き抜ける	吹き抜け
あざむく	あざむき
言い合う	言い合い
うぬぼれる	うぬぼれ
浮き出る	浮き出
埋めあわせる	埋めあわせ
かき揚げる	かき揚げ
はぐくむ	はぐくみ
取り残す	取り残し
見澄ます	見澄まし
うちだせる	うちだせ
ことなる	ことなり
捕える	捕え
空うそぶく	空うそぶき
遠のく	遠のき
先立てる	先立て
練れる	練れ
さとせる	さとせ
いりまじる	いりまじり
留まれる	留まれ
突き破れる	突き破れ
取り逃す	取り逃し
よじる	よじ
お目にかかる	お目にかかり
じゃらす	じゃらし
濁らす	濁らし
聞出す	聞出し
促す	促し
飲み乾す	飲み乾し
深ける	深け
うなづく	うなづき
とびあがる	とびあがり
寄添う	寄添い
拝み倒す	拝み倒し
とおざかる	とおざかり
映し出せる	映し出せ
行暮れる	行暮れ
買い付ける	買い付け
ひきいる	ひきい
くりかえる	くりかえ
ハヤる	ハヤり
呑み潰れる	呑み潰れ
あらいあげる	あらいあげ
焼き捨てる	焼き捨て
しにそこなう	しにそこない
伸びる	伸び
乗る	乗り
睨み付ける	睨み付け
しなだれる	しなだれ
取り込む	取り込み
引き締る	引き締り
差換える	差換え
捩じ込む	捩じ込み
払いのける	払いのけ
煮立つ	煮立ち
さそいかける	さそいかけ
被せる	被せ
くつがえせる	くつがえせ
そぼふる	そぼふり
はげあがる	はげあがり
聞く	聞き
あたれる	あたれ
懲らしめる	懲らしめ
そめわける	そめわけ
差掛る	差掛り
折合う	折合い
託する	折合い
ぬいあげる	ぬいあげ
乗り合せる	乗り合せ
うたいあげる	うたいあげ
なきわめく	なきわめき
書きつける	書きつけ
締出す	締出し
無くする	締出し
けいする	締出し
にじり寄る	にじり寄り
辿れる	辿れ
苦りきる	苦りきり
ひやかす	ひやかし
愚痴る	愚痴り
毟る	毟り
打ち倒す	打ち倒し
てきする	打ち倒し
えがきだせる	えがきだせ
遣り遂げる	遣り遂げ
稔る	稔り
きりこめる	きりこめ
よみあげる	よみあげ
いつわる	いつわり
たれこめる	たれこめ
飛かける	飛かけり
取り締まる	取り締まり
ずらせる	ずらせ
とりされる	とりされ
買いたたける	買いたたけ
いこぼれる	いこぼれ
くみする	いこぼれ
浮かせる	浮かせ
応える	応え
侵せる	侵せ
そそりたつ	そそりたち
探り出す	探り出し
言い交わす	言い交わし
ぬくもる	ぬくもり
持崩す	持崩し
ちぢみあがる	ちぢみあがり
窄む	窄み
厭う	厭い
はやらす	はやらし
おっぱじめる	おっぱじめ
望める	望め
なりひびく	なりひびき
証する	なりひびき
省ける	省け
たまる	たまり
あらいたてる	あらいたて
逃げ回れる	逃げ回れ
うちころす	うちころし
張付ける	張付け
すすめる	すすめ
懲らす	懲らし
涌く	涌き
しょうする	涌き
はしりだす	はしりだし
しわばむ	しわばみ
心がける	心がけ
突抜ける	突抜け
為さる	為さり
擦りむく	擦りむき
売り抜ける	売り抜け
つうがる	つうがり
すみかえる	すみかえ
あらせる	あらせ
さわぎたてる	さわぎたて
得る	さわぎたて
なつける	なつけ
染返す	染返し
立ち上る	立ち上り
あわだてる	あわだて
よみながす	よみながし
下びる	下び
おさめる	おさめ
張り巡らせる	張り巡らせ
ひろがる	ひろがり
ぎむづける	ぎむづけ
かりあつめる	かりあつめ
行き逢う	行き逢い
闌ける	闌け
溜まる	溜まり
心する	溜まり
修める	修め
みほれる	みほれ
でっちあげる	でっちあげ
すくいだす	すくいだし
困り果てる	困り果て
受け付ける	受け付け
申し述べる	申し述べ
問い質す	問い質し
捧ぐ	捧げ
燃え盛る	燃え盛り
寄せつける	寄せつけ
篭もれる	篭もれ
鳴り響く	鳴り響き
蹴っ飛ばす	蹴っ飛ばし
いきづく	いきづき
こまりぬく	こまりぬき
沁む	沁み
うちたおす	うちたおし
触れ合う	触れ合い
持ちこたえる	持ちこたえ
馳せる	馳せ
おりこむ	おりこみ
ふく	ふき
振回す	振回し
ねがえる	ねがえり
こづきまわす	こづきまわし
火取る	火取り
履違える	履違え
とりもどす	とりもどし
乗じる	乗じ
切る	切り
ひろめる	ひろめ
引き出せる	引き出せ
弥立つ	弥立ち
かち得る	かち得
啄める	啄め
かきくどく	かきくどき
取り捨てる	取り捨て
めぐらす	めぐらし
差しかざす	差しかざし
よる	より
召抱える	召抱え
ひかえる	ひかえ
きかざる	きかざり
下押す	下押し
押し下げる	押し下げ
ねとぼける	ねとぼけ
やじれる	やじれ
急く	急き
しかれる	しかれ
いきりたつ	いきりたち
細る	細り
とろかす	とろかし
取り計らえる	取り計らえ
刺せる	刺せ
聞きあわせる	聞きあわせ
くずれおちる	くずれおち
はげむ	はげみ
ほうこうづける	ほうこうづけ
語り掛ける	語り掛け
埋ける	埋け
這出る	這出
跳あがる	跳あがり
もげる	もげ
アガる	アガり
落ちつく	落ちつき
しぼりあげる	しぼりあげ
込む	込み
踏込む	踏込み
めくれる	めくれ
飛付く	飛付き
引渡す	引渡し
絞まる	絞まり
寝転がる	寝転がり
ぬけあがる	ぬけあがり
示し合わせる	示し合わせ
漬けこむ	漬けこみ
実る	実り
いく	いき
特徴付ける	特徴付け
送りだす	送りだし
住める	住め
縮みあがる	縮みあがり
よみこめる	よみこめ
買い尽くす	買い尽くし
衝ける	衝け
またがる	またがり
はぜる	はぜ
まなびとる	まなびとり
乗り過ごす	乗り過ごし
並ぶ	並び
取り離せる	取り離せ
孕む	孕み
いりこむ	いりこみ
いきごむ	いきごみ
よみあわせる	よみあわせ
くらえる	くらえ
吹き出す	吹き出し
ひきずりこめる	ひきずりこめ
おきだす	おきだし
呈す	呈し
起き上がる	起き上がり
降り頻る	降り頻り
さえぎれる	さえぎれ
ためせる	ためせ
委ねる	委ね
引き繕う	引き繕い
ひびく	ひびき
殖やす	殖やし
連れ添う	連れ添い
いばる	いばり
もりあげる	もりあげ
立て替える	立て替え
甘んじる	甘んじ
掃ける	掃け
浮かれ出でる	浮かれ出で
底知る	底知り
散りばめる	散りばめ
乗切る	乗切り
ぬいこめる	ぬいこめ
いんする	ぬいこめ
鳴く	鳴き
通す	通し
ひろいあげる	ひろいあげ
稼げる	稼げ
待ち望む	待ち望み
登る	登り
超せる	超せ
みむく	みむき
寝つく	寝つき
言合う	言合い
なずむ	なずみ
臨む	臨み
押し倒す	押し倒し
飛歩く	飛歩き
駈ける	駈け
引き摺り込む	引き摺り込み
悄げる	悄げ
でまわる	でまわり
織り成す	織り成し
つっつく	つっつき
致す	致し
根付く	根付き
きりかえる	きりかえ
はぎあわす	はぎあわし
言含める	言含め
うとむ	うとみ
寄すがる	寄すがり
謗る	謗り
閉こもる	閉こもり
みあげる	みあげ
追いたてる	追いたて
うかる	うかり
攻立てる	攻立て
抱きすくめる	抱きすくめ
間ぎる	間ぎり
ながれだす	ながれだし
払い出せる	払い出せ
蒸し返す	蒸し返し
回れる	回れ
みなぎる	みなぎり
曝せる	曝せ
まぜる	まぜ
こぼれ落ちる	こぼれ落ち
頼み込める	頼み込め
まちわびる	まちわび
引止める	引止め
寸たる	寸たり
薦める	薦め
押す	押し
合わさる	合わさり
歩む	歩み
如く	如き
鞘走る	鞘走り
まんずる	鞘走り
こごめる	こごめ
ふらせる	ふらせ
すわれる	すわれ
連込む	連込み
在す	在し
みだす	みだし
こわれる	こわれ
磨り潰す	磨り潰し
あぶる	あぶり
利かす	利かし
売りとばす	売りとばし
そんする	売りとばし
つみかさなる	つみかさなり
仕える	仕え
拗る	拗り
買受ける	買受け
透く	透き
怒鳴る	怒鳴り
萎びる	萎び
扱う	扱い
ながれつく	ながれつき
られる	られ
切込む	切込み
差し置く	差し置き
見返る	見返り
まさる	まさり
鎧う	鎧い
早まる	早まり
隠せる	隠せ
熟む	熟み
しがみつける	しがみつけ
ついえる	ついえ
かむる	かむり
呵する	かむり
討ちとる	討ちとり
しるせる	しるせ
血塗る	血塗り
降り敷く	降り敷き
書く	書き
嵩じる	嵩じ
もちあがる	もちあがり
吸う	吸い
もだえる	もだえ
追い回せる	追い回せ
食わす	食わし
思す	思し
書きいれる	書きいれ
ふきとばす	ふきとばし
感じ取れる	感じ取れ
いいふらす	いいふらし
散り敷く	散り敷き
奪う	奪い
ねぎらう	ねぎらい
働く	働き
競える	競え
たかまる	たかまり
捻れる	捻れ
そだてあげる	そだてあげ
縺れる	縺れ
亙れる	亙れ
よみとる	よみとり
あかじみる	あかじみ
はりたおす	はりたおし
取揃える	取揃え
くくめる	くくめ
差しかける	差しかけ
とどろかす	とどろかし
もやす	もやし
伸す	伸し
討ち果す	討ち果し
むかえうつ	むかえうち
もつれこむ	もつれこみ
寄付く	寄付き
あげつらう	あげつらい
しゃする	あげつらい
偲べる	偲べ
てらせる	てらせ
移り住む	移り住み
延す	延し
そらす	そらし
惘れる	惘れ
言い替える	言い替え
屈す	屈し
寿ぐ	寿ぎ
際立つ	際立ち
違える	違え
そそのかす	そそのかし
来す	来し
並べたてる	並べたて
相せっする	並べたて
盾突く	盾突き
くすべる	くすべ
突っこむ	突っこみ
はれわたる	はれわたり
あぶれる	あぶれ
組みいれる	組みいれ
つどう	つどい
めばえる	めばえ
蓄える	蓄え
いつく	いつき
見渡す	見渡し
たとえる	たとえ
とけこむ	とけこみ
赤茶ける	赤茶け
背負い込める	背負い込め
切掛ける	切掛け
おびく	おびき
漲る	漲り
背負い込む	背負い込み
落ち合える	落ち合え
かりたおす	かりたおし
ふりまける	ふりまけ
とける	とけ
差出る	差出
おいこめる	おいこめ
なめる	なめ
たくれる	たくれ
騒ぎ立てる	騒ぎ立て
繋ぐ	繋ぎ
にこめる	にこめ
おもいおこせる	おもいおこせ
遂せる	遂せ
煮込む	煮込み
つっかえる	つっかえ
横切る	横切り
勘ぐる	勘ぐり
遊び回る	遊び回り
外れる	外れ
切結ぶ	切結び
かずく	かずき
つけだす	つけだし
あいつづく	あいつづき
守立てる	守立て
のたまう	のたまい
窮める	窮め
落とす	落とし
うけとめる	うけとめ
行き交う	行き交い
降る	降り
買いかぶる	買いかぶり
思い出す	思い出し
受かる	受かり
はりあわせる	はりあわせ
くみあわせる	くみあわせ
絶やす	絶やし
齧り付く	齧り付き
おこないすます	おこないすまし
呑みこむ	呑みこみ
具わる	具わり
送り出せる	送り出せ
いっする	送り出せ
塞く	塞き
仕る	仕り
突っぷす	突っぷし
もみけせる	もみけせ
吸える	吸え
つきあう	つきあい
きざむ	きざみ
敬する	きざみ
しゃちこばる	しゃちこばり
弾き出せる	弾き出せ
宛てる	宛て
選りすぐる	選りすぐり
思い止まる	思い止まり
ふりあてる	ふりあて
打ち立てる	打ち立て
欲する	打ち立て
なめす	なめし
食む	食み
即ける	即け
駆け抜ける	駆け抜け
染み着く	染み着き
増す	増し
沸き立つ	沸き立ち
駆ける	駆け
すう	すい
受け取る	受け取り
たくる	たくり
蒸す	蒸し
透通る	透通り
老け込む	老け込み
見倣う	見倣い
持出す	持出し
限る	限り
しにわかれる	しにわかれ
つっころばす	つっころばし
図る	図り
手なれる	手なれ
あるきつめる	あるきつめり
忘れ去る	忘れ去り
忍べる	忍べ
交わせる	交わせ
取払う	取払い
くゆらす	くゆらし
打ち消す	打ち消し
厭きる	厭き
行きかかる	行きかかり
覆う	覆い
読み比べる	読み比べ
役に立つ	役に立ち
滑り降ちる	滑り降ち
おがみたおす	おがみたおし
盛り合わせる	盛り合わせ
なぐれる	なぐれ
突き戻す	突き戻し
あり	あり
追抜く	追抜き
ひやす	ひやし
ひきつづく	ひきつづき
響かす	響かし
駆り催す	駆り催し
送り付ける	送り付け
仕組む	仕組み
磨きあげる	磨きあげ
湿る	湿り
ぱらつく	ぱらつき
攫む	攫み
先立つ	先立ち
分かる	分かり
股がる	股がり
倒れ込む	倒れ込み
ひるがえる	ひるがえり
見つける	見つけ
褒めちぎる	褒めちぎり
取り払う	取り払い
駆出す	駆出し
取り押さえる	取り押さえ
釣り込む	釣り込み
けしとめる	けしとめ
上廻る	上廻り
転がれる	転がれ
とりのぞく	とりのぞき
打勝つ	打勝ち
寄りかかる	寄りかかり
溶けだす	溶けだし
せいだす	せいだし
さそいだす	さそいだし
かきさす	かきさし
飲みこむ	飲みこみ
蘇る	蘇り
掛け合う	掛け合い
かいだす	かいだし
打ち落す	打ち落し
穫る	穫り
妻せる	妻せ
じらす	じらし
あふる	あふり
ムキになる	ムキになり
食入る	食入り
言い聞かす	言い聞かし
聞き咎める	聞き咎め
よみきる	よみきり
取らせる	取らせ
ねむりこける	ねむりこけ
名乗る	名乗り
過ぎる	過ぎり
とりはなす	とりはなし
いいそびれる	いいそびれ
ぎんじる	ぎんじ
絞り出す	絞り出し
乗り越す	乗り越し
おしたおせる	おしたおせ
かどだてる	かどだて
染直す	染直し
こしかける	こしかけ
にげこめる	にげこめ
ぬりつぶせる	ぬりつぶせ
よごれる	よごれ
ゆるむ	ゆるみ
突き上げる	突き上げ
ふれこめる	ふれこめ
据え置く	据え置き
灯す	灯し
入り替る	入り替り
投げ入れる	投げ入れ
居こぼれる	居こぼれ
外らす	外らし
もりこむ	もりこみ
腫らす	腫らし
繰りかえす	繰りかえし
誉めそやす	誉めそやし
ききとどける	ききとどけ
すっぱぬける	すっぱぬけ
ぼやく	ぼやき
掻き合せる	掻き合せ
そがれる	そがれ
食い足りる	食い足り
荒し回る	荒し回り
解く	解き
ぶれる	ぶれ
つめこむ	つめこみ
ちかよる	ちかより
仕付ける	仕付け
拘る	拘り
投げ掛ける	投げ掛け
遣り過す	遣り過し
揺る	揺り
薙ぎ倒す	薙ぎ倒し
かき曇る	かき曇り
うそぶく	うそぶき
せきとめる	せきとめ
浮きでる	浮きで
ひかる	ひかり
突きつける	突きつけ
掛かれる	掛かれ
ふり合う	ふり合い
みつ	みち
換える	換え
とりなす	とりなし
張切る	張切り
渋る	渋り
啓する	渋り
蠢かす	蠢かし
おしかえせる	おしかえせ
堪える	堪え
遣える	遣え
すみこめる	すみこめ
貸せる	貸せ
飛びのれる	飛びのれ
仰せ付ける	仰せ付け
毳立つ	毳立ち
よぎる	よぎり
黙りこくる	黙りこくり
る	黙りこくり
沸き返る	沸き返り
往ける	往け
張り合わせる	張り合わせ
ぶらさがる	ぶらさがり
すくう	すくい
狩り出す	狩り出し
取り掛る	取り掛り
申渡す	申渡し
称える	称え
入り込む	入り込み
すりへる	すりへり
装う	装い
立てる	立て
おもいあまる	おもいあまり
もやう	もやい
もちよれる	もちよれ
いいかえせる	いいかえせ
とじ込む	とじ込み
入り切る	入り切り
陰る	陰り
塞き止める	塞き止め
はずむ	はずみ
染め付ける	染め付け
ねりなおす	ねりなおし
取かかる	取かかり
ぐらつく	ぐらつき
押分ける	押分け
なごむ	なごみ
いのこれる	いのこれ
劣る	劣り
吹出す	吹出し
とぼける	とぼけ
とびつける	とびつけ
酌み交わす	酌み交わし
掻ける	掻け
立返る	立返り
違う	違い
ムシる	ムシり
する	すり
おもいつめる	おもいつめ
解き放す	解き放し
言い切る	言い切り
参る	参り
要す	要し
病ほうける	病ほうけ
かみしずまる	かみしずまり
すわる	すわり
微笑む	微笑み
刷込む	刷込み
延ばせる	延ばせ
在り合わせる	在り合わせ
組みあわせる	組みあわせ
挿す	挿し
探し当てる	探し当て
絶える	絶え
つぶやく	つぶやき
練り合わす	練り合わし
おぢゃる	おぢゃり
ゆめみる	ゆめみ
みそこなう	みそこない
まぜっ返す	まぜっ返し
つみこむ	つみこみ
誦する	つみこみ
截つ	截ち
うめあわせる	うめあわせ
しこなす	しこなし
織り込む	織り込み
押え込む	押え込み
ささやく	ささやき
うつむく	うつむき
積み立てる	積み立て
差繰る	差繰り
たちよれる	たちよれ
死に別れる	死に別れ
掘り起こす	掘り起こし
とざす	とざし
あまる	あまり
合せる	合せ
組敷く	組敷き
接ぎ合わす	接ぎ合わし
哭する	接ぎ合わし
待ちわびる	待ちわび
とびおりる	とびおり
斎く	斎き
彫りつける	彫りつけ
なる	なり
とくせいづける	とくせいづけ
張り出せる	張り出せ
課する	張り出せ
持ち替える	持ち替え
むし返す	むし返し
背負える	背負え
下り立つ	下り立ち
みがきこむ	みがきこみ
ひっぱたく	ひっぱたき
かり出す	かり出し
もえでる	もえで
潜り込む	潜り込み
いれちがう	いれちがい
浮かされる	浮かされ
べんする	浮かされ
摺る	摺り
見送る	見送り
いいわたす	いいわたし
尖る	尖り
おとなう	おとない
でっぱる	でっぱり
いけどる	いけどり
打殺す	打殺し
うつぶせる	うつぶせ
きせる	きせ
昇る	昇り
突き抜く	突き抜き
たたる	たたり
追い廻す	追い廻し
黒める	黒め
かじる	かじり
きりたてる	きりたて
蒔ける	蒔け
しめ殺す	しめ殺し
読みとる	読みとり
定める	定め
抜け出せる	抜け出せ
焚き付ける	焚き付け
うやまえる	うやまえ
といかける	といかけ
切りあげる	切りあげ
準ずる	切りあげ
守れる	守れ
処する	守れ
差し控える	差し控え
いやしめる	いやしめ
うばいとれる	うばいとれ
きりかえす	きりかえし
懐かしむ	懐かしみ
凪ぐ	凪ぎ
得	得
撰べる	撰べ
発つ	発ち
晦ます	晦まし
繰りあわせる	繰りあわせ
熬る	熬り
掴む	掴み
うしなう	うしない
もらう	もらい
恥じ入る	恥じ入り
のりいれる	のりいれ
きらわれる	きらわれ
ふかまる	ふかまり
恕する	ふかまり
悪びれる	悪びれ
聞きかじる	聞きかじり
咲き残る	咲き残り
言ひ現す	言ひ現し
そばめる	そばめ
絡みつく	絡みつき
包み込む	包み込み
うかされる	うかされ
ひっこむ	ひっこみ
魅する	ひっこみ
引っ括る	引っ括り
飛びつける	飛びつけ
差し翳す	差し翳し
とりむすぶ	とりむすび
朽果てる	朽果て
温まる	温まり
振り出せる	振り出せ
のしあがれる	のしあがれ
たちこめる	たちこめ
掻きむしる	掻きむしり
引継ぐ	引継ぎ
こんがらかる	こんがらかり
堪忍ぶ	堪忍び
建て替える	建て替え
抱着く	抱着き
ぶらつく	ぶらつき
申し渡す	申し渡し
よろける	よろけ
たたく	たたき
映せる	映せ
まかりまちがう	まかりまちがい
かせぐ	かせぎ
冷え込む	冷え込み
せる	せ
きりだせる	きりだせ
植え付ける	植え付け
舞う	舞い
染分ける	染分け
分つ	分ち
行詰る	行詰り
嗄らす	嗄らし
越す	越し
丸まる	丸まり
書付ける	書付け
いく	いき
請合う	請合い
ひろえる	ひろえ
脱げる	脱げ
討果す	討果し
つかいふるす	つかいふるし
扱き使う	扱き使い
入浸る	入浸り
焦らす	焦らし
覚る	覚り
ぬる	ぬり
すみつく	すみつき
繰替える	繰替え
きりはずす	きりはずし
建て込む	建て込み
騒ぐ	騒ぎ
おしだす	おしだし
おしつまる	おしつまり
まいおりる	まいおり
ガンバる	ガンバり
おどる	おどり
向う	向い
付けかえる	付けかえ
慶する	付けかえ
見計らえる	見計らえ
視る	視
引っこめる	引っこめ
こころする	引っこめ
語りこむ	語りこみ
否める	否め
おとなびる	おとなび
ひっ込む	ひっ込み
くばる	くばり
のりすてる	のりすて
でむける	でむけ
攻め寄せる	攻め寄せ
はめ込む	はめ込み
聞きそこなう	聞きそこない
貪る	貪り
みこせる	みこせ
許す	許し
薄める	薄め
抜け落ちる	抜け落ち
届く	届き
狭める	狭め
出掛ける	出掛け
ことよせる	ことよせ
ほっぽらかす	ほっぽらかし
併せ持つ	併せ持ち
投げつける	投げつけ
落籍す	落籍し
ぱくる	ぱくり
踏み均す	踏み均し
たぐう	たぐい
ざわつく	ざわつき
突きあわす	突きあわし
構う	構い
ねじあげる	ねじあげ
終わる	終わり
育くむ	育くみ
さぐれる	さぐれ
繕える	繕え
諾う	諾い
切り下げる	切り下げ
みおくれる	みおくれ
生まれる	生まれ
しゃしゃりでる	しゃしゃりで
見守れる	見守れ
ひきたてる	ひきたて
祝う	祝い
打ち砕ける	打ち砕け
問う	問い
くみふせる	くみふせ
かいもとめる	かいもとめ
ひしゃげる	ひしゃげ
ふきとぶ	ふきとび
濡らす	濡らし
踏みならす	踏みならし
位置づける	位置づけ
ああなる	ああなり
静まりかえる	静まりかえり
迫れる	迫れ
吸い上げる	吸い上げ
呼び出す	呼び出し
落ち込む	落ち込み
しゅくする	落ち込み
食延す	食延し
仕切る	仕切り
宣う	宣い
ふりまわす	ふりまわし
置きかわる	置きかわり
代わる	代わり
すなどる	すなどり
問い合せる	問い合せ
いいおとす	いいおとし
つっぱしれる	つっぱしれ
ほうりこむ	ほうりこみ
参する	ほうりこみ
労う	労い
とらえる	とらえ
泡立つ	泡立ち
とおのける	とおのけ
まがえる	まがえ
こうじる	こうじ
かき落とす	かき落とし
やり返す	やり返し
にたてる	にたて
くすねる	くすね
ないまぜる	ないまぜ
織りあげる	織りあげ
さそえる	さそえ
塗りつける	塗りつけ
弄する	塗りつけ
揮う	揮い
下げ渡す	下げ渡し
怒る	怒り
逃げ惑う	逃げ惑い
飼える	飼え
騒げる	騒げ
だぶる	だぶり
あたためる	あたため
ものがたる	ものがたり
たのめる	たのめ
伴える	伴え
追い出す	追い出し
きれこむ	きれこみ
ひっこめる	ひっこめ
めいする	ひっこめ
入込む	入込み
檄する	入込み
貯える	貯え
聞ほれる	聞ほれ
与太る	与太り
隣る	隣り
いぶす	いぶし
ゆずりわたせる	ゆずりわたせ
かみあう	かみあい
為し遂げる	為し遂げ
突き落とす	突き落とし
駆る	駆り
歌いまくる	歌いまくり
積み重なる	積み重なり
うちはらう	うちはらい
餓える	餓え
染め分ける	染め分け
囲める	囲め
食い切る	食い切り
気取る	気取り
わずらわす	わずらわし
生茂る	生茂り
有りあわせる	有りあわせ
しいれる	しいれ
とりこわせる	とりこわせ
ながびく	ながびき
こみ上げる	こみ上げ
閉じこもる	閉じこもり
きめる	きめ
おしつぶす	おしつぶし
刺通す	刺通し
うばう	うばい
気ばる	気ばり
勇む	勇み
謹む	謹み
でおくれる	でおくれ
まとう	まとい
ちる	ちり
煩わせる	煩わせ
よみかえる	よみかえ
かきこめる	かきこめ
たきあげる	たきあげ
通り過ぎる	通り過ぎ
なりかわる	なりかわり
偏る	偏り
振る	振り
なで上げる	なで上げ
相手取る	相手取り
まかす	まかし
裏切れる	裏切れ
刻む	刻み
梱る	梱り
こぞる	こぞり
さかだてる	さかだて
見交す	見交し
降りる	降り
遂げる	遂げ
書き抜ける	書き抜け
鳴かす	鳴かし
かこめる	かこめ
仕うまつる	仕うまつり
やどす	やどし
揺らぐ	揺らぎ
鳴り出す	鳴り出し
かりもよおす	かりもよおし
縫い上げる	縫い上げ
さきこぼれる	さきこぼれ
よこぎれる	よこぎれ
向き合う	向き合い
導き出せる	導き出せ
届け出る	届け出
となえる	となえ
成り代る	成り代り
削れる	削れ
乾びる	乾び
叫べる	叫べ
なさる	なさい
気張れる	気張れ
べた付く	べた付き
ちぎる	ちぎり
やり過ごす	やり過ごし
すわりこむ	すわりこみ
はこびだす	はこびだし
叩きつける	叩きつけ
ほろぼせる	ほろぼせ
宣る	宣り
甲ばしる	甲ばしり
便する	甲ばしり
通ぶる	通ぶり
眠らせる	眠らせ
くり広げる	くり広げ
醸し出す	醸し出し
話し合える	話し合え
まかり出る	まかり出
脅しつける	脅しつけ
解す	解し
いらだつ	いらだち
呼び掛ける	呼び掛け
いいつたえる	いいつたえ
訊ねる	訊ね
聞き澄ます	聞き澄まし
差し替える	差し替え
窄まる	窄まり
更かす	更かし
言募る	言募り
輝かす	輝かし
いすくまる	いすくまり
生まれつく	生まれつき
威ばる	威ばり
まきかえす	まきかえし
失せる	失せ
追い越す	追い越し
染抜く	染抜き
打ち払える	打ち払え
はぎ取れる	はぎ取れ
示せる	示せ
抱取る	抱取り
ほねおる	ほねおり
当て込む	当て込み
待ち兼ねる	待ち兼ね
つづれる	つづれ
うちくだく	うちくだき
出直せる	出直せ
取り持てる	取り持て
つられる	つられ
曝す	曝し
有余る	有余り
ふけこむ	ふけこみ
染め抜く	染め抜き
譲り受ける	譲り受け
罰する	譲り受け
じぶくる	じぶくり
あらだてる	あらだて
戻す	戻し
建て直せる	建て直せ
沸あがる	沸あがり
言消す	言消し
順序付ける	順序付け
凍える	凍え
活気づく	活気づき
ぎする	活気づき
えらぶ	えらび
謝する	えらび
押し進める	押し進め
しずまりかえる	しずまりかえり
はじき飛ばす	はじき飛ばし
荷なう	荷ない
感じ入る	感じ入り
そぼ濡れる	そぼ濡れ
掻き回す	掻き回し
こまりきる	こまりきり
だましとる	だましとり
はらいきよめる	はらいきよめ
取すます	取すまし
だきあげる	だきあげ
なぎたおす	なぎたおし
殴りつける	殴りつけ
備えつける	備えつけ
酔う	酔い
感じとる	感じとり
とりすてる	とりすて
抽んでる	抽んで
震いつく	震いつき
乗付ける	乗付け
奮い起こす	奮い起こし
逃げ込む	逃げ込み
しめる	しめ
おっかける	おっかけ
乗りこむ	乗りこみ
評す	評し
馴染む	馴染み
まばたく	まばたき
つかまえる	つかまえ
おくらせる	おくらせ
ではらう	ではらい
垂んとする	ではらい
そそぎ込む	そそぎ込み
叢る	叢り
取りはからう	取りはからい
深まる	深まり
よみながせる	よみながせ
くださる	ください
あける	あけ
ねぶる	ねぶり
力つきる	力つき
貶める	貶め
つづり合す	つづり合し
散ずる	つづり合し
かきおこす	かきおこし
まつる	まつり
煎じ詰める	煎じ詰め
差上げる	差上げ
取り締る	取り締り
あんじる	あんじ
ちぢれる	ちぢれ
急げる	急げ
慣わす	慣わし
任せる	任せ
めだつ	めだち
たっとべる	たっとべ
たてなおせる	たてなおせ
盛れる	盛れ
さわぎだす	さわぎだし
ゆさぶれる	ゆさぶれ
書き落す	書き落し
謹しむ	謹しみ
架る	架り
吸込む	吸込み
見飽きる	見飽き
捜しあてる	捜しあて
にらみつける	にらみつけ
伸ばせる	伸ばせ
ききいれる	ききいれ
駆ける	駆けり
揉みほぐす	揉みほぐし
かかずらう	かかずらい
逃げのびる	逃げのび
練りあわせる	練りあわせ
つらぬきとおす	つらぬきとおし
続ける	続け
飛びかかれる	飛びかかれ
匿う	匿い
つきはなす	つきはなし
わらう	わらい
渇く	渇き
才ばしる	才ばしり
とおざける	とおざけ
立行く	立行き
ゆらめく	ゆらめき
ぶっとばす	ぶっとばし
頬張る	頬張り
衒う	衒い
薙ぐ	薙ぎ
念ずる	薙ぎ
勘繰る	勘繰り
逃げ込める	逃げ込め
気づかう	気づかい
すき返す	すき返し
ひっ掴む	ひっ掴み
なみする	ひっ掴み
買い切れる	買い切れ
さされる	さされ
結びつける	結びつけ
つっ返す	つっ返し
火照る	火照り
沮む	沮み
解る	解り
見逸れる	見逸れ
芽吹く	芽吹き
こじ開ける	こじ開け
捏ねくる	捏ねくり
かいあたえる	かいあたえ
乾上がる	乾上がり
もぎ取る	もぎ取り
描き出せる	描き出せ
詠込む	詠込み
成り立つ	成り立ち
嗣ぐ	嗣ぎ
みあわせる	みあわせ
にげる	にげ
治せる	治せ
乗っかる	乗っかり
ほくそ笑む	ほくそ笑み
煎り付ける	煎り付け
ものいう	ものいい
出くわす	出くわし
あらいながせる	あらいながせ
引っかく	引っかき
ふくまる	ふくまり
たちわれる	たちわれ
いいなおす	いいなおし
思い過ごす	思い過ごし
つるしあげる	つるしあげ
切り放せる	切り放せ
おもいつく	おもいつき
ゑむ	ゑみ
おもむく	おもむき
目だつ	目だち
通り越す	通り越し
染付く	染付き
とる	とり
打ちだす	打ちだし
だんじこめる	だんじこめ
けっていづける	けっていづけ
とかす	とかし
うちすてる	うちすて
折り返す	折り返し
話し合う	話し合い
老いぼれる	老いぼれ
責めたてる	責めたて
序する	責めたて
彫りこむ	彫りこみ
麾く	麾き
拓く	拓き
書き写す	書き写し
取抑える	取抑え
貸す	貸し
切り落す	切り落し
耳立つ	耳立ち
取扱う	取扱い
関す	関し
ひっかける	ひっかけ
とうとぶ	とうとび
平らげる	平らげ
振りわける	振りわけ
打ち続く	打ち続き
侘びる	侘び
副える	副え
付け回す	付け回し
なきじゃくる	なきじゃくり
すさぶ	すさび
いからす	いからし
切り倒す	切り倒し
もくろむ	もくろみ
くりかえせる	くりかえせ
はなつ	はなち
仕立てる	仕立て
手放す	手放し
糾す	糾し
もみ合う	もみ合い
初める	初め
立通す	立通し
毀つ	毀ち
がっつく	がっつき
みちびける	みちびけ
うけおう	うけおい
遣る	遣り
えぐる	えぐり
早める	早め
隣り合わせる	隣り合わせ
差し招く	差し招き
はねかえせる	はねかえせ
遣わす	遣わし
そげる	そげ
ひん曲げる	ひん曲げ
綴りあわせる	綴りあわせ
取囲む	取囲み
泳ぎ着ける	泳ぎ着け
撃ち止める	撃ち止め
折り込む	折り込み
むかいあえる	むかいあえ
かきよせる	かきよせ
噛み殺す	噛み殺し
取り返せる	取り返せ
睨みあわせる	睨みあわせ
すずむ	すずみ
あたいする	すずみ
ほりだせる	ほりだせ
しらげる	しらげ
思い直す	思い直し
きこなせる	きこなせ
うらむ	うらみ
揉み消す	揉み消し
基く	基き
いいまくる	いいまくり
あとずさる	あとずさり
映ずる	あとずさり
のる	のり
かぞえる	かぞえ
放り出す	放り出し
のばせる	のばせ
釣りあう	釣りあい
ねかせる	ねかせ
売れる	売れ
灯る	灯り
眠れる	眠れ
なやませる	なやませ
かかる	かかり
使う	使い
のりこす	のりこし
干涸らびる	干涸らび
抜きん出る	抜きん出
踏み入れる	踏み入れ
たてこもる	たてこもり
渇れる	渇れ
訴える	訴え
喜ばす	喜ばし
突き詰める	突き詰め
いのれる	いのれ
つき抜ける	つき抜け
耕す	耕し
こじらせる	こじらせ
あざわらう	あざわらい
ぞくす	ぞくし
かげる	かげ
響かせる	響かせ
いきのこれる	いきのこれ
まきおこす	まきおこし
おもえる	おもえ
運び出せる	運び出せ
詠う	詠い
俯せる	俯せ
染透る	染透り
見交わす	見交わし
汗じみる	汗じみ
蒙る	蒙り
おいたつ	おいたち
持ち出せる	持ち出せ
にえくりかえる	にえくりかえり
湧かす	湧かし
取り止める	取り止め
叩ける	叩け
接す	接し
おぶう	おぶい
被う	被い
絡む	絡み
ふう	ふい
すえおく	すえおき
跳ねる	跳ね
引っ付く	引っ付き
襲う	襲い
纏わる	纏わり
にらむ	にらみ
おぼえる	おぼえ
打ちかえす	打ちかえし
れっする	打ちかえし
推量る	推量り
ゆれる	ゆれ
なげこむ	なげこみ
濯ぐ	濯ぎ
ひきずりこむ	ひきずりこみ
なみはずれる	なみはずれ
負う	負い
もぎ取れる	もぎ取れ
聞き合わす	聞き合わし
吸い付ける	吸い付け
感ずる	吸い付け
搾り取る	搾り取り
おちぶれる	おちぶれ
轟く	轟き
不貞腐る	不貞腐り
保する	不貞腐り
鋏める	鋏め
名づける	名づけ
逸する	名づけ
置ける	置け
のりあわせる	のりあわせ
尽きる	尽き
えんづける	えんづけ
差し延べる	差し延べ
かえる	かえり
なす	なし
うちはらえる	うちはらえ
舞い込む	舞い込み
おもんぱかる	おもんぱかり
ぬぐいされる	ぬぐいされ
行い澄ます	行い澄まし
うち捨てる	うち捨て
おいまくる	おいまくり
見すえる	見すえ
極まる	極まり
切る	切り
はねかえす	はねかえし
すっとぼける	すっとぼけ
きえいる	きえいり
取りかたづける	取りかたづけ
駆けだす	駆けだし
擬す	擬し
踏外す	踏外し
争う	争い
散敷く	散敷き
付出す	付出し
込める	込め
立て通す	立て通し
加われる	加われ
引き当てる	引き当て
足掻く	足掻き
纏まる	纏まり
ふれあう	ふれあい
愛し合う	愛し合い
ゆえる	ゆえ
形作れる	形作れ
鎖す	鎖し
盛り返せる	盛り返せ
兼ね備える	兼ね備え
ふりしく	ふりしき
うりきれる	うりきれ
跳ね返せる	跳ね返せ
せり上げる	せり上げ
うちおとせる	うちおとせ
まう	まい
よそおえる	よそおえ
飼い慣らす	飼い慣らし
しゅくす	しゅくし
とくちょうづける	とくちょうづけ
遡る	遡り
みきれる	みきれ
とりいれる	とりいれ
寄かかる	寄かかり
あつかふ	あつかひ
跡付ける	跡付け
不貞腐れる	不貞腐れ
遣れる	遣れ
睨める	睨め
だくする	睨め
並居る	並居
こときれる	こときれ
とりかわす	とりかわし
いいきかす	いいきかし
ねじれる	ねじれ
怯える	怯え
見比べる	見比べ
おしとおせる	おしとおせ
みまわせる	みまわせ
ちぢまる	ちぢまり
いさみたてる	いさみたて
聞過す	聞過し
鏤める	鏤め
浮き出す	浮き出し
うち連れる	うち連れ
納まる	納まり
聞きとがめる	聞きとがめ
言い出す	言い出し
狎れる	狎れ
詠ずる	狎れ
飲みつぶれる	飲みつぶれ
引き付ける	引き付け
ひきはなせる	ひきはなせ
落っこちる	落っこち
戻せる	戻せ
保ち合う	保ち合い
つみわける	つみわけ
頷く	頷き
捩じ合う	捩じ合い
積み出す	積み出し
ちぢくれる	ちぢくれ
押入る	押入り
つきぬける	つきぬけ
言い聞かせる	言い聞かせ
つみだす	つみだし
うまれでる	うまれで
売り出せる	売り出せ
しこる	しこり
めいずる	しこり
かいこめる	かいこめ
つみする	かいこめ
とりつくろう	とりつくろい
諦める	諦め
みがまえる	みがまえ
勇み立てる	勇み立て
釈く	釈き
死ぬ	死に
かる	かり
廻る	廻り
繕う	繕い
祝す	祝し
つれだつ	つれだち
染め直せる	染め直せ
散り急ぐ	散り急ぎ
干あがる	干あがり
擁する	干あがり
はかりこむ	はかりこみ
取りしまる	取りしまり
説き伏せる	説き伏せ
みつもれる	みつもれ
かけ隔たる	かけ隔たり
よびつける	よびつけ
突ぱしる	突ぱしり
降り積もる	降り積もり
拭う	拭い
たたき起す	たたき起し
若やぐ	若やぎ
溶かす	溶かし
まよう	まよい
とびわたる	とびわたり
うけおえる	うけおえ
芽立つ	芽立ち
催す	催し
降ろす	降ろし
泣濡れる	泣濡れ
讀める	讀め
たちきれる	たちきれ
失くなる	失くなり
いろあせる	いろあせ
くるむ	くるみ
撮る	撮り
出逢う	出逢い
恤む	恤み
吹おろす	吹おろし
抜きんでる	抜きんで
防ぐ	防ぎ
下さる	下さい
おぼしめす	おぼしめし
かすめとる	かすめとり
くみあげる	くみあげ
むしり取る	むしり取り
さしまねく	さしまねき
洗い落とす	洗い落とし
かけまわれる	かけまわれ
誑かす	誑かし
つれさる	つれさり
食合う	食合い
打ちみる	打ちみ
すませる	すませ
踏ん張る	踏ん張り
燃えつく	燃えつき
もみけす	もみけし
やりこめる	やりこめ
申す	申し
しする	申し
りかいしあう	りかいしあい
ほころびる	ほころび
くだる	くだり
読み合わす	読み合わし
丸めこむ	丸めこみ
言い消す	言い消し
こき使う	こき使い
突通る	突通り
押し詰る	押し詰り
せおえる	せおえ
うく	うき
献ずる	うき
劈く	劈き
敵する	劈き
始まる	始まり
ひねくる	ひねくり
撫で付ける	撫で付け
洩らす	洩らし
愛す	愛し
ひっ被る	ひっ被り
いらせられる	いらせられ
取り巻ける	取り巻け
照れる	照れ
指し示す	指し示し
下立つ	下立ち
かさねあわす	かさねあわし
引きちぎれる	引きちぎれ
取り消せる	取り消せ
きれる	きれ
おもいみだれる	おもいみだれ
笑い飛ばせる	笑い飛ばせ
かけ離れる	かけ離れ
さしかける	さしかけ
みみだつ	みみだち
奉ずる	みみだち
択ぶ	択び
こぼす	こぼし
わかがえる	わかがえり
ふくめる	ふくめ
生け捕る	生け捕り
署する	生け捕り
組み立る	組み立
ぬくまる	ぬくまり
おろす	おろし
立入る	立入り
ひっくり返れる	ひっくり返れ
もりわける	もりわけ
置き換える	置き換え
投げ勝つ	投げ勝ち
みづく	みづき
えりすぐる	えりすぐり
威張れる	威張れ
聴こえる	聴こえ
産める	産め
むかう	むかい
かれる	かれ
ねらいうつ	ねらいうち
ふりかざす	ふりかざし
酌める	酌め
弾ける	弾け
もよおす	もよおし
食う	食い
ブッ殺す	ブッ殺し
いやがる	いやがり
僭する	いやがり
撒く	撒き
持ち帰る	持ち帰り
きざす	きざし
おしよせる	おしよせ
おくらす	おくらし
歩ます	歩まし
ふうきる	ふうきり
転げる	転げ
かきだす	かきだし
しょげこむ	しょげこみ
突き当たる	突き当たり
ほきだす	ほきだし
かりあげる	かりあげ
すごせる	すごせ
こねる	こね
差し出る	差し出
狙い打つ	狙い打ち
得る	得
粒だつ	粒だち
きりひらく	きりひらき
揺ぎ出でる	揺ぎ出で
遺る	遺り
やりなおす	やりなおし
めんする	やりなおし
真似る	真似
ちりしく	ちりしき
出盛る	出盛り
減り込む	減り込み
いやせる	いやせ
役する	いやせ
なける	なけ
立ち尽くす	立ち尽くし
舞い戻る	舞い戻り
強いる	強い
ぬりつける	ぬりつけ
ひそめる	ひそめ
おもいしる	おもいしり
乗っける	乗っけ
結えつける	結えつけ
おどり出る	おどり出
もうしこむ	もうしこみ
惚れこむ	惚れこみ
うずまく	うずまき
いのこる	いのこり
異なる	異なり
詣れる	詣れ
積上げる	積上げ
撓る	撓り
すぼめる	すぼめ
ことほぐ	ことほぎ
経あがる	経あがり
煮詰める	煮詰め
ひやせる	ひやせ
打沈む	打沈み
しゃくう	しゃくい
拡げる	拡げ
撫ぜる	撫ぜ
かたげる	かたげ
轢き殺す	轢き殺し
だく	だき
差延べる	差延べ
令する	差延べ
身篭る	身篭り
あらがう	あらがい
罷りでる	罷りで
こまぬく	こまぬき
ぬれる	ぬれ
堪り兼ねる	堪り兼ね
釣れる	釣れ
差し障る	差し障り
すれちがう	すれちがい
はせ回る	はせ回り
飛びまわる	飛びまわり
煙る	煙り
満たす	満たし
騙る	騙り
反れる	反れ
呼ばれる	呼ばれ
でなおせる	でなおせ
つけたせる	つけたせ
登り詰める	登り詰め
寝込む	寝込み
坐する	寝込み
とりあわす	とりあわし
耐え忍ぶ	耐え忍び
捻じる	捻じり
駆け回れる	駆け回れ
攻上る	攻上り
打かさなる	打かさなり
いきちがう	いきちがい
対応付ける	対応付け
踏み分ける	踏み分け
掘出す	掘出し
止める	止め
断切る	断切り
在り合せる	在り合せ
盛りかえす	盛りかえし
たおる	たおり
ひにくる	ひにくり
摩する	ひにくり
かたりつぐ	かたりつぎ
おりかさなる	おりかさなり
かいかぶる	かいかぶり
むきかわる	むきかわり
醒ます	醒まし
打つ	打ち
あやめる	あやめ
執る	執り
つっぱる	つっぱり
組みこめる	組みこめ
とんがる	とんがり
埋まる	埋まり
活きる	活き
ぶちのめす	ぶちのめし
へきする	ぶちのめし
つめかける	つめかけ
言い含める	言い含め
敲く	敲き
ただよう	ただよい
掛け持つ	掛け持ち
いりみだれる	いりみだれ
きたる	きたり
押え付ける	押え付け
賜る	賜り
並べ換える	並べ換え
ひえる	ひえ
取り次げる	取り次げ
撮み出す	撮み出し
のめりこむ	のめりこみ
あいしあえる	あいしあえ
じみる	じみ
しずまる	しずまり
あやなす	あやなし
笑いとばす	笑いとばし
取り合う	取り合い
なきすがる	なきすがり
ひとはだぬぐ	ひとはだぬぎ
取って返す	取って返し
取入れる	取入れ
乳繰る	乳繰り
煮染める	煮染め
なぎはらう	なぎはらい
たく	たき
ふうする	たき
果たせる	果たせ
刈入れる	刈入れ
まかる	まかり
突っぱなす	突っぱなし
全うする	突っぱなし
書きぬく	書きぬき
起きあがる	起きあがり
書き添える	書き添え
ふるわす	ふるわし
であるける	であるけ
飛び付く	飛び付き
さしはさむ	さしはさみ
撞く	撞き
掛離れる	掛離れ
とびこえる	とびこえ
達する	とびこえ
みる	み
謀る	謀り
食詰める	食詰め
探し回る	探し回り
かわいがれる	かわいがれ
とまれる	とまれ
立ち入る	立ち入り
転ける	転け
当てこする	当てこすり
こする	こすり
抜き出せる	抜き出せ
とびあがれる	とびあがれ
そそける	そそけ
頂く	頂き
おちあえる	おちあえ
おちこぼれる	おちこぼれ
皮肉る	皮肉り
言いきる	言いきり
乗り換える	乗り換え
さしもどす	さしもどし
つくりなす	つくりなし
搾り上げる	搾り上げ
急ぐ	急ぎ
立ち尽す	立ち尽し
住み込める	住み込め
おろせる	おろせ
震える	震え
ぞくする	震え
飛びこむ	飛びこみ
見いだせる	見いだせ
蔓延る	蔓延り
かき出す	かき出し
すごす	すごし
わずらう	わずらい
合わせる	合わせ
踏切る	踏切り
かわかす	かわかし
背負う	背負い
拭ける	拭け
手向かえる	手向かえ
付廻す	付廻し
くちはてる	くちはて
果せる	果せ
あおざめる	あおざめ
遅なわる	遅なわり
ごてつく	ごてつき
だきしめる	だきしめ
詠む	詠み
あめる	あめ
罷り出でる	罷り出で
相つぐ	相つぎ
ねらえる	ねらえ
かりいれる	かりいれ
そねむ	そねみ
きりひらける	きりひらけ
触る	触り
つのる	つのり
まきこめる	まきこめ
つれこむ	つれこみ
寝転ぶ	寝転び
亡くなる	亡くなり
ばら蒔く	ばら蒔き
あかしくらす	あかしくらし
もえさかる	もえさかり
くわえる	くわえ
借り出す	借り出し
くちすすぐ	くちすすぎ
もたつく	もたつき
でんぐりがえる	でんぐりがえり
弄る	弄り
もちきる	もちきり
額づく	額づき
盛込む	盛込み
巻上げる	巻上げ
殴り付ける	殴り付け
若返る	若返り
行き渡る	行き渡り
搾る	搾り
ほりおこせる	ほりおこせ
魅入る	魅入り
売り込める	売り込め
秘める	秘め
潜り込める	潜り込め
引き下ろす	引き下ろし
よりぬく	よりぬき
ひき込む	ひき込み
たじろぐ	たじろぎ
弾き出す	弾き出し
映す	映し
さだめる	さだめ
せかす	せかし
よごす	よごし
わびいる	わびいり
くえる	くえ
いなかびる	いなかび
見廻る	見廻り
いかれる	いかれ
敗れる	敗れ
苔むす	苔むし
ぬけだせる	ぬけだせ
いいまるめる	いいまるめ
なびく	なびき
落着き払う	落着き払い
とばす	とばし
議する	とばし
靡かす	靡かし
たためる	たため
振り切る	振り切り
積む	積み
いえる	いえ
みはるかす	みはるかし
のし歩く	のし歩き
刃向かう	刃向かい
薄まる	薄まり
薄れる	薄れ
引留める	引留め
暴き出す	暴き出し
抱え込む	抱え込み
わななく	わななき
改む	改め
すてる	すて
なげだす	なげだし
踏付ける	踏付け
設える	設え
看做す	看做し
ひきこむ	ひきこみ
くりぬく	くりぬき
売込む	売込み
つうじる	つうじ
ふるびる	ふるび
ぬりつぶす	ぬりつぶし
踏み込める	踏み込め
ばれる	ばれ
もりつぶす	もりつぶし
のみほせる	のみほせ
反り返る	反り返り
毛羽立つ	毛羽立ち
どくする	毛羽立ち
あふれでる	あふれで
反す	反し
やりすごせる	やりすごせ
游ぐ	游ぎ
うちたてる	うちたて
遭う	遭い
どよもす	どよもし
塞ぐ	塞ぎ
引き合える	引き合え
貫き通す	貫き通し
かしきる	かしきり
打消す	打消し
ねぎる	ねぎり
ふりかぶる	ふりかぶり
いきがる	いきがり
更す	更し
呼戻す	呼戻し
教える	教え
ほりかえせる	ほりかえせ
映る	映り
疲らせる	疲らせ
さかえる	さかえ
貫ける	貫け
流れ落ちる	流れ落ち
呼び覚ます	呼び覚まし
揺ぐ	揺ぎ
張りとばす	張りとばし
ふみこむ	ふみこみ
咲かす	咲かし
とむらう	とむらい
刺立つ	刺立ち
聞こえる	聞こえ
とまる	とまり
変じる	変じ
罰す	罰し
降り出す	降り出し
磨りつぶす	磨りつぶし
掻い繰る	掻い繰り
そなわる	そなわり
泣く	泣き
浸る	浸り
交ぜかえす	交ぜかえし
留まる	留まり
暴れまくる	暴れまくり
まちのぞむ	まちのぞみ
引入れる	引入れ
誓う	誓い
取り零す	取り零し
こがれる	こがれ
組める	組め
たけりたつ	たけりたち
まぎらせる	まぎらせ
そめぬく	そめぬき
愛でる	愛で
さとす	さとし
侵す	侵し
濁らせる	濁らせ
吸い出す	吸い出し
擦る	擦り
歌える	歌え
張上げる	張上げ
掛け合わす	掛け合わし
書記す	書記し
ぶら下がれる	ぶら下がれ
入まじる	入まじり
止す	止し
引き払う	引き払い
回る	回り
探り出せる	探り出せ
振りかける	振りかけ
磨れる	磨れ
かんずる	磨れ
立並ぶ	立並び
朽ち果てる	朽ち果て
こやす	こやし
卜する	こやし
寄り添う	寄り添い
誘い出せる	誘い出せ
あやまれる	あやまれ
ひっ括る	ひっ括り
掻き込む	掻き込み
受持つ	受持ち
落ちる	落ち
移る	移り
ハリたおす	ハリたおし
奮い起つ	奮い起ち
ほす	ほし
茂り合う	茂り合い
転げ込む	転げ込み
体する	転げ込み
晴らす	晴らし
心付く	心付き
革める	革め
むせぶ	むせび
窘める	窘め
はらいだす	はらいだし
いい表す	いい表し
殴りとばす	殴りとばし
よびさけぶ	よびさけび
澄切る	澄切り
立後れる	立後れ
とりしきれる	とりしきれ
かたまりあう	かたまりあい
係る	係り
おとし入れる	おとし入れ
立こもる	立こもり
かよわす	かよわし
あわさる	あわさり
飛ばす	飛ばし
ふしくれだつ	ふしくれだち
刷り上がる	刷り上がり
ひしめき合う	ひしめき合い
かんがえだせる	かんがえだせ
立退く	立退き
善がる	善がり
はじき出せる	はじき出せ
働かせる	働かせ
すみつける	すみつけ
れる	れ
あう	あい
にぎりつぶす	にぎりつぶし
待ち構える	待ち構え
忍び寄る	忍び寄り
かなしむ	かなしみ
振り立てる	振り立て
もうしたてる	もうしたて
言付ける	言付け
打ち砕く	打ち砕き
みかける	みかけ
うつ	うち
買い叩く	買い叩き
刺し殺せる	刺し殺せ
さぐりだす	さぐりだし
敬う	敬い
うわずる	うわずり
摺り抜ける	摺り抜け
繰寄せる	繰寄せ
結わえ付ける	結わえ付け
彫り上げる	彫り上げ
とらわれる	とらわれ
さわる	さわり
歓ぶ	歓び
みつもる	みつもり
つづける	つづけ
すれ違う	すれ違い
なすりつける	なすりつけ
吃る	吃り
追詰める	追詰め
出来る	出来
振るう	振るい
しこむ	しこみ
うめたてる	うめたて
やらす	やらし
立ちすくむ	立ちすくみ
かたす	かたし
とりつける	とりつけ
ほほ笑む	ほほ笑み
魘される	魘され
打ちまくる	打ちまくり
書きさす	書きさし
しまる	しまり
塗立てる	塗立て
みずぎわだつ	みずぎわだち
受け取れる	受け取れ
そこねる	そこね
放下す	放下し
ぶす	ぶし
こうむる	こうむり
じょうじる	じょうじ
けみする	じょうじ
込合う	込合い
通じる	通じ
病める	病め
ひきとめる	ひきとめ
和らぐ	和らぎ
くみほす	くみほし
あんずる	くみほし
たちむかえる	たちむかえ
かさ張る	かさ張り
あづかる	あづかり
ふみとどまれる	ふみとどまれ
ひきいれる	ひきいれ
照らす	照らし
いぶる	いぶり
しさる	しさり
捩れる	捩れ
出揃う	出揃い
とびちる	とびちり
くいあらためる	くいあらため
こむ	こみ
のりこせる	のりこせ
はげます	はげまし
絞り込む	絞り込み
決す	決し
捨置く	捨置き
逸る	逸り
ひかされる	ひかされ
盛り込む	盛り込み
抜けあがる	抜けあがり
詰め掛ける	詰め掛け
結える	結え
戯ける	戯け
恋する	戯け
ふるう	ふるい
割引く	割引き
挾む	挾み
おれあえる	おれあえ
踏みとどまれる	踏みとどまれ
着く	着き
かまう	かまい
泊る	泊り
捨て置く	捨て置き
ぬすみだす	ぬすみだし
戸惑う	戸惑い
はぐらかす	はぐらかし
踏み切る	踏み切り
釣込む	釣込み
奮たつ	奮たち
凌げる	凌げ
目立つ	目立ち
曇らせる	曇らせ
わりもどせる	わりもどせ
黒ずむ	黒ずみ
する	し
掛り合う	掛り合い
言返す	言返し
きりあう	きりあい
ゆき帰る	ゆき帰り
取り交す	取り交し
保ち合える	保ち合え
出過ぎる	出過ぎ
仮す	仮し
張り裂ける	張り裂け
すみあらす	すみあらし
いいなす	いいなし
もりこめる	もりこめ
たびかさなる	たびかさなり
ききとる	ききとり
増さる	増さり
媚びる	媚び
あたたまる	あたたまり
卑しめる	卑しめ
寝違える	寝違え
なぐる	なぐり
うちけせる	うちけせ
問いかける	問いかけ
うちころせる	うちころせ
向かう	向かい
運ぶ	運び
復する	運び
つけねらう	つけねらい
体裁振る	体裁振り
騒ぎだす	騒ぎだし
かきあわせる	かきあわせ
竦み上がる	竦み上がり
はりだせる	はりだせ
焚く	焚き
刷れる	刷れ
躍り掛る	躍り掛り
してやる	してやり
精出す	精出し
到れる	到れ
看る	看
くりあわせる	くりあわせ
売り飛ばせる	売り飛ばせ
降しきる	降しきり
引締める	引締め
おいだせる	おいだせ
とびのる	とびのり
垂れ下がる	垂れ下がり
うえる	うえ
解かす	解かし
ふてくさる	ふてくさり
そいとげる	そいとげ
いわえる	いわえ
おきかえる	おきかえ
はぎ取る	はぎ取り
わきでる	わきで
拡がる	拡がり
着込む	着込み
掘り出せる	掘り出せ
錆びつく	錆びつき
うきでる	うきで
ふれこむ	ふれこみ
変りはてる	変りはて
のりかける	のりかけ
凝らす	凝らし
こねくる	こねくり
とけ込める	とけ込め
吹き込む	吹き込み
ばたつく	ばたつき
立ち働く	立ち働き
庶幾う	庶幾い
きりわすれる	きりわすれ
はじきだす	はじきだし
草する	はじきだし
凍む	凍み
はいまつわる	はいまつわり
掻き暗す	掻き暗し
與える	與え
うつしとれる	うつしとれ
かんじとれる	かんじとれ
化ける	化け
掘りさげる	掘りさげ
ふんぞりかえる	ふんぞりかえり
切り倒せる	切り倒せ
締め付ける	締め付け
こね返す	こね返し
北叟笑む	北叟笑み
食下がる	食下がり
引きさく	引きさき
算する	引きさき
言いつのる	言いつのり
ひっこ抜く	ひっこ抜き
触れ込める	触れ込め
言い尽す	言い尽し
あからむ	あからみ
説伏せる	説伏せ
擽る	擽り
掛かり合う	掛かり合い
たぐまる	たぐまり
指さす	指さし
追い込める	追い込め
浮あがる	浮あがり
うらづける	うらづけ
食い下がる	食い下がり
のりだせる	のりだせ
ふためく	ふためき
詠める	詠め
ひるがえす	ひるがえし
手つだう	手つだい
芽ぐむ	芽ぐみ
補える	補え
取り越す	取り越し
滅びる	滅び
絡ます	絡まし
損じる	損じ
きんずる	損じ
つきだせる	つきだせ
なくなす	なくなし
請けあう	請けあい
取り交わす	取り交わし
張りつける	張りつけ
読み流せる	読み流せ
かもし出す	かもし出し
ちからづける	ちからづけ
あずける	あずけ
払い出す	払い出し
象る	象り
そなえつける	そなえつけ
溜る	溜り
入れ直す	入れ直し
かかる	かかり
引っ繰り返る	引っ繰り返り
しめす	しめし
うろつく	うろつき
もす	もし
たける	たけ
くばりあるける	くばりあるけ
折重ねる	折重ね
とりのぞける	とりのぞけ
吹分ける	吹分け
やける	やけ
たびだてる	たびだて
騙しこむ	騙しこみ
踏みにじる	踏みにじり
かたどる	かたどり
しょぼくれる	しょぼくれ
挿せる	挿せ
たきつける	たきつけ
こぼつ	こぼち
織る	織り
切崩す	切崩し
起き出せる	起き出せ
探せる	探せ
掘下げる	掘下げ
引き下げる	引き下げ
持切る	持切り
食べる	食べ
おちこむ	おちこみ
湿気る	湿気
煩わす	煩わし
かっする	煩わし
ながれおちる	ながれおち
振り放け見みる	振り放け見み
持ち越す	持ち越し
割り切る	割り切り
食らいつく	食らいつき
牽ける	牽け
天下る	天下り
買込む	買込み
あいまつ	あいまち
えりぬく	えりぬき
塗りつぶせる	塗りつぶせ
放く	放き
推す	推し
とく	とき
馬鹿げる	馬鹿げ
興る	興り
おもいすごす	おもいすごし
ひびきわたる	ひびきわたり
あこがれる	あこがれ
おじけだつ	おじけだち
憎める	憎め
書きなぐる	書きなぐり
従える	従え
決る	決り
漕ぎ着ける	漕ぎ着け
つむる	つむり
襲われる	襲われ
棹さす	棹さし
泣すがる	泣すがり
打取る	打取り
引き伸ばす	引き伸ばし
きばむ	きばみ
突き飛ばせる	突き飛ばせ
ことづける	ことづけ
ずっこける	ずっこけ
使い分ける	使い分け
あぶりだす	あぶりだし
はらいもどせる	はらいもどせ
払いもどす	払いもどし
あぶらじみる	あぶらじみ
明け渡る	明け渡り
伏せる	伏せ
もえ出る	もえ出
育てあげる	育てあげ
曵く	曵き
煮込める	煮込め
気圧される	気圧され
あそぶ	あそび
よせかける	よせかけ
ぬかせる	ぬかせ
受け合う	受け合い
やり遂げる	やり遂げ
おそいかかる	おそいかかり
畏れる	畏れ
よばなれる	よばなれ
うろぬく	うろぬき
かちこす	かちこし
みたす	みたし
痩せこける	痩せこけ
巡れる	巡れ
とりひろげる	とりひろげ
ふうじる	ふうじ
引っ返す	引っ返し
とがめる	とがめ
老い耄れる	老い耄れ
追いこす	追いこし
踏み入る	踏み入り
書流す	書流し
わき起こる	わき起こり
あおる	あおり
くいいる	くいいり
囚われる	囚われ
なごめる	なごめ
飲回す	飲回し
歯する	飲回し
うちだす	うちだし
速まる	速まり
化かせる	化かせ
たどりつける	たどりつけ
聞き入れる	聞き入れ
つとめる	つとめ
飛ぶ	飛び
担える	担え
このむ	このみ
おどしつける	おどしつけ
ふくらませる	ふくらませ
立寄る	立寄り
みおくる	みおくり
ふみわける	ふみわけ
憂う	憂い
託ける	託け
うせる	うせ
掻払う	掻払い
しっする	掻払い
出払う	出払い
きこむ	きこみ
じす	じし
追い回す	追い回し
繰りまわす	繰りまわし
繰り越す	繰り越し
よみやぶる	よみやぶり
切組む	切組み
悪たれる	悪たれ
撃ち殺せる	撃ち殺せ
しきる	しきり
執成す	執成し
もぎれる	もぎれ
ほしころす	ほしころし
いでたつ	いでたち
たゆむ	たゆみ
傷つく	傷つき
突き刺す	突き刺し
さしさわる	さしさわり
報いる	報い
なおす	なおし
とどける	とどけ
使い果たす	使い果たし
てりかえす	てりかえし
ふっきれる	ふっきれ
送り出す	送り出し
きづく	きづき
過ごす	過ごし
かきあげる	かきあげ
飛び回れる	飛び回れ
焦げつく	焦げつき
あおげる	あおげ
画す	画し
しめる	しめ
くい込む	くい込み
いならぶ	いならび
漬け込む	漬け込み
這い出でる	這い出で
聞澄ます	聞澄まし
ねそべる	ねそべり
現れる	現れ
親しめる	親しめ
はいいる	はいいり
進み出す	進み出し
貸し越す	貸し越し
はじいる	はじいり
封じ込む	封じ込み
炒る	炒り
取りもてる	取りもて
かなぐり捨てる	かなぐり捨て
盛る	盛り
とばしる	とばしり
ふきおろす	ふきおろし
ふれあえる	ふれあえ
申し越す	申し越し
残す	残し
きわ立つ	きわ立ち
あしらう	あしらい
鬱する	あしらい
かたまれる	かたまれ
引っ込める	引っ込め
かんがえだす	かんがえだし
囲む	囲み
繰りあげる	繰りあげ
思い当たる	思い当たり
事切れる	事切れ
切り回せる	切り回せ
げびる	げび
縋れる	縋れ
でかす	でかし
やくする	でかし
むす	むし
つっぱなす	つっぱなし
まどろむ	まどろみ
動かす	動かし
いづ	いで
取組む	取組み
しおおせる	しおおせ
めくるめく	めくるめき
預け入れる	預け入れ
引き攣れる	引き攣れ
聞き合せる	聞き合せ
はれあがる	はれあがり
振り回せる	振り回せ
似通う	似通い
せんじつめる	せんじつめ
高まる	高まり
彫り込める	彫り込め
乗り上げる	乗り上げ
取り合える	取り合え
まいこむ	まいこみ
たちのける	たちのけ
ほとばしる	ほとばしり
ひかれる	ひかれ
世づく	世づき
やぶれる	やぶれ
書き送る	書き送り
やってくる	やってき
送る	送り
打直せる	打直せ
いきる	いき
かしだす	かしだし
ふらす	ふらし
旅だつ	旅だち
上がる	上がり
煮詰る	煮詰り
かわいがる	かわいがり
つぼめる	つぼめ
ふりわける	ふりわけ
つきやぶれる	つきやぶれ
かけつける	かけつけ
あきれる	あきれ
取りあげる	取りあげ
いのる	いのり
うまれあわす	うまれあわし
折かさなる	折かさなり
のっかる	のっかり
食い止める	食い止め
なでおろす	なでおろし
ほりかえす	ほりかえし
うりあげる	うりあげ
ひきあげる	ひきあげ
わける	わけ
着こなす	着こなし
取り運べる	取り運べ
湯引く	湯引き
たまりかねる	たまりかね
たちはたらく	たちはたらき
見立てる	見立て
てづまる	てづまり
生まれ合わす	生まれ合わし
押しかぶさる	押しかぶさり
犯す	犯し
いいあやまる	いいあやまり
くらいする	いいあやまり
振出す	振出し
出そろう	出そろい
すくみ上がる	すくみ上がり
高じる	高じ
惟みる	惟み
績む	績み
渡りあう	渡りあい
くどける	くどけ
ひきつぐ	ひきつぎ
芽差す	芽差し
からます	からまし
祓う	祓い
付き合える	付き合え
仰る	仰り
省く	省き
追い求める	追い求め
せめよせる	せめよせ
放れる	放れ
うちこわす	うちこわし
生れ落ちる	生れ落ち
慎む	慎み
打ちくだく	打ちくだき
なげかつ	なげかち
沸き起る	沸き起り
腐らす	腐らし
枕する	腐らし
せっつく	せっつき
伺える	伺え
挺する	伺え
絶てる	絶て
つかまつる	つかまつり
くみつく	くみつき
せおいこめる	せおいこめ
あけはなれる	あけはなれ
取結ぶ	取結び
ちぢこまる	ちぢこまり
みぬける	みぬけ
濡れる	濡れ
泣ける	泣け
励ませる	励ませ
入れ替える	入れ替え
ほおける	ほおけ
嫁ぐ	嫁ぎ
照らせる	照らせ
ひきさく	ひきさき
ふむ	ふみ
発く	発き
駆け込む	駆け込み
さがしだす	さがしだし
ねじ向ける	ねじ向け
えらびだせる	えらびだせ
借倒す	借倒し
とびかける	とびかけり
悔改める	悔改め
準える	準え
さえ渡る	さえ渡り
息せききる	息せききり
逃げ回る	逃げ回り
いいなおせる	いいなおせ
呑み込める	呑み込め
有り合せる	有り合せ
さとれる	さとれ
たばねる	たばね
入組む	入組み
打込む	打込み
突止める	突止め
焼け落ちる	焼け落ち
取る	取り
齎す	齎し
敷き詰める	敷き詰め
よじ登る	よじ登り
色褪せる	色褪せ
なのる	なのり
うちとける	うちとけ
古る	古り
喩える	喩え
しゃがみこむ	しゃがみこみ
吠える	吠え
明らめる	明らめ
にくむ	にくみ
打ち切れる	打ち切れ
調える	調え
編める	編め
しりぬく	しりぬき
しょぼ濡れる	しょぼ濡れ
居竦まる	居竦まり
たがやす	たがやし
へめぐる	へめぐり
写し出す	写し出し
つめる	つめり
捜し当てる	捜し当て
ひきさる	ひきさり
爪弾く	爪弾き
あざむける	あざむけ
数え切れる	数え切れ
降り込む	降り込み
はなやぐ	はなやぎ
抛つつ	抛つち
紛れ込める	紛れ込め
闘える	闘え
方向付ける	方向付け
略す	略し
跪く	跪き
刻み付ける	刻み付け
言い渡せる	言い渡せ
潰す	潰し
開け放す	開け放し
捲し上げる	捲し上げ
はみ出す	はみ出し
いきながらえる	いきながらえ
あきめく	あきめき
適える	適え
賭する	適え
とおりすぎる	とおりすぎ
取り締まれる	取り締まれ
さぼる	さぼり
付する	さぼり
踏み越す	踏み越し
乗越える	乗越え
勢いづく	勢いづき
入り乱れる	入り乱れ
組伏せる	組伏せ
うちきれる	うちきれ
ききだせる	ききだせ
破く	破き
さそう	さそい
食する	さそい
よろこびあえる	よろこびあえ
積重ねる	積重ね
捩る	捩り
しわがれる	しわがれ
しょくする	しわがれ
はきだせる	はきだせ
練り直す	練り直し
下種張る	下種張り
みはからえる	みはからえ
使い果す	使い果し
捲る	捲り
記せる	記せ
つれもどす	つれもどし
おっしゃる	おっしゃい
振り払える	振り払え
かりこむ	かりこみ
差うつむく	差うつむき
乾かす	乾かし
恐れ入る	恐れ入り
なきくらす	なきくらし
ばくする	なきくらし
詠じる	詠じ
抓る	抓り
ちかづく	ちかづき
誤らす	誤らし
たかなる	たかなり
横たえる	横たえ
はりまわす	はりまわし
拝む	拝み
ゆるがす	ゆるがし
ひきずりまわせる	ひきずりまわせ
はらいもどす	はらいもどし
ゆびく	ゆびき
斬る	斬り
もつれあう	もつれあい
せめおとす	せめおとし
うちはたす	うちはたし
どよむ	どよみ
ついていける	ついていけ
交じる	交じり
脅える	脅え
うちけす	うちけし
轢く	轢き
うけながせる	うけながせ
降やむ	降やみ
うなる	うなり
さしつかえる	さしつかえ
見あたる	見あたり
取り扱う	取り扱い
脱する	取り扱い
でむかえる	でむかえ
けばだつ	けばだち
生みだす	生みだし
踏抜く	踏抜き
飲む	飲み
立ち込める	立ち込め
肯んずる	立ち込め
割出す	割出し
かきなおす	かきなおし
組み上げる	組み上げ
けせる	けせ
弁ずる	けせ
乗あわせる	乗あわせ
統べ括る	統べ括り
泣き明かす	泣き明かし
産み付ける	産み付け
釣り合う	釣り合い
枝垂れる	枝垂れ
なかせる	なかせ
めしよせる	めしよせ
宣する	めしよせ
とびかかる	とびかかり
奮い起す	奮い起し
思い上がる	思い上がり
さずかる	さずかり
いれなおす	いれなおし
やぶく	やぶき
さがす	さがし
つみかさねる	つみかさね
おもいなおす	おもいなおし
慣す	慣し
澄ます	澄まし
占う	占い
心得える	心得え
きばる	きばり
ぬいあわす	ぬいあわし
飛び出す	飛び出し
絵取る	絵取り
打ち勝つ	打ち勝ち
節榑立つ	節榑立ち
私する	節榑立ち
取り違える	取り違え
おひゃらかす	おひゃらかし
むちうつ	むちうち
落延びる	落延び
枯れる	枯れ
つまだてる	つまだて
おちょくる	おちょくり
取りこぼす	取りこぼし
揺らす	揺らし
払いこむ	払いこみ
取り極める	取り極め
吹き上げる	吹き上げ
凋む	凋み
清まる	清まり
近寄る	近寄り
いとなむ	いとなみ
かかわれる	かかわれ
たくしあげる	たくしあげ
たてつく	たてつき
怖気付く	怖気付き
繰り返す	繰り返し
そよふく	そよふき
壊れる	壊れ
恐がる	恐がり
壊せる	壊せ
通り抜ける	通り抜け
ひきだせる	ひきだせ
泳ぐ	泳ぎ
冴える	冴え
握りつぶす	握りつぶし
手がける	手がけ
やきつける	やきつけ
顧みる	顧み
しあげる	しあげ
たたきつぶす	たたきつぶし
敵す	敵し
わかつ	わかち
つからす	つからし
書き記す	書き記し
吹きだす	吹きだし
混ぜっかえす	混ぜっかえし
せりだす	せりだし
折り返せる	折り返せ
ゆるめる	ゆるめ
引き裂ける	引き裂け
えがく	えがき
振りかざす	振りかざし
入り交じる	入り交じり
たいらぐ	たいらぎ
わきおこせる	わきおこせ
撫でつける	撫でつけ
嫌がる	嫌がり
打ち込める	打ち込め
こかす	こかし
変ずる	こかし
托する	こかし
もちかえる	もちかえり
跨げる	跨げ
点る	点り
切り離す	切り離し
かさなりあう	かさなりあい
切れる	切れ
わかす	わかし
打ちあう	打ちあい
かもせる	かもせ
けんじる	けんじ
辷らす	辷らし
還る	還り
待ち設ける	待ち設け
住みつべる	住みつべ
こねかえす	こねかえし
さしむける	さしむけ
弁える	弁え
かち合う	かち合い
つくせる	つくせ
すりつける	すりつけ
取すがる	取すがり
貸し出す	貸し出し
組みなおす	組みなおし
はやす	はやし
死に絶える	死に絶え
あがく	あがき
じれこむ	じれこみ
ぬかずく	ぬかずき
切り忘れる	切り忘れ
乗りまわす	乗りまわし
疲れる	疲れ
いいあらそえる	いいあらそえ
引き落とせる	引き落とせ
突合す	突合し
弾ずる	突合し
かればむ	かればみ
抱えこむ	抱えこみ
とりまわす	とりまわし
便る	便り
あけわたす	あけわたし
しょいこむ	しょいこみ
あぐねる	あぐね
投げこむ	投げこみ
ふるいおとせる	ふるいおとせ
たべる	たべ
読み返せる	読み返せ
流れ歩く	流れ歩き
拗ねる	拗ね
こく	こき
生きかえる	生きかえり
書分ける	書分け
さししめせる	さししめせ
気づく	気づき
でき上がる	でき上がり
照りつける	照りつけ
なくなる	なくなり
ゆだねる	ゆだね
ずれこめる	ずれこめ
はせ参じる	はせ参じ
浮立つ	浮立ち
眠りこける	眠りこけ
はいつくばう	はいつくばい
封じ込める	封じ込め
ゆでる	ゆで
蒸ける	蒸け
探る	探り
耐え抜く	耐え抜き
いぬ	いに
うめあわす	うめあわし
つめよる	つめより
はつる	はつり
来る	来
切り替える	切り替え
しょぼつく	しょぼつき
むずかる	むずかり
差置く	差置き
奪い合える	奪い合え
くもらせる	くもらせ
見まがう	見まがい
言い付かる	言い付かり
いいもらす	いいもらし
みまもる	みまもり
かかりあう	かかりあい
のみこむ	のみこみ
突きあたる	突きあたり
持つ	持ち
とりまとめる	とりまとめ
もちこめる	もちこめ
供する	もちこめ
ふるいわける	ふるいわけ
落す	落し
ひろげる	ひろげ
載せる	載せ
動ずる	載せ
組みあう	組みあい
こすれる	こすれ
縋る	縋り
祓い清める	祓い清め
とけあえる	とけあえ
ほくそえむ	ほくそえみ
向かいあう	向かいあい
引張る	引張り
繰り回す	繰り回し
おどかす	おどかし
いかける	いかけ
擦切る	擦切り
窮まる	窮まり
消せる	消せ
打ち出せる	打ち出せ
退ける	退け
しつくす	しつくし
架ける	架け
持ち帰れる	持ち帰れ
はかす	はかし
聞き惚れる	聞き惚れ
あばれまくる	あばれまくり
かっ込む	かっ込み
とりつく	とりつき
下回る	下回り
いらだてる	いらだて
吊せる	吊せ
がんばる	がんばり
肯く	肯き
さやばしる	さやばしり
戦ぐ	戦ぎ
いとう	いとい
はりかえる	はりかえ
きりさげる	きりさげ
買わす	買わし
服せる	服せ
寄る	寄り
崩す	崩し
ききおく	ききおき
釣合う	釣合い
浮び上る	浮び上り
澄渡る	澄渡り
舞いこむ	舞いこみ
言祝ぐ	言祝ぎ
差越える	差越え
走り抜ける	走り抜け
蹴立てる	蹴立て
老ぼれる	老ぼれ
繰り返せる	繰り返せ
問い掛ける	問い掛け
奪い取れる	奪い取れ
わき返る	わき返り
貰う	貰い
繰る	繰り
駆け寄る	駆け寄り
抜き取る	抜き取り
すりこむ	すりこみ
しけこむ	しけこみ
逝く	逝き
かけだす	かけだし
競り合う	競り合い
ねっする	競り合い
突出す	突出し
ふんばる	ふんばり
乾反る	乾反り
回り込める	回り込め
うまる	うまり
しける	しけ
言い淀む	言い淀み
はやしたてる	はやしたて
見計らう	見計らい
奉じる	奉じ
末枯れる	末枯れ
はせ戻る	はせ戻り
波だつ	波だち
聞ける	聞け
きりいる	きりいり
取集める	取集め
祭る	祭り
悔いる	悔い
恥入る	恥入り
はいだす	はいだし
誑し込む	誑し込み
とれる	とれ
がいする	とれ
噎ぶ	噎び
就く	就き
踏ん切れる	踏ん切れ
言い渡す	言い渡し
抜ける	抜け
あきる	あき
成し遂げる	成し遂げ
呼びつける	呼びつけ
たす	たし
もりかえす	もりかえし
がえんずる	もりかえし
こぐ	こぎ
おもいまどえる	おもいまどえ
掻き口説く	掻き口説き
鼓する	掻き口説き
窶れる	窶れ
被る	被り
撥ねる	撥ね
操れる	操れ
興じる	興じ
掘り返す	掘り返し
ひきずりまわす	ひきずりまわし
色あせる	色あせ
去る	去り
生える	生え
ほめちぎる	ほめちぎり
守り立てる	守り立て
かこつ	かこち
さしかためる	さしかため
慣わせる	慣わせ
落ち合う	落ち合い
差し繰る	差し繰り
はねかかる	はねかかり
訓ずる	はねかかり
並べる	並べ
蹴飛ばす	蹴飛ばし
添わる	添わり
ふるいおこせる	ふるいおこせ
もれ聞く	もれ聞き
つり上がる	つり上がり
うなされる	うなされ
割る	割り
すける	すけ
ついばめる	ついばめ
ほうり込む	ほうり込み
掻き鳴す	掻き鳴し
蒔き直せる	蒔き直せ
みなおせる	みなおせ
やけおちる	やけおち
治す	治し
侍する	治し
馴す	馴し
立かかる	立かかり
ゆずりうける	ゆずりうけ
召し具す	召し具し
そびえ立つ	そびえ立ち
立ち戻る	立ち戻り
練歩く	練歩き
およぐ	およぎ
あざ笑う	あざ笑い
かちとる	かちとり
寄りすがる	寄りすがり
かぎれる	かぎれ
まちかねる	まちかね
狼狽える	狼狽え
掘れる	掘れ
さしひく	さしひき
秘する	さしひき
猛り立つ	猛り立ち
とりはからう	とりはからい
幽する	とりはからい
ろうする	とりはからい
咲そろう	咲そろい
きしめく	きしめき
げんずる	きしめき
みすかす	みすかし
うちはなす	うちはなし
とっつかまる	とっつかまり
身罷る	身罷り
煉り合せる	煉り合せ
触れ込む	触れ込み
喰う	喰い
ほめあげる	ほめあげ
連れ戻す	連れ戻し
増やす	増やし
仕上げる	仕上げ
昏れる	昏れ
老い込む	老い込み
間に合う	間に合い
さする	さすり
吹っとぶ	吹っとび
ひっかく	ひっかき
だきあう	だきあい
居着く	居着き
牽く	牽き
伸ばす	伸ばし
のりすすめる	のりすすめ
はいりこめる	はいりこめ
草臥れる	草臥れ
縁づく	縁づき
這える	這え
追い掛ける	追い掛け
ふきあげる	ふきあげ
つつみこめる	つつみこめ
食い込める	食い込め
打ち解ける	打ち解け
黙す	黙し
言損なう	言損ない
いいあわせる	いいあわせ
聳やかす	聳やかし
うべなう	うべない
差押える	差押え
せり落す	せり落し
いとめる	いとめ
手向かう	手向かい
あてこむ	あてこみ
細める	細め
きぐす	きぐし
ぼやける	ぼやけ
企てる	企て
測れる	測れ
振る舞える	振る舞え
翔ける	翔け
分ける	分け
佩く	佩き
躍り込む	躍り込み
まなびとれる	まなびとれ
服する	まなびとれ
打ち直せる	打ち直せ
いけどれる	いけどれ
冒せる	冒せ
かけよれる	かけよれ
開け放せる	開け放せ
冴え返る	冴え返り
かつぎ上げる	かつぎ上げ
打って出る	打って出
きりくずせる	きりくずせ
ふくす	ふくし
ツクる	ツクり
見回せる	見回せ
すすみだす	すすみだし
のたくる	のたくり
遊べる	遊べ
興がる	興がり
ねばりぬける	ねばりぬけ
押し通す	押し通し
付け込む	付け込み
詠える	詠え
呼び立てる	呼び立て
負ける	負け
たちすくむ	たちすくみ
担ぎ出す	担ぎ出し
出向く	出向き
いわす	いわし
くみなおす	くみなおし
聳える	聳え
ひける	ひけ
ゆさぶる	ゆさぶり
さしのぼる	さしのぼり
劃する	さしのぼり
殺げる	殺げ
染め出す	染め出し
勇気づける	勇気づけ
覗く	覗き
ほうり出す	ほうり出し
折りかさなる	折りかさなり
潜める	潜め
見透せる	見透せ
さし迫る	さし迫り
炊き込む	炊き込み
ほりだす	ほりだし
せめこむ	せめこみ
うみだす	うみだし
まきなおせる	まきなおせ
割りほぐす	割りほぐし
あばける	あばけ
言いそびれる	言いそびれ
かみさびる	かみさび
積もる	積もり
放せる	放せ
追いつめる	追いつめ
迎え入れる	迎え入れ
折りかさねる	折りかさね
引き継げる	引き継げ
作り成す	作り成し
みぬく	みぬき
持ち合わす	持ち合わし
言いつかる	言いつかり
選りわける	選りわけ
うちくつろぐ	うちくつろぎ
儚む	儚み
語り合える	語り合え
飛び上がれる	飛び上がれ
かき集める	かき集め
うちほろぼす	うちほろぼし
ふうずる	うちほろぼし
酔っぱらう	酔っぱらい
ふりくらす	ふりくらし
引っくくる	引っくくり
ずれ込める	ずれ込め
ゆずりあう	ゆずりあい
もちあわす	もちあわし
おもいおこす	おもいおこし
挟める	挟め
さきばしる	さきばしり
褒める	褒め
買える	買え
うりつける	うりつけ
噛み合わす	噛み合わし
すだつ	すだち
そんじる	そんじ
めかしこむ	めかしこみ
たすけだす	たすけだし
走り抜く	走り抜き
てれる	てれ
関する	てれ
巣立つ	巣立ち
らっする	巣立ち
つくり出す	つくり出し
救う	救い
溜めこむ	溜めこみ
振放す	振放し
叱る	叱り
しげる	しげり
帰せる	帰せ
屠る	屠り
言いまくる	言いまくり
頼る	頼り
乗り切る	乗り切り
にかよう	にかよい
さがせる	さがせ
書き損じる	書き損じ
囁やく	囁やき
立て篭る	立て篭り
ふみならす	ふみならし
願い下げる	願い下げ
吹きでる	吹きで
反りくり返る	反りくり返り
こらす	こらし
払わす	払わし
生きぬく	生きぬき
いすわる	いすわり
猛る	猛り
差し出せる	差し出せ
眠りこむ	眠りこみ
兼ねる	兼ね
明かす	明かし
有難がる	有難がり
折り重ねる	折り重ね
落ち着き払う	落ち着き払い
補する	落ち着き払い
じゅんじょづける	じゅんじょづけ
そこねる	そこね
育める	育め
摘める	摘め
まちがふ	まちがひ
思いなおす	思いなおし
噛み合う	噛み合い
つきあえる	つきあえ
取合せる	取合せ
射つ	射ち
しめころす	しめころし
覗ける	覗け
踏破る	踏破り
寄こす	寄こし
きえはてる	きえはて
ききもらす	ききもらし
まちつける	まちつけ
近づく	近づき
まがる	まがり
たちはだかる	たちはだかり
繰合せる	繰合せ
借り上げる	借り上げ
たたき上げる	たたき上げ
売付ける	売付け
やり直す	やり直し
考え込む	考え込み
卷ける	卷け
読み直す	読み直し
聾する	読み直し
握りつぶせる	握りつぶせ
よびだす	よびだし
はめ込める	はめ込め
手渡す	手渡し
めあわす	めあわし
押しのける	押しのけ
みあわす	みあわし
どうじる	どうじ
取り入る	取り入り
読み替える	読み替え
うみおとせる	うみおとせ
問う	問い
押し込める	押し込め
とちる	とちり
なつめく	なつめき
しのびこめる	しのびこめ
彫れる	彫れ
にぎれる	にぎれ
飛び散る	飛び散り
払込む	払込み
くみ上げる	くみ上げ
ふりかかる	ふりかかり
降り篭める	降り篭め
こうる	こうり
ねむらす	ねむらし
呼びかける	呼びかけ
くみこむ	くみこみ
買い控える	買い控え
したたる	したたり
おびえる	おびえ
いいつくす	いいつくし
吸い込める	吸い込め
差招く	差招き
ふみとどまる	ふみとどまり
焼き払う	焼き払い
見逃せる	見逃せ
集まる	集まり
撥ね付ける	撥ね付け
掠める	掠め
切り廻す	切り廻し
引き入れる	引き入れ
禿びる	禿び
まかせる	まかせ
切捨てる	切捨て
いれかわれる	いれかわれ
まぜかえせる	まぜかえせ
うきたつ	うきたち
なきはらす	なきはらし
ためこむ	ためこみ
すぎる	すぎ
うちつづく	うちつづき
払い除ける	払い除け
かきなぐる	かきなぐり
さかせる	さかせ
掘り起こせる	掘り起こせ
ねちがえる	ねちがえ
寄せかける	寄せかけ
ひらく	ひらき
付け狙う	付け狙い
くだされる	くだされ
観する	くだされ
錬る	錬り
ねばつく	ねばつき
とぶ	とび
引っつかむ	引っつかみ
かき鳴す	かき鳴し
ころばす	ころばし
いきたつ	いきたち
差しだす	差しだし
世帯染みる	世帯染み
積立てる	積立て
ふせげる	ふせげ
詠み込む	詠み込み
捕まえる	捕まえ
打ち倒せる	打ち倒せ
あい変わる	あい変わり
なめずる	なめずり
連れこむ	連れこみ
聞きわける	聞きわけ
思い及ぶ	思い及び
すり減らす	すり減らし
揺れ動く	揺れ動き
崩れる	崩れ
凝る	凝り
警める	警め
にしめる	にしめ
受け継げる	受け継げ
聞きとどける	聞きとどけ
思い直せる	思い直せ
触れあう	触れあい
けむにまく	けむにまき
飛び立つ	飛び立ち
解け合える	解け合え
できあがる	できあがり
しなる	しなり
そびれる	そびれ
おいたてる	おいたて
踏みとどまる	踏みとどまり
凹む	凹み
たちならぶ	たちならび
ねんずる	たちならび
喜べる	喜べ
停る	停り
しいたげる	しいたげ
しかくばる	しかくばり
およろこびもうしあげる	およろこびもうしあげ
きりはなす	きりはなし
たきこむ	たきこみ
にげかえる	にげかえり
踏みしだく	踏みしだき
乗っ取れる	乗っ取れ
盛り上げる	盛り上げ
そわつく	そわつき
とけあう	とけあい
じだいがかる	じだいがかり
決まる	決まり
割り振れる	割り振れ
みわける	みわけ
議す	議し
取交す	取交し
滅入る	滅入り
ふきかける	ふきかけ
埋め合わす	埋め合わし
見定める	見定め
かけずる	かけずり
恙む	恙み
燻ぼる	燻ぼり
通り掛る	通り掛り
消し止める	消し止め
しゃくる	しゃくり
飛び立てる	飛び立て
掃き出す	掃き出し
かしだせる	かしだせ
みくびる	みくびり
願出る	願出
来はじめる	来はじめ
つなぎ止める	つなぎ止め
決め込む	決め込み
さっする	決め込み
しわむ	しわみ
つり上げる	つり上げ
揚がる	揚がり
徴する	揚がり
ちまう	ちまい
もの申す	もの申し
ねころがる	ねころがり
おぼめかす	おぼめかし
はがれる	はがれ
やどる	やどり
割りきれる	割りきれ
読める	読め
とりしずめる	とりしずめ
濁す	濁し
謝る	謝り
燻す	燻し
因われる	因われ
配す	配し
おとずれる	おとずれ
こそげる	こそげ
変わり果てる	変わり果て
言い丸める	言い丸め
切り込む	切り込み
まじえる	まじえ
きょうがる	きょうがり
つねる	つねり
拝する	つねり
縫い合わせる	縫い合わせ
探し出す	探し出し
当てはまる	当てはまり
縫上げる	縫上げ
うちぬく	うちぬき
まき散らす	まき散らし
引き攣る	引き攣り
ふるい分ける	ふるい分け
祈る	祈り
群れる	群れ
帰れる	帰れ
叩く	叩き
突っ張れる	突っ張れ
結び付ける	結び付け
唱う	唱い
はげませる	はげませ
盛返す	盛返し
ふうじこめる	ふうじこめ
かしこす	かしこし
にぎわせる	にぎわせ
買い求める	買い求め
つのだつ	つのだち
もくする	つのだち
さくする	つのだち
祭れる	祭れ
身構える	身構え
そらとぼける	そらとぼけ
巻き返す	巻き返し
譲れる	譲れ
飛び起きる	飛び起き
乗り外す	乗り外し
向かい合える	向かい合え
とめる	とめ
ひらきなおる	ひらきなおり
絶入る	絶入り
聞き及ぶ	聞き及び
腹立つ	腹立ち
賊する	腹立ち
すがり付く	すがり付き
渇かす	渇かし
減せる	減せ
気色ばむ	気色ばみ
振り放す	振り放し
はだかる	はだかり
みわたせる	みわたせ
へぐ	へぎ
問いあわせる	問いあわせ
すりよる	すりより
ききただせる	ききただせ
のりきる	のりきり
伝う	伝い
ねる	ね
限れる	限れ
いきづまる	いきづまり
こせつく	こせつき
泣きわめく	泣きわめき
学べる	学べ
取り寄せる	取り寄せ
緩まる	緩まり
粘る	粘り
手控える	手控え
まじなう	まじない
張り回す	張り回し
和解し合える	和解し合え
突っ込む	突っ込み
行合う	行合い
おおえる	おおえ
よびさます	よびさまし
許せる	許せ
治まる	治まり
括る	括り
はじきかえせる	はじきかえせ
困り抜く	困り抜き
継げる	継げ
しめくくる	しめくくり
戦う	戦い
かえりざける	かえりざけ
ひっぱがす	ひっぱがし
ひらきなおれる	ひらきなおれ
飛違う	飛違い
いたみいる	いたみいり
きずける	きずけ
解き放つ	解き放ち
凍てつく	凍てつき
つきつめる	つきつめ
いれあげる	いれあげ
すりへらす	すりへらし
おこる	おこり
すり潰す	すり潰し
責め苛む	責め苛み
ひきはらう	ひきはらい
荒だつ	荒だち
言い習わす	言い習わし
おう	おい
くりこむ	くりこみ
あいいれる	あいいれ
ふくらむ	ふくらみ
入る	入り
ゆだる	ゆだり
つまぐる	つまぐり
臭わせる	臭わせ
寝入る	寝入り
召し抱える	召し抱え
茂る	茂り
いじくる	いじくり
見張れる	見張れ
ねじこめる	ねじこめ
聞き返す	聞き返し
咲きほこる	咲きほこり
買う	買い
いいのがれる	いいのがれ
磨ける	磨け
のこす	のこし
滅ぼせる	滅ぼせ
騙す	騙し
こみあう	こみあい
逸す	逸し
滑り込む	滑り込み
答える	答え
ひきしまる	ひきしまり
座り込む	座り込み
ひきたつ	ひきたち
低める	低め
つまみ出す	つまみ出し
盛り付ける	盛り付け
くい止める	くい止め
はらう	はらい
なりすます	なりすまし
おきかわる	おきかわり
埋める	埋め
怖じる	怖じ
きそくだつ	きそくだち
溜める	溜め
締めくくる	締めくくり
居溢れる	居溢れ
なう	居溢れ
もたす	もたし
消え果てる	消え果て
行きあう	行きあい
おしいる	おしいり
打合せる	打合せ
滑り落ちる	滑り落ち
年取る	年取り
めぶく	めぶき
うちなおせる	うちなおせ
おどろきいる	おどろきいり
いがむ	いがみ
物申す	物申し
はらばう	はらばい
売りきれる	売りきれ
平める	平め
射す	射し
抱き合わせる	抱き合わせ
すべりだせる	すべりだせ
ことたりる	ことたり
てきす	てきし
たたずむ	たたずみ
せりおとす	せりおとし
追いつく	追いつき
飲み干す	飲み干し
こける	こけ
しとめる	しとめ
やけつく	やけつき
呑み潰す	呑み潰し
たれ込む	たれ込み
たちまよう	たちまよい
もえたつ	もえたち
行過ぎる	行過ぎ
滑り降りる	滑り降り
明く	明き
禁じる	禁じ
出来す	出来し
上擦る	上擦り
跳ねかす	跳ねかし
責め落とせる	責め落とせ
洗い上げる	洗い上げ
つつみかくす	つつみかくし
生き返れる	生き返れ
押し倒せる	押し倒せ
追い返せる	追い返せ
追出す	追出し
うち群れる	うち群れ
組付ける	組付け
消し飛ぶ	消し飛び
こばめる	こばめ
遊ばす	遊ばし
間違える	間違え
粘着く	粘着き
思いわずらう	思いわずらい
おしせまる	おしせまり
逸らせる	逸らせ
揺らめく	揺らめき
使いこむ	使いこみ
免れる	免れ
やせる	やせ
はやらせる	はやらせ
ざす	ざし
もうしきける	もうしきけ
一旗揚げる	一旗揚げ
ちょうずる	一旗揚げ
逃延びる	逃延び
おい付く	おい付き
選り抜く	選り抜き
酌む	酌み
終わる	終わり
にげだせる	にげだせ
うらなえる	うらなえ
住まわせる	住まわせ
はじく	はじき
吊りあげる	吊りあげ
申し合わせる	申し合わせ
ます	まし
睨みあう	睨みあい
てんじる	てんじ
噛み締める	噛み締め
切りかえる	切りかえ
取りこめる	取りこめ
はりめぐらす	はりめぐらし
酔つぶれる	酔つぶれ
つけかえる	つけかえ
騙し込む	騙し込み
降り立つ	降り立ち
攻め寄る	攻め寄り
和める	和め
にぎる	にぎり
とどめる	とどめ
はらいさげる	はらいさげ
組みあわす	組みあわし
拗らす	拗らし
読流す	読流し
おしまくる	おしまくり
積み分ける	積み分け
薙ぎ伏せる	薙ぎ伏せ
たやせる	たやせ
けずりたおせる	けずりたおせ
分け合う	分け合い
むせ返る	むせ返り
たどりつく	たどりつき
従う	従い
釣出す	釣出し
焼き上げる	焼き上げ
巻き起こせる	巻き起こせ
固まり合う	固まり合い
ゆびさす	ゆびさし
駆り立てる	駆り立て
列ぶ	列び
奮う	奮い
付加える	付加え
照り付ける	照り付け
争える	争え
追い払える	追い払え
ならびたつ	ならびたち
うちかつ	うちかち
いいはる	いいはり
のがせる	のがせ
打切る	打切り
あじる	あじり
染込む	染込み
閉める	閉め
あおぐ	あおぎ
離す	離し
あやまる	あやまり
えみわれる	えみわれ
つけ加わる	つけ加わり
言い暮す	言い暮し
目掛ける	目掛け
染め上がる	染め上がり
食込む	食込み
繰り込む	繰り込み
つく	つき
負わす	負わし
望む	望み
慣れ親しむ	慣れ親しみ
組上げる	組上げ
障む	障み
きざめる	きざめ
ゆわえる	ゆわえ
漏る	漏り
うつ伏せる	うつ伏せ
約する	うつ伏せ
ひるがえせる	ひるがえせ
割り出す	割り出し
代える	代え
こごえる	こごえ
持ち上がる	持ち上がり
節する	持ち上がり
抱きこむ	抱きこみ
回る	回り
かきおとす	かきおとし
息詰る	息詰り
まてる	まて
むつむ	むつみ
洗い出す	洗い出し
滑る	滑り
ゆるせる	ゆるせ
倒れる	倒れ
ふりこめる	ふりこめ
別れる	別れ
てこずる	てこずり
あいかわる	あいかわり
打破る	打破り
申しあわせる	申しあわせ
のりこむ	のりこみ
なりだす	なりだし
生きのびる	生きのび
おいだす	おいだし
うすらぐ	うすらぎ
組入れる	組入れ
すまわす	すまわし
ゆいあげる	ゆいあげ
飲み潰れる	飲み潰れ
よりたおす	よりたおし
付込む	付込み
こと足る	こと足り
埋かる	埋かり
つかいはたす	つかいはたし
熟れる	熟れ
乗出す	乗出し
濯げる	濯げ
ほうむれる	ほうむれ
孵る	孵り
なで下ろす	なで下ろし
附す	附し
廻れる	廻れ
読み上げる	読み上げ
追ひ廻す	追ひ廻し
射通す	射通し
濾す	濾し
行渡る	行渡り
聞き届ける	聞き届け
えがきだす	えがきだし
込む	込み
えり抜く	えり抜き
打直す	打直し
困る	困り
花開く	花開き
諾する	花開き
かねそなえる	かねそなえ
ねらわれる	ねらわれ
手が込む	手が込み
ぬぐえる	ぬぐえ
乗りだす	乗りだし
ききそこなう	ききそこない
すりかえる	すりかえ
きりあげる	きりあげ
怖じ気付く	怖じ気付き
照らし合せる	照らし合せ
割れる	割れ
てらしあわせる	てらしあわせ
もやせる	もやせ
えばる	えばり
おじる	おじ
煩いつく	煩いつき
慣らす	慣らし
あせる	あせり
うらぎれる	うらぎれ
切立つ	切立ち
わずらわせる	わずらわせ
吹っきれる	吹っきれ
つくりだす	つくりだし
応じる	応じ
けずりとれる	けずりとれ
たのむ	たのみ
そめあげる	そめあげ
はたらく	はたらき
説きつける	説きつけ
おしこめる	おしこめ
張りめぐらせる	張りめぐらせ
みえすく	みえすき
飛出す	飛出し
ていさいぶる	ていさいぶり
ふれまわる	ふれまわり
護る	護り
いっす	いっし
離せる	離せ
掘りおこす	掘りおこし
思い合わせる	思い合わせ
描き出す	描き出し
集まれる	集まれ
たたみこめる	たたみこめ
まくしあげる	まくしあげ
ほぐれる	ほぐれ
打ち破る	打ち破り
いいよれる	いいよれ
繰返す	繰返し
にぎわす	にぎわし
読み返す	読み返し
はたらかせる	はたらかせ
低まる	低まり
降敷く	降敷き
取り合わせる	取り合わせ
選び取れる	選び取れ
賎しめる	賎しめ
ぶちまける	ぶちまけ
おもいきる	おもいきり
わきおこる	わきおこり
引返す	引返し
そうろう	そうろい
編みだす	編みだし
語る	語り
追掛ける	追掛け
しぼめる	しぼめ
みすかせる	みすかせ
むせび泣く	むせび泣き
うちあける	うちあけ
まいらせる	まいらせ
詰寄る	詰寄り
やりあう	やりあい
やわらぐ	やわらぎ
打ちあげる	打ちあげ
ふるまえる	ふるまえ
ろうたける	ろうたけ
滑り出せる	滑り出せ
染上げる	染上げ
寄れる	寄れ
洗う	洗い
聞きもらす	聞きもらし
蝕する	聞きもらし
およぎつける	およぎつけ
澄む	澄み
つれかえる	つれかえり
乗換える	乗換え
当てこむ	当てこみ
飲下す	飲下し
降り懸かる	降り懸かり
訪う	訪い
剥せる	剥せ
ちぢめる	ちぢめ
酔っぱらえる	酔っぱらえ
辿る	辿り
闘う	闘い
震わせる	震わせ
つまだつ	つまだち
綴る	綴り
見開く	見開き
踊る	踊り
話し掛ける	話し掛け
取り下げる	取り下げ
履ける	履け
果たす	果たし
こばむ	こばみ
摩る	摩り
閃く	閃き
進める	進め
うずもれる	うずもれ
とりわける	とりわけ
吹き替える	吹き替え
立たす	立たし
強まる	強まり
かたぶける	かたぶけ
つける	つけ
取り換える	取り換え
重ね合わす	重ね合わし
取捨てる	取捨て
書きとめる	書きとめ
謡える	謡え
つなげる	つなげ
跳ね返す	跳ね返し
ききすごす	ききすごし
走れる	走れ
ある	あり
付け替える	付け替え
吹っかける	吹っかけ
ハネ出す	ハネ出し
点す	点し
引っかける	引っかけ
若く	若き
挽く	挽き
話しかける	話しかけ
切り込める	切り込め
抱き留める	抱き留め
助かる	助かり
飛びかかる	飛びかかり
立ち行く	立ち行き
刈り取れる	刈り取れ
結く	結き
恋い慕う	恋い慕い
はがす	はがし
惚気ける	惚気け
勝越す	勝越し
銘じる	銘じ
たらしこむ	たらしこみ
取り篭める	取り篭め
打ち殺す	打ち殺し
言う	言い
さげすむ	さげすみ
割く	割き
出す	出し
すがる	すがり
ぬく	ぬき
申し込む	申し込み
発する	申し込み
みする	申し込み
押さえ付ける	押さえ付け
打ち合わせる	打ち合わせ
負け越す	負け越し
げきする	負け越し
主立つ	主立ち
しはらう	しはらい
うちなおす	うちなおし
うちかえせる	うちかえせ
だきとめる	だきとめ
横切れる	横切れ
言いよどむ	言いよどみ
きりくずす	きりくずし
へる	へり
へらす	へらし
手向ける	手向け
ひっつかむ	ひっつかみ
見舞う	見舞い
はめる	はめ
飛立つ	飛立ち
撃ち破る	撃ち破り
にじりよる	にじりより
つけくわえる	つけくわえ
落ちこぼれる	落ちこぼれ
あくたれる	あくたれ
こんぐらかる	こんぐらかり
経巡る	経巡り
窄める	窄め
食いしばる	食いしばり
よいつぶれる	よいつぶれ
みあたる	みあたり
ちぢかむ	ちぢかみ
皺める	皺め
聞き込める	聞き込め
いがみ合う	いがみ合い
勝てる	勝て
あけはらう	あけはらい
唸る	唸り
盛り合わす	盛り合わし
まねぶ	まねび
絞める	絞め
むきあう	むきあい
よそえる	よそえ
うすまる	うすまり
立遅れる	立遅れ
なざす	なざし
どける	どけ
上り詰める	上り詰め
たたきあげる	たたきあげ
うけだす	うけだし
炙る	炙り
つぐなえる	つぐなえ
引き上げる	引き上げ
むかえる	むかえ
堪え忍べる	堪え忍べ
ひからびる	ひからび
はれる	はれ
据え付ける	据え付け
つきでる	つきで
はしりこむ	はしりこみ
縮まる	縮まり
談じ込める	談じ込め
付す	付し
さきそろう	さきそろい
突っかえす	突っかえし
もちはこぶ	もちはこび
スる	スり
言寄る	言寄り
蔑する	言寄り
あゆみはじめる	あゆみはじめ
つかさどる	つかさどり
諳んずる	つかさどり
吹っ掛ける	吹っ掛け
たてなおす	たてなおし
冷かす	冷かし
おもいとどまれる	おもいとどまれ
切りはずす	切りはずし
にふくめる	にふくめ
引きずり出せる	引きずり出せ
織成す	織成し
梳る	梳り
うちかえす	うちかえし
めなれる	めなれ
突き出せる	突き出せ
ふりむく	ふりむき
掘り進む	掘り進み
買い占める	買い占め
いぶく	いぶき
もぎる	もぎり
充てがう	充てがい
いやす	いやし
跨ぐ	跨ぎ
纏める	纏め
うかがう	うかがい
差し止める	差し止め
型どれる	型どれ
おとしいれる	おとしいれ
ベタつく	ベタつき
よべる	よべ
掴み合う	掴み合い
ずりおちる	ずりおち
貯め込む	貯め込み
のみまわす	のみまわし
喘ぐ	喘ぎ
裏返す	裏返し
引きしめる	引きしめ
ほじる	ほじり
おおう	おおい
見て取れる	見て取れ
相続く	相続き
ねりあわせる	ねりあわせ
取り掛かる	取り掛かり
過ぎる	過ぎ
阿る	阿り
降こめる	降こめ
にじみ出る	にじみ出
准ずる	にじみ出
巻き上げる	巻き上げ
継ぎ足す	継ぎ足し
生まれ変われる	生まれ変われ
おこなえる	おこなえ
取り交わせる	取り交わせ
たもてる	たもて
繋る	繋り
かみしめる	かみしめ
ずれこむ	ずれこみ
たつ	たち
嘯く	嘯き
壊す	壊し
よみくらべる	よみくらべ
救える	救え
はせさんじる	はせさんじ
脹らます	脹らまし
咳く	咳き
泳がせる	泳がせ
のりはずす	のりはずし
泣きつく	泣きつき
かえれる	かえれ
言い回す	言い回し
蕩ける	蕩け
乗り出せる	乗り出せ
調う	調い
こなす	こなし
ふみだせる	ふみだせ
霞む	霞み
換わる	換わり
没す	没し
浴びる	浴び
食らわす	食らわし
臨める	臨め
くりひろげる	くりひろげ
かんばしる	かんばしり
施す	施し
あらいだす	あらいだし
りかいしあえる	りかいしあえ
およる	おより
かざす	かざし
おさまる	おさまり
削り取る	削り取り
屈する	削り取り
併せる	併せ
しのぐ	しのぎ
ねづく	ねづき
く	き
入れ替わる	入れ替わり
見すかす	見すかし
言い做す	言い做し
ちりばめる	ちりばめ
問いただせる	問いただせ
降りしきる	降りしきり
打ち上げる	打ち上げ
おりかえせる	おりかえせ
頌する	おりかえせ
読ふける	読ふけり
迎え撃つ	迎え撃ち
まがう	まがい
付き纏う	付き纏い
縮める	縮め
ころせる	ころせ
おもいまどう	おもいまどい
浚える	浚え
狂れる	狂れ
婀娜めく	婀娜めき
突っ掛る	突っ掛り
もとむ	もとみ
真面目くさる	真面目くさり
売りつける	売りつけ
はかる	はかり
したおす	したおし
におう	におい
たらす	たらし
推し量れる	推し量れ
おしやる	おしやり
もうしいれる	もうしいれ
暴れ出す	暴れ出し
憤る	憤り
責付ける	責付け
飲ます	飲まし
按ずる	飲まし
持ち上げる	持ち上げ
ひきさける	ひきさけ
しばる	しばり
駆け寄れる	駆け寄れ
端折れる	端折れ
佇む	佇み
怯む	怯み
ほごす	ほごし
つくろえる	つくろえ
打ち沈む	打ち沈み
構える	構え
撲りとばす	撲りとばし
座り込める	座り込め
きよまる	きよまり
たちさる	たちさり
取合う	取合い
かき込む	かき込み
備える	備え
ふとれる	ふとれ
じゃう	じゃい
折れる	折れ
いきかう	いきかい
解きあかす	解きあかし
付き随う	付き随い
おもだつ	おもだち
人なれる	人なれ
めぐりあえる	めぐりあえ
せき上げる	せき上げ
合える	合え
のみ込む	のみ込み
量る	量り
切り出す	切り出し
しつらえる	しつらえ
おっこちる	おっこち
まきつける	まきつけ
つよめる	つよめ
ことかく	ことかき
もぐ	もぎ
握りしめる	握りしめ
固める	固め
食い込む	食い込み
いたわりあう	いたわりあい
触合う	触合い
差出す	差出し
そしる	そしり
おしあげる	おしあげ
よろう	よろい
抜あがる	抜あがり
さしうつむく	さしうつむき
漂う	漂い
のりこなせる	のりこなせ
宥める	宥め
打あぐむ	打あぐみ
おこす	おこし
取り鎮める	取り鎮め
傷める	傷め
ひきおろせる	ひきおろせ
ふん縛る	ふん縛り
ひきおとす	ひきおとし
おそなわる	おそなわり
受け出せる	受け出せ
聴ける	聴け
うきたてる	うきたて
おちいる	おちいり
のりあげる	のりあげ
突きのめす	突きのめし
馴染める	馴染め
もうしのべる	もうしのべ
煮やす	煮やし
歩みよる	歩みより
沸おこる	沸おこり
はからう	はからい
集う	集い
いろづく	いろづき
組み合わす	組み合わし
かいつける	かいつけ
勝抜く	勝抜き
揉む	揉み
しきつめる	しきつめ
外らせる	外らせ
怠ける	怠け
なげうつ	なげうち
追い出せる	追い出せ
かいあがる	かいあがり
会える	会え
申し合わす	申し合わし
すまわせる	すまわせ
澄み切る	澄み切り
きわまる	きわまり
よろこべる	よろこべ
もらす	もらし
上向く	上向き
思いがける	思いがけ
のびなやむ	のびなやみ
てりかがやく	てりかがやき
挟み切る	挟み切り
ぼっする	挟み切り
擦り切れる	擦り切れ
黴びる	黴び
もちあわせる	もちあわせ
ふるぼける	ふるぼけ
蠕く	蠕き
打ちこむ	打ちこみ
おもいだす	おもいだし
つっぱれる	つっぱれ
きりたおす	きりたおし
やわらげる	やわらげ
差し戻す	差し戻し
届けでる	届けで
群がる	群がり
振り込む	振り込み
わかれる	わかれ
しのびよる	しのびより
惑わす	惑わし
居合わせる	居合わせ
つまさきだつ	つまさきだち
せしめる	せしめ
宿れる	宿れ
成れる	成れ
盈ちる	盈ち
通ずる	盈ち
かいとれる	かいとれ
はるめく	はるめき
切り取れる	切り取れ
聞きただす	聞きただし
遡れる	遡れ
耽る	耽り
ちなむ	ちなみ
さずける	さずけ
とう	とい
とびだす	とびだし
跳ね出す	跳ね出し
盛上がる	盛上がり
学び取る	学び取り
こじつける	こじつけ
くわえもつ	くわえもち
あいなかばする	くわえもち
よりあつまる	よりあつまり
雪ぐ	雪ぎ
見合わせる	見合わせ
たのしめる	たのしめ
およぼせる	およぼせ
けとばす	けとばし
ぬきつらねる	ぬきつらね
くみとる	くみとり
かんけいづける	かんけいづけ
噴き出す	噴き出し
ひきちぎる	ひきちぎり
買いしめる	買いしめ
さす	さし
赤らめる	赤らめ
打ち抜く	打ち抜き
付あがる	付あがり
ねじくれる	ねじくれ
ふきとばせる	ふきとばせ
だす	だし
かきいれる	かきいれ
みつけだせる	みつけだせ
当はまる	当はまり
くぼまる	くぼまり
ぬぎすてる	ぬぎすて
取りくむ	取りくみ
言立てる	言立て
掬する	言立て
焼かす	焼かし
おいぬく	おいぬき
ひきあえる	ひきあえ
呑明かす	呑明かし
洗い流せる	洗い流せ
甲走る	甲走り
差支える	差支え
割る	割
生じる	生じ
呼込む	呼込み
止まれる	止まれ
紛らわせる	紛らわせ
切換える	切換え
しみったれる	しみったれ
ふすぶる	ふすぶり
立て込む	立て込み
居残れる	居残れ
掻き鳴らす	掻き鳴らし
のろう	のろい
まじろぐ	まじろぎ
じらせる	じらせ
痛みいる	痛みいり
乾し殺す	乾し殺し
勝つ	勝ち
飽きる	飽き
契る	契り
磨き込む	磨き込み
設ける	設け
秘す	秘し
言い捨てる	言い捨て
差し出でる	差し出で
仕入れる	仕入れ
取っ組む	取っ組み
従く	従き
数え立てる	数え立て
ひっ提げる	ひっ提げ
おくりとどける	おくりとどけ
遅らせる	遅らせ
だます	だまし
比べる	比べ
僻む	僻み
引きずり出す	引きずり出し
罷り間違う	罷り間違い
たおれる	たおれ
つけあがる	つけあがり
滴る	滴り
見向く	見向き
絞め殺す	絞め殺し
懲りる	懲り
知恵づく	知恵づき
遣り合う	遣り合い
搾り取れる	搾り取れ
量りこむ	量りこみ
煮えたぎる	煮えたぎり
言いふらす	言いふらし
見顕す	見顕し
名付ける	名付け
ちらばる	ちらばり
承ける	承け
かいならす	かいならし
楽しむ	楽しみ
切れ上がる	切れ上がり
勘づく	勘づき
見なせる	見なせ
判ずる	見なせ
書送る	書送り
のぼせ上がる	のぼせ上がり
もみ消せる	もみ消せ
おかけいたす	おかけいたし
引き込める	引き込め
あやつれる	あやつれ
這いつくばう	這いつくばい
ぶちこむ	ぶちこみ
案じる	案じ
語り継ぐ	語り継ぎ
落着ける	落着け
くぐりぬける	くぐりぬけ
造り上げる	造り上げ
引き分ける	引き分け
精げる	精げ
朽ちる	朽ち
つまみあげる	つまみあげ
しばりあげる	しばりあげ
問返す	問返し
おしきれる	おしきれ
なする	なすり
なおせる	なおせ
撰ぶ	撰び
つかす	つかし
ふるい落とす	ふるい落とし
ぶん投げる	ぶん投げ
関連づける	関連づけ
ひどる	ひどり
すくいあげる	すくいあげ
とりのこす	とりのこし
つきそう	つきそい
おびきだせる	おびきだせ
拉する	おびきだせ
とびあるく	とびあるき
みまがう	みまがい
つぎ込める	つぎ込め
浴びせかける	浴びせかけ
静まり返る	静まり返り
悩み抜く	悩み抜き
空かす	空かし
ふるいつく	ふるいつき
くぐもる	くぐもり
おりこめる	おりこめ
萌える	萌え
そぐ	そぎ
禦ぐ	禦ぎ
見逃す	見逃し
繁る	繁り
下せる	下せ
めりこむ	めりこみ
つよまる	つよまり
めいうつ	めいうち
言い兼ねる	言い兼ね
取り上せる	取り上せ
借り受ける	借り受け
差響く	差響き
やくせる	やくせ
飛び出る	飛び出
しめしあわす	しめしあわし
あせじみる	あせじみ
おいつかう	おいつかい
すりきる	すりきり
斥ける	斥け
できる	でき
うすめる	うすめ
ひんまげる	ひんまげ
隙取る	隙取り
のめり込む	のめり込み
頂く	頂き
塗れる	塗れ
気付かす	気付かし
まっとうする	気付かし
殺す	殺し
ぶっ続ける	ぶっ続け
はこびこめる	はこびこめ
とびたつ	とびたち
避ける	避け
としよる	としより
合う	合い
泊める	泊め
渡り合える	渡り合え
釣り上がる	釣り上がり
期する	釣り上がり
いばれる	いばれ
切廻す	切廻し
よっぱらう	よっぱらい
さぐる	さぐり
誘きよせる	誘きよせ
犒う	犒い
打ち出す	打ち出し
すさる	すさり
冷ます	冷まし
注げる	注げ
まちこがれる	まちこがれ
つっぱねる	つっぱね
割り戻す	割り戻し
ねじあう	ねじあい
震えあがる	震えあがり
漏れ聞く	漏れ聞き
しめ切る	しめ切り
ひきころす	ひきころし
よわまる	よわまり
どもる	どもり
ひする	どもり
はする	どもり
しまう	しまい
交う	交い
シャレる	シャレ
ふりだせる	ふりだせ
息せき切る	息せき切り
栄える	栄え
ひりだす	ひりだし
おる	おり
かさばる	かさばり
突っ突く	突っ突き
冴えわたる	冴えわたり
打ちはらう	打ちはらい
まいもどれる	まいもどれ
掃く	掃き
たよる	たより
見過ごせる	見過ごせ
出あう	出あい
なきあかす	なきあかし
四角張る	四角張り
からかう	からかい
荒ぶ	荒び
にくまれる	にくまれ
倒す	倒し
どなる	どなり
踏分ける	踏分け
勢い込む	勢い込み
よみかえせる	よみかえせ
口ずさむ	口ずさみ
尽す	尽し
討ち滅ぼす	討ち滅ぼし
嗅ぐ	嗅ぎ
探り当てる	探り当て
息衝く	息衝き
上る	上り
買いこむ	買いこみ
買戻す	買戻し
ぬくめる	ぬくめ
接げる	接げ
連れ戻せる	連れ戻せ
やくだてる	やくだて
懸け隔てる	懸け隔て
たちつくす	たちつくし
しょうずる	たちつくし
奮い立つ	奮い立ち
ろんじる	ろんじ
掴まえる	掴まえ
あがめる	あがめ
興醒める	興醒め
巡り合う	巡り合い
そそぐ	そそぎ
萎える	萎え
かこむ	かこみ
朝する	かこみ
もたれ掛かる	もたれ掛かり
着付ける	着付け
よどむ	よどみ
そる	そり
こぎる	こぎり
量れる	量れ
うりいそぐ	うりいそぎ
なぞらえる	なぞらえ
灼く	灼き
せつく	せつき
煎りつける	煎りつけ
おりまげる	おりまげ
よびいれる	よびいれ
差し向ける	差し向け
当てつける	当てつけ
好きこのむ	好きこのみ
頌える	頌え
むくいる	むくい
かきとる	かきとり
遊び歩く	遊び歩き
付け合わせる	付け合わせ
かきくらす	かきくらし
のむ	のみ
持ちかえる	持ちかえり
育つ	育ち
あいうつ	あいうち
炊あがる	炊あがり
没する	炊あがり
のめる	のめり
はこべる	はこべ
解れる	解れ
すげる	すげ
落つ	落ち
綻ぶ	綻び
刻みつける	刻みつけ
迫る	迫り
赤らむ	赤らみ
見限る	見限り
巣篭る	巣篭り
ぬかるむ	ぬかるみ
読みこなす	読みこなし
ひきこめる	ひきこめ
くらべる	くらべ
食いつく	食いつき
衝く	衝き
かざりつける	かざりつけ
あだめく	あだめき
言逃れる	言逃れ
責めつける	責めつけ
投げる	投げ
持ち歩ける	持ち歩け
煩う	煩い
学ぶ	学び
もちはこべる	もちはこべ
ほれこむ	ほれこみ
買い戻す	買い戻し
かけあわせる	かけあわせ
点じる	点じ
間にあう	間にあい
蒔き直す	蒔き直し
おいまわせる	おいまわせ
かえせる	かえせ
閉込める	閉込め
買い戻せる	買い戻せ
拭き取れる	拭き取れ
黙り込む	黙り込み
点頭く	点頭き
ひきおこす	ひきおこし
見込む	見込み
巡り会える	巡り会え
行き暮れる	行き暮れ
かぶれる	かぶれ
こきおろす	こきおろし
じょする	こきおろし
抜き放つ	抜き放ち
ねわすれる	ねわすれ
聞置く	聞置き
剥す	剥し
疎む	疎み
偽る	偽り
垂さがる	垂さがり
ころべる	ころべ
のぞきこむ	のぞきこみ
想う	想い
奢る	奢り
引っ掻く	引っ掻き
死す	死し
もりころす	もりころし
死に後れる	死に後れ
寄り切る	寄り切り
ざする	寄り切り
ぱちつかせる	ぱちつかせ
突っかかる	突っかかり
つらなる	つらなり
包める	包め
にがす	にがし
せんする	にがし
みわたす	みわたし
沸かす	沸かし
むさぼる	むさぼり
励ます	励まし
助け出せる	助け出せ
かみ殺せる	かみ殺せ
きりこまざく	きりこまざき
しごく	しごき
抜き合せる	抜き合せ
突き返す	突き返し
すりあげる	すりあげ
付随う	付随い
ゆわく	ゆわき
遇する	ゆわき
当て込める	当て込め
見上げる	見上げ
賑わう	賑わい
費やす	費やし
掃出す	掃出し
差立てる	差立て
つまめる	つまめ
思い込む	思い込み
増える	増え
擂り潰す	擂り潰し
がする	擂り潰し
よみわける	よみわけ
信じ込める	信じ込め
せきあげる	せきあげ
現ずる	せきあげ
なぜる	なぜ
ひっくりかえれる	ひっくりかえれ
たるむ	たるみ
誑す	誑し
あまがける	あまがけり
はたらける	はたらけ
悄気返る	悄気返り
切羽詰まる	切羽詰まり
求む	求み
だきあえる	だきあえ
食切る	食切り
産み落とす	産み落とし
留置く	留置き
給う	給い
廃れる	廃れ
のしあがる	のしあがり
見とがめる	見とがめ
叶う	叶い
吊るす	吊るし
注す	注し
つたわる	つたわり
あやどる	あやどり
抱きとめる	抱きとめ
なくする	抱きとめ
なでる	なで
読みさす	読みさし
ころがれる	ころがれ
憂える	憂え
追い返す	追い返し
過ごせる	過ごせ
みがく	みがき
さしせまる	さしせまり
寄り切れる	寄り切れ
追い使う	追い使い
流行る	流行り
働きかける	働きかけ
信じ合える	信じ合え
まくらする	信じ合え
とりいる	とりいり
切り掛ける	切り掛け
そなえる	そなえ
呆れる	呆れ
浸かる	浸かり
はげ落ちる	はげ落ち
きずつく	きずつき
おくまる	おくまり
とりそろう	とりそろい
突き通せる	突き通せ
きょうじる	きょうじ
駆付ける	駆付け
結わえる	結わえ
蟠る	蟠り
泣き濡れる	泣き濡れ
見透す	見透し
盗める	盗め
引っ込む	引っ込み
峙つ	峙ち
ながれこむ	ながれこみ
どんする	ながれこみ
流行らす	流行らし
みなおす	みなおし
忘する	みなおし
詰める	詰め
引き裂く	引き裂き
興す	興し
いぶかる	いぶかり
映し出す	映し出し
しぼる	しぼり
ふみこす	ふみこし
計れる	計れ
ひくめる	ひくめ
仕向ける	仕向け
抱く	抱き
立ち寄る	立ち寄り
ぱくつく	ぱくつき
似る	似
忍び込む	忍び込み
塗りたくる	塗りたくり
練り上げる	練り上げ
やむをえる	やむをえ
投げ出す	投げ出し
入れ替る	入れ替り
粘り抜ける	粘り抜け
ほれる	ほれ
引きかえす	引きかえし
売る	売り
悼む	悼み
叩き上げる	叩き上げ
乗り掛かる	乗り掛かり
ゆずりわたす	ゆずりわたし
すげ替える	すげ替え
たくわえる	たくわえ
売切れる	売切れ
雇える	雇え
かきかえる	かきかえ
羞じらう	羞じらい
泣付く	泣付き
みあう	みあい
出張る	出張り
寝かす	寝かし
くいつぶす	くいつぶし
かきまわす	かきまわし
畳み掛ける	畳み掛け
すまう	すまい
干枯らびる	干枯らび
取りまく	取りまき
はてる	はて
撃ち落とせる	撃ち落とせ
沸き上がる	沸き上がり
飲みつぶす	飲みつぶし
いいあらわせる	いいあらわせ
歩き回る	歩き回り
だける	だけ
決する	だけ
ぬぐう	ぬぐい
もうしあわす	もうしあわし
血走る	血走り
顕す	顕し
煉る	煉り
ぐうする	煉り
書残す	書残し
取りだす	取りだし
目盛る	目盛り
敗ける	敗け
洗い立てる	洗い立て
しのぶ	しのび
書き換える	書き換え
死にそこなう	死にそこない
やる	やり
おもいなやむ	おもいなやみ
飛び掛る	飛び掛り
変り果てる	変り果て
でくわす	でくわし
いいあらそう	いいあらそい
たよれる	たよれ
ふぶく	ふぶき
越せる	越せ
すべくくる	すべくくり
掴みあう	掴みあい
持ち崩す	持ち崩し
ふみつぶす	ふみつぶし
堪る	堪り
呆れ返る	呆れ返り
片す	片し
はりあえる	はりあえ
なりたつ	なりたち
走り込める	走り込め
しゃしゃり出る	しゃしゃり出
醒ませる	醒ませ
ゆく	ゆき
縛れる	縛れ
ねりあげる	ねりあげ
存する	ねりあげ
かしずく	かしずき
覆える	覆え
くいあらす	くいあらし
起き直れる	起き直れ
思いあたる	思いあたり
あやつる	あやつり
責め合う	責め合い
おわらす	おわらし
通せる	通せ
とりひしぐ	とりひしぎ
ひきぬく	ひきぬき
せめさいなむ	せめさいなみ
あからめる	あからめ
差し越える	差し越え
進ずる	差し越え
巡り会う	巡り会い
げんじる	げんじ
覚ませる	覚ませ
ひっかぶる	ひっかぶり
かなでる	かなで
そりおとせる	そりおとせ
いためつける	いためつけ
害す	害し
聞す	聞し
よなげる	よなげ
すいする	よなげ
見下せる	見下せ
手放せる	手放せ
ゆうきづく	ゆうきづき
やられる	やられ
そむける	そむけ
疑う	疑い
唄う	唄い
掴まる	掴まり
なりあがる	なりあがり
そそげる	そそげ
弱まる	弱まり
取り縋る	取り縋り
持ち越せる	持ち越せ
取り除く	取り除き
収まる	収まり
ひとはたあげる	ひとはたあげ
切り分ける	切り分け
亙る	亙り
すべる	すべり
がなる	がなり
見遣る	見遣り
かけめぐる	かけめぐり
滑らす	滑らし
産み落とせる	産み落とせ
作りかえる	作りかえ
さきはじめる	さきはじめ
つっかかる	つっかかり
捩じこむ	捩じこみ
まきなおす	まきなおし
負ぶさる	負ぶさり
はさめる	はさめ
つのぐむ	つのぐみ
聞き取る	聞き取り
表立つ	表立ち
見張る	見張り
差昇る	差昇り
およぼす	およぼし
尊ぶ	尊び
考える	考え
賀する	考え
鎮める	鎮め
あだする	鎮め
切り払える	切り払え
盗み出す	盗み出し
ききこめる	ききこめ
追返す	追返し
窪む	窪み
言切る	言切り
出で立つ	出で立ち
ぶつかる	ぶつかり
笑いころげる	笑いころげ
取り入れる	取り入れ
うかびあがれる	うかびあがれ
切らす	切らし
反返る	反返り
ふせる	ふせり
逆らう	逆らい
閉め切る	閉め切り
夢みる	夢み
ゆき届く	ゆき届き
はく	はき
逃す	逃し
患う	患い
義務付ける	義務付け
漁る	漁り
いらう	いらい
嗜む	嗜み
まぎらわせる	まぎらわせ
梳かす	梳かし
書き直す	書き直し
立ち上がれる	立ち上がれ
あるく	あるき
押える	押え
のりこめる	のりこめ
こむ	こみ
買い入れる	買い入れ
通りかかる	通りかかり
気にいる	気にいり
送り返す	送り返し
取替える	取替え
もうしこす	もうしこし
ふみならせる	ふみならせ
おくりかえせる	おくりかえせ
臭わす	臭わし
しなう	しない
取り廻す	取り廻し
とりそろえる	とりそろえ
おいつける	おいつけ
申し合せる	申し合せ
とびぬける	とびぬけ
興ざめる	興ざめ
語り込める	語り込め
押さえる	押さえ
現われる	現われ
くずせる	くずせ
おどれる	おどれ
押つまる	押つまり
先がける	先がけ
さいばしる	さいばしり
振放つ	振放ち
ねつける	ねつけ
深める	深め
こじあける	こじあけ
請出す	請出し
鄙びる	鄙び
散らす	散らし
払い戻す	払い戻し
揺すぶる	揺すぶり
すさむ	すさみ
たちかわれる	たちかわれ
かよう	かよい
附ける	附け
あせばむ	あせばみ
あまてらす	あまてらし
造りだす	造りだし
うけもつ	うけもち
渡る	渡り
かいつまむ	かいつまみ
殖える	殖え
打寄せる	打寄せ
ばかげる	ばかげ
おちのびる	おちのび
はいりこむ	はいりこみ
敷く	敷き
さきほこる	さきほこり
丸める	丸め
引き立つ	引き立ち
妬ける	妬け
じゃくする	妬け
はねとばす	はねとばし
煮え繰り返る	煮え繰り返り
乗り回す	乗り回し
きりはずせる	きりはずせ
着こなせる	着こなせ
召し捕る	召し捕り
しぼれる	しぼれ
けしきばむ	けしきばみ
くるしむ	くるしみ
号する	くるしみ
噴き上げる	噴き上げ
気おされる	気おされ
くわだてる	くわだて
通る	通り
狂う	狂い
決めこむ	決めこみ
図れる	図れ
とりあげる	とりあげ
住まう	住まい
ひんす	ひんし
ふれる	ふれ
言わす	言わし
行く	行き
及ぼす	及ぼし
引払う	引払い
埋め込める	埋め込め
目くるめく	目くるめき
抜く	抜き
ねり合せる	ねり合せ
纏える	纏え
につめる	につめ
返る	返り
くりかえす	くりかえし
はらいこめる	はらいこめ
説付ける	説付け
選び出す	選び出し
はやる	はやり
聞きあきる	聞きあき
おいやれる	おいやれ
切開く	切開き
踞る	踞り
棄てる	棄て
撓む	撓み
染あがる	染あがり
埋めたてる	埋めたて
同じる	同じ
あばれだす	あばれだし
なおす	なおし
呼び起こす	呼び起こし
連れる	連れ
ふりおとせる	ふりおとせ
みだれる	みだれ
誘い合わす	誘い合わし
たちもどる	たちもどり
眇める	眇め
ねびる	ねび
漉き返す	漉き返し
克つ	克ち
極め付ける	極め付け
こそぎ落とす	こそぎ落とし
まちくたびれる	まちくたびれ
追廻す	追廻し
願い出でる	願い出で
奏する	願い出で
咳き入る	咳き入り
取り続ける	取り続け
さます	さまし
いためる	いため
ふかす	ふかし
断れる	断れ
ひきとる	ひきとり
突っ走れる	突っ走れ
くみこめる	くみこめ
うてる	うて
のがす	のがし
磨く	磨き
いきぬける	いきぬけ
盛りつける	盛りつけ
継足す	継足し
弾く	弾き
痴れる	痴れ
くり上げる	くり上げ
ふみだす	ふみだし
たちこむ	たちこみ
綻びる	綻び
食倒す	食倒し
炊ぐ	炊ぎ
咲きこぼれる	咲きこぼれ
言い換える	言い換え
静まる	静まり
悔い改める	悔い改め
隣合う	隣合い
居坐る	居坐り
助ける	助け
奏でる	奏で
報う	報い
まもれる	まもれ
はさみきる	はさみきり
治る	治り
のりとおす	のりとおし
といただせる	といただせ
そばだつ	そばだち
いろどれる	いろどれ
きり組む	きり組み
産みおとす	産みおとし
寄せる	寄せ
埋め立てる	埋め立て
くわす	くわし
紐解く	紐解き
さしいれる	さしいれ
辷り込む	辷り込み
傾ぐ	傾ぎ
売り払える	売り払え
むく	むき
うちこめる	うちこめ
やせこける	やせこけ
まつわる	まつわり
煮え滾る	煮え滾り
翳る	翳り
一肌脱ぐ	一肌脱ぎ
くめる	くめ
わかやぐ	わかやぎ
つっぱしる	つっぱしり
裁ける	裁け
はっする	裁け
述べる	述べ
押返す	押返し
まわりこめる	まわりこめ
力付ける	力付け
切り立てる	切り立て
かどだつ	かどだち
せめかける	せめかけ
きしる	きしり
引き戻せる	引き戻せ
うもれる	うもれ
辞する	うもれ
編む	編み
取広げる	取広げ
止む	止み
有触れる	有触れ
ねらい打てる	ねらい打て
立てこもる	立てこもり
除く	除き
甜める	甜め
聞損なう	聞損ない
聞き捨てる	聞き捨て
ふみしだく	ふみしだき
読み耽る	読み耽り
挟み込む	挟み込み
絡める	絡め
走り回れる	走り回れ
ただれる	ただれ
滾つ	滾ち
なすり付ける	なすり付け
あつめる	あつめ
カエる	カエり
手伝える	手伝え
はりあわす	はりあわし
熱る	熱り
しょい込む	しょい込み
くみつける	くみつけ
たずさわる	たずさわり
練り直せる	練り直せ
たたきおこす	たたきおこし
とりざたす	とりざたし
育む	育み
きなさる	きなさり
寝かせる	寝かせ
なつく	なつき
かぎ出せる	かぎ出せ
飛び離れる	飛び離れ
たれさがる	たれさがり
とりちがえる	とりちがえ
言い放す	言い放し
配り歩ける	配り歩け
吹きまくる	吹きまくり
へし折る	へし折り
受止める	受止め
啜り泣く	啜り泣き
張り合う	張り合い
あか抜ける	あか抜け
知らせる	知らせ
帯びる	帯び
むすぶ	むすび
打ち見る	打ち見
行届く	行届き
華やぐ	華やぎ
おそれる	おそれ
たずねる	たずね
あるける	あるけ
突っ伏す	突っ伏し
つちかえる	つちかえ
住み替る	住み替り
いや増す	いや増し
ぶち当てる	ぶち当て
つきすすめる	つきすすめ
おさえこむ	おさえこみ
舞戻る	舞戻り
撮れる	撮れ
あばく	あばき
しれる	しれ
整う	整い
かきくれる	かきくれ
踏み付ける	踏み付け
呵る	呵り
持込む	持込み
だまりこくる	だまりこくり
ほてる	ほてり
染みる	染み
連れ回す	連れ回し
暗む	暗み
待ち付ける	待ち付け
買切る	買切り
勝ち越せる	勝ち越せ
着ぶくれる	着ぶくれ
おどす	おどし
間引ける	間引け
たやす	たやし
うめこめる	うめこめ
すめる	すめ
見抜ける	見抜け
嫌われる	嫌われ
盛あがる	盛あがり
息む	息み
創り出す	創り出し
ぶつ	ぶち
ふきあれる	ふきあれ
振り払う	振り払い
みきる	みきり
ごてる	ごて
しんじこむ	しんじこみ
差伸べる	差伸べ
さしぐむ	さしぐみ
飛び廻る	飛び廻り
取違える	取違え
かんじいる	かんじいり
辞む	辞み
のりかかる	のりかかり
とむ	とみ
ひる	ひ
色づく	色づき
とうじる	とうじ
討止める	討止め
しもがかる	しもがかり
落合う	落合い
ふみぬく	ふみぬき
しみわたる	しみわたり
捕る	捕り
もえつく	もえつき
並べ立てる	並べ立て
かたれる	かたれ
撃てる	撃て
さまよう	さまよい
ほえる	ほえ
引つれる	引つれ
思い悩む	思い悩み
組み直す	組み直し
投出す	投出し
血ばしる	血ばしり
折れ込む	折れ込み
扱き下ろす	扱き下ろし
まとえる	まとえ
喫する	まとえ
よこぎる	よこぎり
乗り付ける	乗り付け
けんずる	乗り付け
刈り入れる	刈り入れ
倒せる	倒せ
さしかかる	さしかかり
閉す	閉し
かしこまる	かしこまり
あららげる	あららげ
擦れる	擦れ
ありがたがる	ありがたがり
抱きしめる	抱きしめ
みちびきだせる	みちびきだせ
ひっとらえる	ひっとらえ
おしかける	おしかけ
どなりこむ	どなりこみ
やらかす	やらかし
くるう	くるい
明け渡す	明け渡し
渡り合う	渡り合い
手間取る	手間取り
貸し出せる	貸し出せ
相いれる	相いれ
えどる	えどり
掻き出す	掻き出し
しいする	掻き出し
取乱す	取乱し
なりわたる	なりわたり
熟する	なりわたり
やきすてる	やきすて
張り巡らす	張り巡らし
駆り集める	駆り集め
潮垂れる	潮垂れ
冷やかす	冷やかし
貯める	貯め
引き渡す	引き渡し
たかめる	たかめ
ちぢむ	ちぢみ
いらっしゃる	いらっしゃい
塗付ける	塗付け
縢る	縢り
詠み込める	詠み込め
伸びゆく	伸びゆき
埋め合せる	埋め合せ
はせさんずる	埋め合せ
蔑む	蔑み
待てる	待て
鎮まる	鎮まり
あそべる	あそべ
たてる	たて
こしらえる	こしらえ
うっちゃる	うっちゃり
開ける	開け
谷まる	谷まり
なベかえる	なベかえ
あずけいれる	あずけいれ
追いかける	追いかけ
よみとおす	よみとおし
行き詰まる	行き詰まり
騒がす	騒がし
見え透く	見え透き
おそわれる	おそわれ
巣だつ	巣だち
落ち着く	落ち着き
追い縋る	追い縋り
きえのこる	きえのこり
おく	おき
いける	いけ
産む	産み
つたう	つたい
ときつける	ときつけ
歩き回れる	歩き回れ
突あたる	突あたり
約す	約し
はいす	はいし
うわつく	うわつき
下ろす	下ろし
すすみだせる	すすみだせ
競る	競り
こりかたまる	こりかたまり
遣い込む	遣い込み
悖る	悖り
踏みしめる	踏みしめ
ほほえむ	ほほえみ
誘い掛ける	誘い掛け
読みつぐ	読みつぎ
信ずる	読みつぎ
ゆき悩む	ゆき悩み
薫る	薫り
とりこむ	とりこみ
攫う	攫い
突っぱねる	突っぱね
かねあう	かねあい
はまる	はまり
揺さぶる	揺さぶり
受けつける	受けつけ
もどせる	もどせ
繰り入れる	繰り入れ
生まれ変わる	生まれ変わり
持たす	持たし
降り続く	降り続き
縫いつける	縫いつけ
とびはなれる	とびはなれ
にぶる	にぶり
浮つく	浮つき
夾む	夾み
よわめる	よわめ
変る	変り
さけぶ	さけび
くぼめる	くぼめ
でそろう	でそろい
散りはてる	散りはて
のりおくれる	のりおくれ
つかうまつる	つかうまつり
引っ捕える	引っ捕え
取戻す	取戻し
うすれる	うすれ
もりあがる	もりあがり
称す	称し
暴ける	暴け
ひきのける	ひきのけ
しぼり上げる	しぼり上げ
さがしだせる	さがしだせ
いきり立つ	いきり立ち
抜く	抜き
取りまとめる	取りまとめ
ふっ切れる	ふっ切れ
絶えはてる	絶えはて
えんじる	えんじ
行く	行き
転がす	転がし
うちやぶる	うちやぶり
捜せる	捜せ
引こもる	引こもり
組み合す	組み合し
思い起こせる	思い起こせ
絞る	絞り
なつかしむ	なつかしみ
ふきこめる	ふきこめ
泳ぎ着く	泳ぎ着き
成り下がれる	成り下がれ
たすける	たすけ
そそり立てる	そそり立て
たたき出す	たたき出し
取り消す	取り消し
繰り出せる	繰り出せ
染め返す	染め返し
とびこむ	とびこみ
ひしげる	ひしげ
吹き飛ぶ	吹き飛び
盛り込める	盛り込め
手こずる	手こずり
むかいあう	むかいあい
掴める	掴め
引攣れる	引攣れ
楯突く	楯突き
ひきさがる	ひきさがり
肖る	肖り
便ずる	肖り
摘み取る	摘み取り
せいだせる	せいだせ
断てる	断て
りゃくす	りゃくし
降りかかる	降りかかり
うえこめる	うえこめ
酔しれる	酔しれ
はぐらかせる	はぐらかせ
しあがる	しあがり
取壊す	取壊し
吹きすさぶ	吹きすさび
ゆがめる	ゆがめ
生かる	生かり
とり殺す	とり殺し
かきくもる	かきくもり
乱れる	乱れ
さがしまわる	さがしまわり
庇う	庇い
ついてまわる	ついてまわり
かいつくろう	かいつくろい
ふける	ふけ
飛びたつ	飛びたち
採り上げる	採り上げ
くみす	くみし
明け離れる	明け離れ
取りつく	取りつき
買い被る	買い被り
むらだつ	むらだち
浮きたつ	浮きたち
持て扱う	持て扱い
おさえる	おさえ
翻る	翻り
飲み下す	飲み下し
著す	著し
わびる	わび
とげだつ	とげだち
賜う	賜い
いする	賜い
のけぞる	のけぞり
勇気づく	勇気づき
勢いづける	勢いづけ
突く	突き
ふんじばる	ふんじばり
待ち伏せる	待ち伏せ
さいなむ	さいなみ
たてとおす	たてとおし
詣る	詣り
うる	詣り
謳う	謳い
すいあげる	すいあげ
逃せる	逃せ
まちもうける	まちもうけ
当こする	当こすり
行き合う	行き合い
折りたたむ	折りたたみ
うちあぐむ	うちあぐみ
下がかる	下がかり
縮み上がる	縮み上がり
飛び上がる	飛び上がり
取り付ける	取り付け
ゆきあたる	ゆきあたり
零落れる	零落れ
かまける	かまけ
蒸らす	蒸らし
合う	合い
縮む	縮み
経上がる	経上がり
立ち上がる	立ち上がり
ぬきだせる	ぬきだせ
告ぐ	告ぎ
だす	だし
突き出す	突き出し
取りやめる	取りやめ
つきかえす	つきかえし
ざんねんがる	ざんねんがり
付け加える	付け加え
やりとげる	やりとげ
ふりまく	ふりまき
屯する	ふりまき
はりあう	はりあい
召し上げる	召し上げ
解けあう	解けあい
切り開く	切り開き
見直す	見直し
打ちあわす	打ちあわし
窺う	窺い
貶む	貶み
捏ねかえす	捏ねかえし
呼び叫ぶ	呼び叫び
たちいたる	たちいたり
たまげる	たまげ
受継ぐ	受継ぎ
消え残る	消え残り
さしひかえる	さしひかえ
追い越せる	追い越せ
じゅんずる	追い越せ
建つ	建ち
終わらせる	終わらせ
もみあう	もみあい
差し付ける	差し付け
むきあえる	むきあえ
寝そびれる	寝そびれ
立回る	立回り
舞い戻れる	舞い戻れ
言い当てる	言い当て
すっ飛ぶ	すっ飛び
生れおちる	生れおち
乗り組める	乗り組め
いらっしゃる	いらっしゃい
切上げる	切上げ
貢ずる	切上げ
さしだせる	さしだせ
わたりあう	わたりあい
守り抜く	守り抜き
うずもる	うずもり
保てる	保て
みひらく	みひらき
引き合わす	引き合わし
過ぎ行く	過ぎ行き
因む	因み
いちゃつく	いちゃつき
糶る	糶り
捲き揚げる	捲き揚げ
ひきずりだす	ひきずりだし
取り壊せる	取り壊せ
攻めたてる	攻めたて
為す	為し
澄みわたる	澄みわたり
填る	填り
周章てる	周章て
感づく	感づき
たちなおる	たちなおり
跳ねあがる	跳ねあがり
値する	跳ねあがり
ぐずつく	ぐずつき
かき寄せる	かき寄せ
奨める	奨め
折畳む	折畳み
馴れ合う	馴れ合い
作り出せる	作り出せ
守る	守り
かりとれる	かりとれ
思い知らす	思い知らし
とおれる	とおれ
巻きこむ	巻きこみ
並みいる	並みい
めんじる	めんじ
陳べる	陳べ
たちそう	たちそい
さしとめる	さしとめ
調べる	調べ
惚ける	惚け
ゆるぎ出る	ゆるぎ出
べと付く	べと付き
まちあわす	まちあわし
煮含める	煮含め
べとつく	べとつき
かりたてる	かりたて
かりきる	かりきり
つからせる	つからせ
捜し求める	捜し求め
撫す	撫し
くみとれる	くみとれ
かっ飛ばす	かっ飛ばし
かき鳴らす	かき鳴らし
ふるわせる	ふるわせ
鋳潰す	鋳潰し
食違う	食違い
打ち合せる	打ち合せ
せせくる	せせくり
気付く	気付き
触回る	触回り
走り回る	走り回り
とぐ	とぎ
いいこめる	いいこめ
かこつける	かこつけ
振り当てる	振り当て
にぎわう	にぎわい
こわばる	こわばり
長引く	長引き
みきわめる	みきわめ
押通す	押通し
かたづく	かたづき
すいとる	すいとり
おきあがれる	おきあがれ
航る	航り
浮べる	浮べ
引きたてる	引きたて
さしこす	さしこし
掘り出す	掘り出し
染めかえす	染めかえし
泣込む	泣込み
とりまぎれる	とりまぎれ
かけまわる	かけまわり
見なれる	見なれ
思い止る	思い止り
老いる	老い
すすむ	すすみ
くりだす	くりだし
廻す	廻し
寝惚ける	寝惚け
凝り固まる	凝り固まり
向き直る	向き直り
塞がる	塞がり
ふちどる	ふちどり
脹らむ	脹らみ
たぶらかす	たぶらかし
年老いる	年老い
買い込む	買い込み
征する	買い込み
届ける	届け
勝ち越す	勝ち越し
にぎわわす	にぎわわし
ゆける	ゆけ
捌かす	捌かし
縛り上げる	縛り上げ
はしょれる	はしょれ
だまくらかす	だまくらかし
捺す	捺し
問いただす	問いただし
相伴う	相伴い
かがやかす	かがやかし
売り払う	売り払い
のりする	売り払い
滑り込める	滑り込め
吸い取る	吸い取り
重んじる	重んじ
もどる	もどり
恨む	恨み
はやめる	はやめ
錆び付く	錆び付き
つめきる	つめきり
怒鳴り込む	怒鳴り込み
観ずる	怒鳴り込み
引当てる	引当て
押し薦める	押し薦め
あてがう	あてがい
つやめく	つやめき
取次ぐ	取次ぎ
捨て去る	捨て去り
さぐりだせる	さぐりだせ
仕上る	仕上り
乗ずる	仕上り
にえる	にえ
留め置く	留め置き
敷きつめる	敷きつめ
交ぜっかえす	交ぜっかえし
かき消す	かき消し
切り裂く	切り裂き
烟る	烟り
ききつける	ききつけ
煮る	煮
みにつける	みにつけ
ぐれる	ぐれ
ねりあわす	ねりあわし
つきとおす	つきとおし
座りこむ	座りこみ
臥せる	臥せり
立ち去る	立ち去り
降す	降し
おじける	おじけ
かすむ	かすみ
ねらい打つ	ねらい打ち
織れる	織れ
はびこる	はびこり
見直せる	見直せ
仰向く	仰向き
満ち足りる	満ち足り
つぎたせる	つぎたせ
乗りかける	乗りかけ
さらけだす	さらけだし
なげかてる	なげかて
則る	則り
ころぶ	ころび
しぶる	しぶり
こびり着く	こびり着き
みみなれる	みみなれ
拉ぐ	拉ぎ
憂ふ	憂ひ
分け与える	分け与え
位置付ける	位置付け
おもいきれる	おもいきれ
弄ぶ	弄び
飛び乗れる	飛び乗れ
売りさばく	売りさばき
おもいこむ	おもいこみ
握る	握り
考え出す	考え出し
係わる	係わり
塗り替える	塗り替え
堪りかねる	堪りかね
きつける	きつけ
しゃぶる	しゃぶり
降かかる	降かかり
吹き出る	吹き出
叱り付ける	叱り付け
物言う	物言い
とびかう	とびかい
適う	適い
弘める	弘め
服す	服し
おしきる	おしきり
乱す	乱し
助け合う	助け合い
もめる	もめ
追える	追え
寵する	追え
繰り合せる	繰り合せ
にごらす	にごらし
改まる	改まり
伐つ	伐ち
ひれふす	ひれふし
打取れる	打取れ
しのべる	しのべ
きえうせる	きえうせ
かい摘む	かい摘み
為出かす	為出かし
酔う	酔い
うけつける	うけつけ
取り扱える	取り扱え
這い出す	這い出し
入りまじる	入りまじり
打壊す	打壊し
見積る	見積り
恥じる	恥じ
襲かかる	襲かかり
張飛ばす	張飛ばし
亡くす	亡くし
降らせる	降らせ
培える	培え
宿す	宿し
捻じくれる	捻じくれ
かしつける	かしつけ
言い寄る	言い寄り
込上げる	込上げ
こと足りる	こと足り
誂える	誂え
消え失せる	消え失せ
使える	使え
さきわう	さきわい
くたびれる	くたびれ
張り詰める	張り詰め
張裂ける	張裂け
取り崩せる	取り崩せ
逆巻く	逆巻き
切りかかる	切りかかり
思いあわせる	思いあわせ
つまびく	つまびき
しばたたく	しばたたき
あげつらる	あげつらり
付回す	付回し
呑み明かす	呑み明かし
おいかえす	おいかえし
思い乱れる	思い乱れ
呼び入れる	呼び入れ
賑やかす	賑やかし
骨ばる	骨ばり
誘いまくる	誘いまくり
割ける	割け
光り輝く	光り輝き
絶やせる	絶やせ
容れる	容れ
則する	容れ
餌付く	餌付き
読み誤る	読み誤り
ふきとる	ふきとり
涸れる	涸れ
おどける	おどけ
ためらう	ためらい
おもいわずらう	おもいわずらい
埋め合わせる	埋め合わせ
徹る	徹り
へす	へし
たたき込める	たたき込め
ととのえなおす	ととのえなおし
しずめる	しずめ
書き込める	書き込め
じゃらつく	じゃらつき
笑む	笑み
たえる	たえ
飽き飽きする	たえ
ゆるぎでる	ゆるぎで
かいくる	かいくり
おぶる	おぶり
買い与える	買い与え
こき下ろす	こき下ろし
たちのぼる	たちのぼり
刈り上げる	刈り上げ
ちょんぎる	ちょんぎり
いいはなす	いいはなし
召しあげる	召しあげ
きりつける	きりつけ
いびり出す	いびり出し
付け上がる	付け上がり
形づくる	形づくり
つうぶる	つうぶり
うれえる	うれえ
逆立てる	逆立て
舞い上がる	舞い上がり
はこびだせる	はこびだせ
覚える	覚え
晒せる	晒せ
といあわす	といあわし
きり入る	きり入り
毒づく	毒づき
急かせる	急かせ
逝く	逝き
腰掛ける	腰掛け
いる	い
切りかける	切りかけ
先走る	先走り
ふきはらう	ふきはらい
あかぬける	あかぬけ
おうずる	あかぬけ
起あがる	起あがり
咲き誇る	咲き誇り
めしあがれる	めしあがれ
ふみにじる	ふみにじり
かたりこむ	かたりこみ
震い付く	震い付き
削り取れる	削り取れ
浮び上がる	浮び上がり
娶す	娶し
思いつめる	思いつめ
つめかえる	つめかえ
すべりおりる	すべりおり
かぐ	かぎ
打倒せる	打倒せ
より抜ける	より抜け
嗄れる	嗄れ
渡す	渡し
悟る	悟り
ふれ合う	ふれ合い
引込む	引込み
赤める	赤め
差し押える	差し押え
こんじる	こんじ
折りこむ	折りこみ
疲らす	疲らし
いきかえる	いきかえり
きる	きり
刈込む	刈込み
片寄せる	片寄せ
つくねる	つくね
振りはらう	振りはらい
ひけらかす	ひけらかし
せばまる	せばまり
打ち落とせる	打ち落とせ
しくじる	しくじり
ねかす	ねかし
にえたぎる	にえたぎり
こうずる	にえたぎり
おどりはじめる	おどりはじめ
寫せる	寫せ
勤しむ	勤しみ
永らえる	永らえ
忘れる	忘れ
ふてくされる	ふてくされ
当たり散らす	当たり散らし
論じる	論じ
描ける	描け
めいる	めいり
渦まく	渦まき
照りはえる	照りはえ
くすむ	くすみ
見きわめる	見きわめ
牛耳る	牛耳り
はい出る	はい出
持ち運べる	持ち運べ
きしむ	きしみ
振り込める	振り込め
聞きほれる	聞きほれ
義務づける	義務づけ
損ねる	損ね
おこせる	おこせ
うけもてる	うけもて
くりまわす	くりまわし
つきとばせる	つきとばせ
貴ぶ	貴び
おりたたむ	おりたたみ
割り出せる	割り出せ
とどこおる	とどこおり
さびつく	さびつき
咲乱れる	咲乱れ
存じる	存じ
きえさる	きえさり
這入る	這入り
思いたつ	思いたち
ひとかわむく	ひとかわむき
ききおとす	ききおとし
ただす	ただし
たえはてる	たえはて
持て成す	持て成し
現せる	現せ
わらわれる	わらわれ
おれこむ	おれこみ
頭抜ける	頭抜け
匂わす	匂わし
関わる	関わり
ひきつける	ひきつけ
鳴る	鳴り
見のがす	見のがし
印する	見のがし
慴れる	慴れ
気が付く	気が付き
ふりむける	ふりむけ
あるきまわる	あるきまわり
乗り移る	乗り移り
咲きでる	咲きで
こぼれる	こぼれ
採り入れる	採り入れ
着膨れる	着膨れ
弛れる	弛れ
手伝う	手伝い
せいす	せいし
撲りつける	撲りつけ
飛回る	飛回り
くずれさる	くずれさり
有す	有し
手繰る	手繰り
彩る	彩り
くいちがう	くいちがい
放る	放り
賑わせる	賑わせ
遠退ける	遠退け
亡ぼす	亡ぼし
廻せる	廻せ
こもれる	こもれ
乗せる	乗せ
殺せる	殺せ
擧げる	擧げ
まよう	まよい
まじわれる	まじわれ
ぼける	ぼけ
叩きあげる	叩きあげ
はむ	はみ
ききわける	ききわけ
組織だつ	組織だち
滑れる	滑れ
居合せる	居合せ
食止める	食止め
冴え渡る	冴え渡り
あいつぐ	あいつぎ
ちゃう	ちゃい
あらそえる	あらそえ
さしあたる	さしあたり
酔える	酔え
まとまる	まとまり
ひきこもる	ひきこもり
くぎれる	くぎれ
ちがう	ちがい
辞める	辞め
追いやる	追いやり
潰える	潰え
すずめる	すずめ
くれる	くれ
鍛える	鍛え
もちだす	もちだし
引っ掴む	引っ掴み
稼ぐ	稼ぎ
対する	稼ぎ
列する	稼ぎ
はさみこめる	はさみこめ
繁り合う	繁り合い
喫す	喫し
処す	処し
取り分ける	取り分け
つづりあわせる	つづりあわせ
てらす	てらし
つかむ	つかみ
てがこむ	てがこみ
組み立てる	組み立て
貶す	貶し
ダブつく	ダブつき
おぶさる	おぶさり
捌ける	捌け
印象づける	印象づけ
詰込む	詰込み
たしなむ	たしなみ
看取れる	看取れ
目する	看取れ
いいすてる	いいすて
ばいする	いいすて
降りそそぐ	降りそそぎ
堰く	堰き
護れる	護れ
くだく	くだき
吊上がる	吊上がり
肥す	肥し
せせらわらえる	せせらわらえ
和らげる	和らげ
臭う	臭い
直す	直し
照り輝く	照り輝き
かききえる	かききえ
打ち取れる	打ち取れ
煮えくりかえる	煮えくりかえり
動かせる	動かせ
へつらう	へつらい
ひねる	ひねり
ほりすすむ	ほりすすみ
あるきつづける	あるきつづけ
曇る	曇り
説く	説き
しのばす	しのばし
ぶったぎる	ぶったぎり
擂り込む	擂り込み
附く	附き
航れる	航れ
付け加わる	付け加わり
傾ける	傾け
よみきれる	よみきれ
切りこまざく	切りこまざき
切り刻む	切り刻み
生け捕れる	生け捕れ
てらう	てらい
てばなす	てばなし
まけこす	まけこし
あげる	あげ
さっぴく	さっぴき
這い纏る	這い纏り
とおのく	とおのき
交ざる	交ざり
売り渡す	売り渡し
鳴きしきる	鳴きしきり
うばいとる	うばいとり
詠みこむ	詠みこみ
いいふるす	いいふるし
つつむ	つつみ
捜す	捜し
歎ずる	捜し
埋もれる	埋もれ
かくまう	かくまい
でつくす	でつくし
飛乗る	飛乗り
腐す	腐し
取り殺す	取り殺し
ひきのばせる	ひきのばせ
つまみだせる	つまみだせ
きかかる	きかかり
とく	とき
こんがらがる	こんがらがり
おりあえる	おりあえ
こぼせる	こぼせ
はりこむ	はりこみ
ふりはらえる	ふりはらえ
出切る	出切り
たたきこむ	たたきこみ
教わる	教わり
花やぐ	花やぎ
責めさいなむ	責めさいなみ
噛みしめる	噛みしめ
狂わす	狂わし
装える	装え
さしのべる	さしのべ
つきとおせる	つきとおせ
さばく	さばき
滞る	滞り
ふりはなつ	ふりはなち
振りまく	振りまき
特性づける	特性づけ
問い返す	問い返し
ねたむ	ねたみ
ねころべる	ねころべ
待設ける	待設け
拾い上げる	拾い上げ
舞込む	舞込み
飛び回る	飛び回り
感じとれる	感じとれ
走る	走り
かむ	かみ
たたき起こす	たたき起こし
突き刺せる	突き刺せ
寄り掛かる	寄り掛かり
ふやける	ふやけ
よがる	よがり
たたかえる	たたかえ
乗り進める	乗り進め
しわぶく	しわぶき
穢れる	穢れ
さすらう	さすらい
当り散らす	当り散らし
ぼくする	当り散らし
掻い出す	掻い出し
繰り延べる	繰り延べ
たいする	繰り延べ
いりくむ	いりくみ
対す	対し
一花咲かせる	一花咲かせ
振込む	振込み
ゆりおこす	ゆりおこし
送り返せる	送り返せ
よりわける	よりわけ
近づける	近づけ
くろずむ	くろずみ
踏み出す	踏み出し
座りこめる	座りこめ
きゅうする	座りこめ
若がえる	若がえり
ひっかえす	ひっかえし
言触らす	言触らし
推し量る	推し量り
知りぬく	知りぬき
擁す	擁し
見積もれる	見積もれ
ひきもどす	ひきもどし
填める	填め
つっ伏す	つっ伏し
ためす	ためし
広がる	広がり
油染みる	油染み
まどわす	まどわし
まとわりつく	まとわりつき
聞き付ける	聞き付け
さかのぼれる	さかのぼれ
手づまる	手づまり
立ち向かう	立ち向かい
ふりそそぐ	ふりそそぎ
いいよどむ	いいよどみ
へしゃげる	へしゃげ
かきぬく	かきぬき
愛せる	愛せ
焦れる	焦れ
浸す	浸し
嘲る	嘲り
かっきる	かっきり
謝れる	謝れ
取り留める	取り留め
きざみこむ	きざみこみ
縫い込める	縫い込め
因る	因り
おちゃらかす	おちゃらかし
付け出す	付け出し
ならべたてる	ならべたて
みてとれる	みてとれ
膨らす	膨らし
のりうつる	のりうつり
言いすてる	言いすて
はたく	はたき
あてつける	あてつけ
手懐ける	手懐け
きこなす	きこなし
流し込む	流し込み
くさむす	くさむし
買い上がる	買い上がり
重なり合う	重なり合い
ぬぐいとる	ぬぐいとり
娶せる	娶せ
しんずる	娶せ
うとんずる	娶せ
歯向かう	歯向かい
撓う	撓い
立ち会う	立ち会い
とりあえる	とりあえ
抜合せる	抜合せ
替われる	替われ
撃ち抜く	撃ち抜き
緩める	緩め
産まれる	産まれ
さっ引く	さっ引き
めんくらう	めんくらい
剃り落とす	剃り落とし
飛出る	飛出
うりとばせる	うりとばせ
色付く	色付き
むしばむ	むしばみ
へんずる	むしばみ
みおろす	みおろし
おもう	おもい
戻れる	戻れ
塗り立てる	塗り立て
続く	続き
脱がす	脱がし
差しあげる	差しあげ
志ざす	志ざし
組み合わせる	組み合わせ
跳ね上がる	跳ね上がり
取り巻く	取り巻き
捩じ向ける	捩じ向け
高ぶる	高ぶり
しらむ	しらみ
書き捨てる	書き捨て
列べる	列べ
きそえる	きそえ
問い合わす	問い合わし
つづく	つづき
攀じる	攀じ
ぬすみだせる	ぬすみだせ
つぶす	つぶし
追っかける	追っかけ
咳込む	咳込み
聞きかえす	聞きかえし
とかせる	とかせ
あらう	あらい
みつげる	みつげ
すりこめる	すりこめ
かたりあかす	かたりあかし
取りあう	取りあい
とりおこなう	とりおこない
押せる	押せ
絡み付く	絡み付き
取返す	取返し
すじばる	すじばり
ならべる	ならべ
飾りたてる	飾りたて
あゆみよれる	あゆみよれ
熱す	熱し
かねる	かね
たちまわる	たちまわり
アジる	アジり
さびれる	さびれ
ころがせる	ころがせ
さび付く	さび付き
かき暗す	かき暗し
さわぐ	さわぎ
たたきこめる	たたきこめ
とどろかせる	とどろかせ
引きずりこむ	引きずりこみ
差し挟む	差し挟み
知ろしめす	知ろしめし
てむかえる	てむかえ
じまう	じまい
投付ける	投付け
呑み込む	呑み込み
ぶる	ぶり
わりびける	わりびけ
ホレる	ホレ
ねこむ	ねこみ
さしおさえる	さしおさえ
なおる	なおり
跳ね返る	跳ね返り
もちくずす	もちくずし
連なる	連なり
見れる	見れ
干る	干
さしとおす	さしとおし
たむろする	さしとおし
みうしなう	みうしない
戴ける	戴け
言いこめる	言いこめ
みなす	みなし
おきる	おき
かたちづくる	かたちづくり
茹だる	茹だり
すわり込める	すわり込め
眠る	眠り
はき違える	はき違え
乗取る	乗取り
とだえる	とだえ
面す	面し
ささげる	ささげ
まかれる	まかれ
わたす	わたし
傾げる	傾げ
耐忍ぶ	耐忍び
おちあう	おちあい
ふりたてる	ふりたて
ふくする	ふりたて
超える	超え
立ち代わる	立ち代わり
見そこなう	見そこない
かもしだす	かもしだし
切りさいなむ	切りさいなみ
波打つ	波打ち
とりかかる	とりかかり
寂びる	寂び
戯れる	戯れ
引き替える	引き替え
うわる	うわり
着る	着
あたる	あたり
もちこむ	もちこみ
事寄せる	事寄せ
おどろかす	おどろかし
綾なす	綾なし
はいでる	はいで
かいきる	かいきり
附する	かいきり
でむく	でむき
掻き暮れる	掻き暮れ
ふくれる	ふくれ
せき込む	せき込み
つづる	つづり
シラケる	シラケ
待ち合せる	待ち合せ
さらけ出す	さらけ出し
かかえこむ	かかえこみ
上がり込む	上がり込み
水際立つ	水際立ち
ぬけでる	ぬけで
確かめる	確かめ
裁つ	裁ち
しみいる	しみいり
立ち止まる	立ち止まり
いいわたせる	いいわたせ
思い当る	思い当り
強請る	強請り
しもがれる	しもがれ
提げる	提げ
連れ出せる	連れ出せ
刷る	刷り
つっ放す	つっ放し
減す	減し
すぐれる	すぐれ
晴れる	晴れ
あおむける	あおむけ
もてあます	もてあまし
吹く	吹き
わたせる	わたせ
聞付ける	聞付け
聞き損なう	聞き損ない
はなじろむ	はなじろみ
恥じらう	恥じらい
くいちらす	くいちらし
見付かる	見付かり
擢んでる	擢んで
恐れる	恐れ
ちかう	ちかい
あけはなつ	あけはなち
もうしあわせる	もうしあわせ
下ろせる	下ろせ
言いつくす	言いつくし
祈ぐ	祈ぎ
据わる	据わり
あわだつ	あわだち
なじめる	なじめ
寒気立つ	寒気立ち
ぶちあてる	ぶちあて
買い切る	買い切り
干せる	干せ
兼ね合う	兼ね合い
ですぎる	ですぎ
凭せかける	凭せかけ
取殺す	取殺し
立どまる	立どまり
もぐりこむ	もぐりこみ
投げ棄てる	投げ棄て
挟み込める	挟み込め
思いだす	思いだし
めざめる	めざめ
にがみばしる	にがみばしり
よぶ	よび
むきだす	むきだし
のれる	のれ
住みつく	住みつき
いろめく	いろめき
くれる	くれ
請け出す	請け出し
逸れる	逸れ
かくす	かくし
ひきさげる	ひきさげ
ウケる	ウケ
えらべる	えらべ
引合せる	引合せ
笑いかける	笑いかけ
篩う	篩い
ほぐす	ほぐし
拗ける	拗け
下げ渋る	下げ渋り
織込む	織込み
転げ落ちる	転げ落ち
過ぎ去る	過ぎ去り
有り合わせる	有り合わせ
ぞんじる	ぞんじ
討てる	討て
いいよる	いいより
まつ	まち
売払う	売払い
からませる	からませ
買い受ける	買い受け
憐れむ	憐れみ
おくりこむ	おくりこみ
触れ回る	触れ回り
煉れる	煉れ
晴れわたる	晴れわたり
きえる	きえ
召出す	召出し
ひん曲がる	ひん曲がり
くもる	くもり
へだたる	へだたり
まぎらわす	まぎらわし
付添う	付添い
えぐれる	えぐれ
打ち合す	打ち合し
組みなおせる	組みなおせ
うたぐる	うたぐり
たばかる	たばかり
妬く	妬き
借り集める	借り集め
くいしばる	くいしばり
言い寄れる	言い寄れ
嬲る	嬲り
裏返る	裏返り
染み付く	染み付き
切り組む	切り組み
おいはらう	おいはらい
はいあがる	はいあがり
になう	にない
防げる	防げ
砕ける	砕け
ふりだす	ふりだし
うちはたせる	うちはたせ
取り出せる	取り出せ
こまる	こまり
連だつ	連だち
修する	連だち
組み替える	組み替え
すじる	すじり
呼入れる	呼入れ
つきもどせる	つきもどせ
書き立てる	書き立て
曰う	曰い
付足す	付足し
あわせる	あわせ
立すくむ	立すくみ
釣りあげる	釣りあげ
つけ回す	つけ回し
書き残す	書き残し
追い捲る	追い捲り
鋤き返す	鋤き返し
思い立つ	思い立ち
締め殺す	締め殺し
ほったらかす	ほったらかし
映じる	映じ
ふるふ	ふるひ
触れる	触れ
退く	退き
といただす	といただし
訣れる	訣れ
さしこむ	さしこみ
死に変る	死に変り
抗する	死に変り
転ばす	転ばし
申し出でる	申し出で
生やす	生やし
こころみる	こころみ
かいかえる	かいかえ
搦める	搦め
ついやせる	ついやせ
おちつける	おちつけ
忘れかける	忘れかけ
けずりとる	けずりとり
よっぱらえる	よっぱらえ
引ずる	引ずり
免ずる	引ずり
暈す	暈し
申し聞ける	申し聞け
詣でる	詣で
くゆらせる	くゆらせ
取外す	取外し
混ぜ返せる	混ぜ返せ
結べる	結べ
突っ込める	突っ込め
贈れる	贈れ
どうずる	贈れ
みたせる	みたせ
討つ	討ち
振り放つ	振り放ち
ざれる	ざれ
吹き鳴らす	吹き鳴らし
すぎさる	すぎさり
とりはこぶ	とりはこび
刈りとる	刈りとり
示しあわせる	示しあわせ
弾む	弾み
つれこめる	つれこめ
押し入れる	押し入れ
割り当てる	割り当て
ねじ曲げる	ねじ曲げ
さからう	さからい
乗り込む	乗り込み
みこめる	みこめ
乗移る	乗移り
屈まる	屈まり
肥れる	肥れ
よそう	よそい
むつかる	むつかり
見縊る	見縊り
置換える	置換え
躍りかかる	躍りかかり
捗る	捗り
弔する	捗り
とびのく	とびのき
たちよる	たちより
呼べる	呼べ
つれだせる	つれだせ
流る	流
ぬかづく	ぬかづき
つきさす	つきさし
ひがむ	ひがみ
冷えこむ	冷えこみ
通り掛かる	通り掛かり
とっくむ	とっくみ
おしとおす	おしとおし
抱き取る	抱き取り
みかえす	みかえし
亡びる	亡び
空く	空き
軋めく	軋めき
呼ばわる	呼ばわり
つぐむ	つぐみ
突き合わせる	突き合わせ
あわす	あわし
講ずる	あわし
知り合える	知り合え
つきる	つき
振立てる	振立て
織り上げる	織り上げ
聞し召す	聞し召し
なれる	なれ
せばめる	せばめ
苛立てる	苛立て
こりる	こり
縒れる	縒れ
ぬいつける	ぬいつけ
へあがる	へあがり
引き篭る	引き篭り
くびれる	くびれ
揺り動かせる	揺り動かせ
畏まる	畏まり
誘い合う	誘い合い
言い立てる	言い立て
こごる	こごり
角目立つ	角目立ち
あゆみよる	あゆみより
吹ける	吹け
役立つ	役立ち
もうしあげる	もうしあげ
訪れる	訪れ
入れ替われる	入れ替われ
塾す	塾し
ひきつる	ひきつり
そそぎこむ	そそぎこみ
憩う	憩い
迷う	迷い
よばわる	よばわり
はべれる	はべれ
滴らす	滴らし
乗遅れる	乗遅れ
割り込める	割り込め
入かわる	入かわり
せびる	せびり
取紛れる	取紛れ
見破れる	見破れ
とびのれる	とびのれ
立ち並ぶ	立ち並び
醒す	醒し
つづける	つづけ
閉じ篭る	閉じ篭り
めげる	めげ
吹き込める	吹き込め
向けなおす	向けなおし
踏みはずす	踏みはずし
しめしあわせる	しめしあわせ
ねむれる	ねむれ
ぬける	ぬけ
打ち連れる	打ち連れ
かくれる	かくれ
組織立つ	組織立ち
見せつける	見せつけ
取りざたす	取りざたし
ひむ	ひみ
読み込める	読み込め
すきとおる	すきとおり
おめにかかる	おめにかかり
介する	おめにかかり
競り勝つ	競り勝ち
震う	震い
聞き齧る	聞き齧り
苦り切る	苦り切り
はる	はり
住まわす	住まわし
申越す	申越し
きらめかす	きらめかし
昇れる	昇れ
つまみ出せる	つまみ出せ
抛る	抛り
塞ぎ込む	塞ぎ込み
あなどる	あなどり
組みあげる	組みあげ
度重なる	度重なり
とりしらべる	とりしらべ
弁じる	弁じ
くるまる	くるまり
きまる	きまり
しょげる	しょげ
差し引く	差し引き
立ちこむ	立ちこみ
もぎとる	もぎとり
落魄れる	落魄れ
助け出す	助け出し
しゅうする	助け出し
はせあつまる	はせあつまり
おいそだつ	おいそだち
しらせる	しらせ
見つけ出せる	見つけ出せ
折りかえす	折りかえし
聞き返せる	聞き返せ
反する	聞き返せ
殺める	殺め
うちつける	うちつけ
齧る	齧り
物思う	物思い
あわてる	あわて
逆立つ	逆立ち
断ち割る	断ち割り
かめる	かめ
ようだいぶる	ようだいぶり
威す	威し
ふるえる	ふるえ
絞れる	絞れ
汲む	汲み
引っ掛かる	引っ掛かり
断つ	断ち
起こす	起こし
ぎょうずる	起こし
もうしつたえる	もうしつたえ
見受ける	見受け
はんずる	見受け
紛らせる	紛らせ
ひっ担ぐ	ひっ担ぎ
数え上げる	数え上げ
印せる	印せ
勝ち抜く	勝ち抜き
いさむ	いさみ
篭る	篭り
ふきまくる	ふきまくり
思いまどえる	思いまどえ
脱せる	脱せ
かみころす	かみころし
讃える	讃え
言い争う	言い争い
ならえる	ならえ
有する	ならえ
ひとはなさかせる	ひとはなさかせ
測る	測り
拐う	拐い
破れる	破れ
呼付ける	呼付け
すっとぶ	すっとび
絡ませる	絡ませ
折込む	折込み
もうかる	もうかり
駆催す	駆催し
やりかえす	やりかえし
当て付ける	当て付け
余る	余り
ふみきれる	ふみきれ
見なす	見なし
擦れ違う	擦れ違い
流れ込む	流れ込み
かりこす	かりこし
蹴る	蹴り
うず巻く	うず巻き
よびもどせる	よびもどせ
ぶっつづける	ぶっつづけ
ふくむ	ふくみ
まぎれ込む	まぎれ込み
生き抜ける	生き抜け
受合う	受合い
繰延べる	繰延べ
さ迷う	さ迷い
つけ上がる	つけ上がり
引しまる	引しまり
さしあう	さしあい
受取る	受取り
引き具する	受取り
せっぱつまる	せっぱつまり
かいたたく	かいたたき
揉み合う	揉み合い
魂消る	魂消
取り運ぶ	取り運び
すくい上げる	すくい上げ
せせらわらう	せせらわらい
枉げる	枉げ
言いふくめる	言いふくめ
落ちぶれる	落ちぶれ
しはらえる	しはらえ
なであげる	なであげ
突き放せる	突き放せ
添える	添え
せせら笑える	せせら笑え
とってかえす	とってかえし
とむらえる	とむらえ
さとる	さとり
篭もる	篭もり
按じる	按じ
見晴らせる	見晴らせ
とどけでる	とどけで
くすぐる	くすぐり
ほうずる	くすぐり
興ずる	くすぐり
浮びあがる	浮びあがり
織りこむ	織りこみ
出せる	出せ
いきわたる	いきわたり
うごめかす	うごめかし
思いおこす	思いおこし
はらす	はらし
もぐり込める	もぐり込め
ごったがえす	ごったがえし
思いとどまれる	思いとどまれ
荒立つ	荒立ち
湯掻く	湯掻き
殺ぐ	殺ぎ
煮つめる	煮つめ
ひしめく	ひしめき
吹き付ける	吹き付け
懐ける	懐け
なぶる	なぶり
思い詰める	思い詰め
償う	償い
加える	加え
ききはずす	ききはずし
道化ける	道化け
転べる	転べ
かっこむ	かっこみ
躓く	躓き
立ち寄れる	立ち寄れ
結う	結い
なく	なき
言いそこなう	言いそこない
よじ登れる	よじ登れ
滅する	よじ登れ
空ける	空け
脅し付ける	脅し付け
映える	映え
選べる	選べ
死なす	死なし
告げる	告げ
あやまつ	あやまち
きょうざめる	きょうざめ
誘い込む	誘い込み
もちあるける	もちあるけ
痛める	痛め
推移る	推移り
売り出す	売り出し
きくする	売り出し
ひきあてる	ひきあて
打解ける	打解け
言い直せる	言い直せ
退かす	退かし
気遣う	気遣い
づける	づけ
取っちめる	取っちめ
デモる	デモり
跳び越す	跳び越し
甦る	甦り
かわる	かわり
差固める	差固め
矧ぐ	矧ぎ
まじめくさる	まじめくさり
踏み倒す	踏み倒し
ひきはなす	ひきはなし
さかす	さかし
逆だつ	逆だち
はばめる	はばめ
切詰める	切詰め
たぐえる	たぐえ
射貫く	射貫き
けちる	けちり
嘲笑う	嘲笑い
ひさぐ	ひさぎ
あそびあるく	あそびあるき
もうしこめる	もうしこめ
払戻す	払戻し
逃げ出す	逃げ出し
ふてる	ふて
ひねれる	ひねれ
勢い付く	勢い付き
ぬれそぼつ	ぬれそぼち
指せる	指せ
あじわえる	あじわえ
流す	流し
つぼむ	つぼみ
わたくしする	つぼみ
いただく	いただき
打ち直す	打ち直し
やぶる	やぶり
かきあつめる	かきあつめ
おびる	おび
取り落とす	取り落とし
もうしおくる	もうしおくり
畳む	畳み
よす	よし
やむを得る	やむを得
なまる	なまり
語り明かす	語り明かし
飛び渡る	飛び渡り
問い詰める	問い詰め
取っつく	取っつき
揺がす	揺がし
さきんじる	さきんじ
取越す	取越し
似かよう	似かよい
見捨てる	見捨て
封ずる	見捨て
せき止める	せき止め
眠らす	眠らし
取りつかれる	取りつかれ
蕩かす	蕩かし
上がれる	上がれ
読みあさる	読みあさり
こわがる	こわがり
刷り込める	刷り込め
怒鳴りつける	怒鳴りつけ
申込む	申込み
さえる	さえ
くろみがかる	くろみがかり
垢抜ける	垢抜け
派する	垢抜け
ちちくる	ちちくり
生らす	生らし
ものおもう	ものおもい
読上げる	読上げ
潜まる	潜まり
抛り出す	抛り出し
ずれ込む	ずれ込み
驚かす	驚かし
羽織る	羽織り
にあがる	にあがり
角立てる	角立て
窶す	窶し
呈する	窶し
きる	きり
差し固める	差し固め
知れる	知れ
乗りこなす	乗りこなし
聞き流せる	聞き流せ
みつくろう	みつくろい
とりかこめる	とりかこめ
ほねばる	ほねばり
入替る	入替り
いただける	いただけ
たわける	たわけ
よみだす	よみだし
かんがえなおす	かんがえなおし
取り仕切れる	取り仕切れ
送り届ける	送り届け
引っくり返す	引っくり返し
見廻す	見廻し
聞き外す	聞き外し
飲み込む	飲み込み
しらべる	しらべ
みならう	みならい
であう	であい
奪い返す	奪い返し
はう	はい
取り拉ぐ	取り拉ぎ
見届ける	見届け
ころがす	ころがし
しめだす	しめだし
たたみかける	たたみかけ
さげる	さげ
売りこむ	売りこみ
流し入れる	流し入れ
包み隠す	包み隠し
救い出せる	救い出せ
あく	あき
湛える	湛え
招き入れる	招き入れ
より分ける	より分け
化す	化し
釣りあがる	釣りあがり
抗える	抗え
切り付ける	切り付け
のりこえる	のりこえ
いれかえる	いれかえ
よびこめる	よびこめ
間引く	間引き
こきつかえる	こきつかえ
利する	こきつかえ
活ける	活け
下卑る	下卑
進み出せる	進み出せ
組み込む	組み込み
突き付ける	突き付け
ねりあるく	ねりあるき
応ずる	ねりあるき
まぜかえす	まぜかえし
書立てる	書立て
はしりこめる	はしりこめ
乗り入れる	乗り入れ
引き継ぐ	引き継ぎ
あいいとなむ	あいいとなみ
おれ合う	おれ合い
吹き飛ばす	吹き飛ばし
憬れる	憬れ
見下げる	見下げ
採る	採り
和ぐ	和ぎ
さびる	さび
やつれる	やつれ
穿く	穿き
おちる	おち
耀く	耀き
寄あつまる	寄あつまり
至る	至り
かよえる	かよえ
あかみがかる	あかみがかり
たがねる	たがね
書き成す	書き成し
突戻す	突戻し
つくれる	つくれ
擦り寄る	擦り寄り
競上げる	競上げ
起き直る	起き直り
すごもる	すごもり
うちよせる	うちよせ
留る	留り
つきぬく	つきぬき
いそしむ	いそしみ
入乱れる	入乱れ
扇ぐ	扇ぎ
清ます	清まし
放つ	放ち
ごった返す	ごった返し
削ぐ	削ぎ
磨る	磨り
押えつける	押えつけ
考え抜く	考え抜き
戴く	戴き
いたぶる	いたぶり
わする	いたぶり
つきそえる	つきそえ
切りとれる	切りとれ
睡る	睡り
働ける	働け
すえつける	すえつけ
取りとめる	取りとめ
ふす	ふし
閉じこめる	閉じこめ
おっかぶせる	おっかぶせ
見せびらかす	見せびらかし
うかばれる	うかばれ
よびかける	よびかけ
もちだせる	もちだせ
抱き合える	抱き合え
勝ち進める	勝ち進め
うきあがれる	うきあがれ
うむ	うみ
番える	番え
とつぐ	とつぎ
誘いかける	誘いかけ
言い争える	言い争え
まかなえる	まかなえ
突っ立てる	突っ立て
しゃれる	しゃれ
取澄ます	取澄まし
うかれ出る	うかれ出
粘つく	粘つき
思い余る	思い余り
押付ける	押付け
削る	削り
直す	直し
うちあう	うちあい
つっぷす	つっぷし
繰り下げる	繰り下げ
つきすすむ	つきすすみ
踏みつぶす	踏みつぶし
見送れる	見送れ
裁ち切る	裁ち切り
生き残れる	生き残れ
憧れる	憧れ
すり減る	すり減り
割り引く	割り引き
ぬたくる	ぬたくり
よじれる	よじれ
すげかえる	すげかえ
強ばる	強ばり
やりすごす	やりすごし
起てる	起て
痩せさらばえる	痩せさらばえ
押し返す	押し返し
言いあう	言いあい
あったまる	あったまり
のりつける	のりつけ
持運ぶ	持運び
広げる	広げ
崩れ落ちる	崩れ落ち
ほうける	ほうけ
ひなびる	ひなび
固まれる	固まれ
還す	還し
とりなおせる	とりなおせ
飲みまわす	飲みまわし
しかる	しかり
うごく	うごき
下す	下し
肥やす	肥やし
さしかえる	さしかえ
まちうける	まちうけ
おいこむ	おいこみ
青ざめる	青ざめ
踏み外す	踏み外し
まかりこす	まかりこし
取り片付ける	取り片付け
たちかわる	たちかわり
書き取る	書き取り
かきあらわす	かきあらわし
引き締める	引き締め
入り雑じる	入り雑じり
くみあう	くみあい
浮き立つ	浮き立ち
こもる	こもり
おりなす	おりなし
しにかける	しにかけ
さんずる	しにかけ
相営む	相営み
招ずる	相営み
つりこむ	つりこみ
いきのこる	いきのこり
いかる	いかり
ふくらせる	ふくらせ
かみ殺す	かみ殺し
任す	任し
制す	制し
取りかえる	取りかえ
差し込む	差し込み
にげこむ	にげこみ
行える	行え
さ迷う	さ迷い
おいぬける	おいぬけ
しなびる	しなび
掲げる	掲げ
充ちる	充ち
みつかる	みつかり
もつれ合う	もつれ合い
携わる	携わり
狩出す	狩出し
ひっくりかえす	ひっくりかえし
注ぐ	注ぎ
くり貫く	くり貫き
おがむ	おがみ
吊る	吊り
方向づける	方向づけ
回せる	回せ
撃ち落とす	撃ち落とし
降り注ぐ	降り注ぎ
駆り出す	駆り出し
掴みかかる	掴みかかり
願う	願い
煮上がる	煮上がり
立込める	立込め
つっ込む	つっ込み
誉めちぎる	誉めちぎり
うつせる	うつせ
狙える	狙え
したまわる	したまわり
うちおとす	うちおとし
生まれでる	生まれで
くじけかかる	くじけかかり
かいしめる	かいしめ
とりまける	とりまけ
懸け隔たる	懸け隔たり
よみこむ	よみこみ
引出す	引出し
むすびつく	むすびつき
観る	観
演じる	演じ
揃える	揃え
消えはてる	消えはて
すきおこす	すきおこし
揺り起こす	揺り起こし
後らせる	後らせ
謙る	謙り
とりおこなえる	とりおこなえ
取り逃がす	取り逃がし
おりゃる	おりゃり
住み着く	住み着き
縮くれる	縮くれ
そりくりかえる	そりくりかえり
転ぶ	転び
きりぬける	きりぬけ
のみあかす	のみあかし
かぎつける	かぎつけ
しゃうぞく	しゃうぞき
逸らす	逸らし
まきかえせる	まきかえせ
巻ける	巻け
繰り替える	繰り替え
踏みこたえる	踏みこたえ
うる	うり
ふせぐ	ふせぎ
叫ぶ	叫び
立ち去れる	立ち去れ
白む	白み
持ち出す	持ち出し
剥ぐ	剥ぎ
励む	励み
研げる	研げ
剥がれる	剥がれ
のりつげる	のりつげ
つきまとう	つきまとい
被さる	被さり
かけもつ	かけもち
やどれる	やどれ
しらす	しらし
吹っ切れる	吹っ切れ
とりしまれる	とりしまれ
合さる	合さり
まつわりつく	まつわりつき
つかみ合う	つかみ合い
圧す	圧し
振り捨てる	振り捨て
はぎとる	はぎとり
傷む	傷み
微睡む	微睡み
はりだす	はりだし
撃ち込める	撃ち込め
打払える	打払え
組込める	組込め
突き進む	突き進み
連合う	連合い
またぐ	またぎ
燐む	燐み
緩む	緩み
付合う	付合い
踏倒す	踏倒し
見越す	見越し
寄り倒す	寄り倒し
はしょる	はしょり
いれかわる	いれかわり
がたつく	がたつき
みそめる	みそめ
おわらせる	おわらせ
つかいこなせる	つかいこなせ
数えあげる	数えあげ
もとまる	もとまり
垂らす	垂らし
笑える	笑え
おれる	おれ
葬れる	葬れ
躄る	躄り
無くなす	無くなし
吹き降ろす	吹き降ろし
折り合える	折り合え
無くす	無くし
もちあげる	もちあげ
沈む	沈み
ぬけかわる	ぬけかわり
たしなめる	たしなめ
張り出す	張り出し
立添う	立添い
除ける	除け
掬う	掬い
揺らせる	揺らせ
立ち代われる	立ち代われ
あきれ返る	あきれ返り
とまどう	とまどい
聞きはずす	聞きはずし
天翔る	天翔り
生み落す	生み落し
からす	からし
取り澄ます	取り澄まし
つきささる	つきささり
案ずる	つきささり
言い伝える	言い伝え
誘き出す	誘き出し
熾る	熾り
腫れ上がる	腫れ上がり
よみさす	よみさし
いだく	いだき
すます	すまし
なげきあかす	なげきあかし
くさす	くさし
ふやかす	ふやかし
暴れだす	暴れだし
負かす	負かし
あいする	負かし
ねむりこむ	ねむりこみ
引き返せる	引き返せ
とおりかかる	とおりかかり
伏せる	伏せり
学びとる	学びとり
爆ぜる	爆ぜ
うまれつく	うまれつき
出会える	出会え
聞きすます	聞きすまし
流れ出る	流れ出
淫する	流れ出
食らう	食らい
引く	引き
吊り出す	吊り出し
まわる	まわり
苦みばしる	苦みばしり
込み上げる	込み上げ
じれ込む	じれ込み
懸ける	懸け
書き起す	書き起し
さえかえる	さえかえり
見識張る	見識張り
ねかしつける	ねかしつけ
あがれる	あがれ
まぎれこむ	まぎれこみ
すくめる	すくめ
おきなおれる	おきなおれ
摩れる	摩れ
見抜く	見抜き
入雑じる	入雑じり
よわる	よわり
ひる	ひり
出しゃばる	出しゃばり
おぼれる	おぼれ
おりたためる	おりたため
究める	究め
陣どる	陣どり
投げ込める	投げ込め
受けとる	受けとり
喪う	喪い
振り絞る	振り絞り
さきがける	さきがけ
締め括る	締め括り
そらせる	そらせ
味付ける	味付け
咲こぼれる	咲こぼれ
遅らす	遅らし
ときあかす	ときあかし
とっくめる	とっくめ
黙する	とっくめ
もむ	もみ
ほじくる	ほじくり
ひもとける	ひもとけ
打ちあぐむ	打ちあぐみ
想える	想え
脱ぐ	脱ぎ
諮れる	諮れ
けずれる	けずれ
謀れる	謀れ
おす	おし
上れる	上れ
目ざめる	目ざめ
はしりまわれる	はしりまわれ
やすめる	やすめ
攻めのぼる	攻めのぼり
荒む	荒み
はなしかける	はなしかけ
はたす	はたし
まする	はたし
憶える	憶え
割切れる	割切れ
こなせる	こなせ
太る	太り
まみれる	まみれ
積込む	積込み
居座る	居座り
ききいる	ききいり
躍りでる	躍りで
過つ	過ち
とる	とり
みかえせる	みかえせ
のけ反る	のけ反り
揺さぶれる	揺さぶれ
おしのける	おしのけ
値切れる	値切れ
縊れる	縊れ
はいれる	はいれ
思いきる	思いきり
聰る	聰り
ほころぶ	ほころび
口篭る	口篭り
遇う	遇い
酬いる	酬い
冬篭る	冬篭り
ふみきる	ふみきり
かき消せる	かき消せ
なげとばす	なげとばし
死に遅れる	死に遅れ
近付く	近付き
なきしずむ	なきしずみ
仕留める	仕留め
醂す	醂し
たおせる	たおせ
はえる	はえ
いりかわる	いりかわり
見回る	見回り
差戻す	差戻し
腹だつ	腹だち
厭き厭きする	腹だち
縛りあげる	縛りあげ
買取る	買取り
またたく	またたき
立ち竦む	立ち竦み
足る	足り
温もる	温もり
惹ける	惹け
立掛ける	立掛け
譲り渡す	譲り渡し
ひろまる	ひろまり
焦る	焦り
ひっさげる	ひっさげ
死かわる	死かわり
まざる	まざり
透ける	透け
追込む	追込み
ほりこむ	ほりこみ
ばかす	ばかし
さがる	さがり
まもりそだてる	まもりそだて
移り変る	移り変り
混ぜ合わす	混ぜ合わし
はね上げる	はね上げ
かがる	かがり
潤びる	潤び
押し負ける	押し負け
突ぱる	突ぱり
よびこむ	よびこみ
かろんずる	よびこみ
搾れる	搾れ
こげつく	こげつき
おもんずる	こげつき
ささめく	ささめき
突き通る	突き通り
請けおう	請けおい
打しおれる	打しおれ
解する	打しおれ
植える	植え
なみだつ	なみだち
取り広げる	取り広げ
はからえる	はからえ
腫れる	腫れ
飛交う	飛交い
高める	高め
つまずく	つまずき
がぶる	がぶり
捲し立てる	捲し立て
のこれる	のこれ
駆け付ける	駆け付け
引き寄せる	引き寄せ
写る	写り
解合う	解合い
たちおくれる	たちおくれ
くずおれる	くずおれ
立会う	立会い
思ふ	思ひ
つる	つり
当込む	当込み
なぐりつける	なぐりつけ
とりつぐ	とりつぎ
きらう	きらい
耕せる	耕せ
散じる	散じ
けしとぶ	けしとび
こびる	こび
取り囲む	取り囲み
一皮剥く	一皮剥き
馳せ参ずる	一皮剥き
むらがる	むらがり
刳る	刳り
かきとめる	かきとめ
出っ張る	出っ張り
ひきつれる	ひきつれ
しんぜる	しんぜ
もえる	もえ
やつす	やつし
知り合う	知り合い
鍛え上げる	鍛え上げ
持て余す	持て余し
差し違える	差し違え
おりまぜる	おりまぜ
のべる	のべ
わきまえる	わきまえ
封じる	封じ
覚める	覚め
殉ずる	覚め
思い付く	思い付き
努まる	努まり
陳ぶ	陳び
がかる	がかり
たかれる	たかれ
やりこなす	やりこなし
ふざける	ふざけ
売り悩む	売り悩み
向かい合わせる	向かい合わせ
佇つ	佇ち
よりそう	よりそい
曇らす	曇らし
弔う	弔い
生かせる	生かせ
撚る	撚り
なきつく	なきつき
わる	わり
入れる	入れ
行き着く	行き着き
盛り上がる	盛り上がり
締まる	締まり
はしりでる	はしりで
なえる	なえ
亡ぶ	亡び
燻る	燻り
すすりなく	すすりなき
ひきのばす	ひきのばし
にごす	にごし
くりこす	くりこし
狭まる	狭まり
取り捌く	取り捌き
娶る	娶り
急かす	急かし
ながらえる	ながらえ
転がりこむ	転がりこみ
おもひよる	おもひより
振切る	振切り
羽ばたく	羽ばたき
請負う	請負い
落行く	落行き
そろう	そろい
揺れる	揺れ
だまりこむ	だまりこみ
とりすます	とりすまし
おしだまる	おしだまり
なみうつ	なみうち
ずる	ずり
詰まる	詰まり
合わす	合わし
ききこむ	ききこみ
折る	折り
正せる	正せ
すり替える	すり替え
連出す	連出し
つけくわわる	つけくわわり
かきなおせる	かきなおせ
小突き回す	小突き回し
荒らす	荒らし
とりこわす	とりこわし
きわめる	きわめ
待つ	待ち
巧む	巧み
さんする	巧み
くみ取れる	くみ取れ
おもいだせる	おもいだせ
ふきならす	ふきならし
ごする	ふきならし
心行く	心行き
食み出す	食み出し
支う	支い
溜め込む	溜め込み
ことわれる	ことわれ
とびはねる	とびはね
繰り込める	繰り込め
ふきはらえる	ふきはらえ
殉じる	殉じ
注ぎ込む	注ぎ込み
沿う	沿い
泊まり込む	泊まり込み
炊きあがる	炊きあがり
すすける	すすけ
飛離れる	飛離れ
ひねり回す	ひねり回し
取分ける	取分け
流せる	流せ
光らす	光らし
すがれる	すがれ
折返す	折返し
へこむ	へこみ
漱ぐ	漱ぎ
借りる	借り
問い合わせる	問い合わせ
みせる	みせ
呼出す	呼出し
数える	数え
着飾る	着飾り
出来上がる	出来上がり
いたる	いたり
召す	召し
先んずる	召し
こらしめる	こらしめ
腐れる	腐れ
受けいれる	受けいれ
切り抜ける	切り抜け
巡らせる	巡らせ
ずらす	ずらし
爪立つ	爪立ち
売急ぐ	売急ぎ
翻す	翻し
くちばしる	くちばしり
捻くれる	捻くれ
錆付く	錆付き
しょうじる	しょうじ
まいる	まいり
歪める	歪め
突き合す	突き合し
羽ばたける	羽ばたけ
ひす	ひし
引下げる	引下げ
かんさびる	かんさび
削り倒す	削り倒し
備え付ける	備え付け
操る	操り
よれる	よれ
ねばりぬく	ねばりぬき
いいだせる	いいだせ
さげわたす	さげわたし
叩き起す	叩き起し
きりかわる	きりかわり
諭せる	諭せ
きける	きけ
打砕く	打砕き
売り込む	売り込み
ひやかせる	ひやかせ
捩じ伏せる	捩じ伏せ
おしながす	おしながし
使う	使い
みすてる	みすて
嚼む	嚼み
フケる	フケ
積出す	積出し
めっする	積出し
言い放つ	言い放ち
殺気立つ	殺気立ち
せきたてる	せきたて
みとおせる	みとおせ
渡れる	渡れ
見かねる	見かね
出回る	出回り
啜る	啜り
心ゆく	心ゆき
引連れる	引連れ
よりそえる	よりそえ
じゅくする	よりそえ
酔い潰れる	酔い潰れ
剃る	剃り
ではじめる	ではじめ
せめたてる	せめたて
ゆき交う	ゆき交い
かちすすむ	かちすすみ
くいこむ	くいこみ
じめつく	じめつき
ふんまえる	ふんまえ
しそんじる	しそんじ
撃ち殺す	撃ち殺し
綰ねる	綰ね
医する	綰ね
噛み付く	噛み付き
間切る	間切り
しまふ	しまひ
送り込める	送り込め
だんじこむ	だんじこみ
みちびきだす	みちびきだし
造れる	造れ
打ちとける	打ちとけ
行く	行き
のたうつ	のたうち
つま弾く	つま弾き
存じ上げる	存じ上げ
汲み出す	汲み出し
抱締める	抱締め
罪する	抱締め
勝ち取る	勝ち取り
撮す	撮し
濡れそぼつ	濡れそぼち
くるしめる	くるしめ
泣かす	泣かし
売り切れる	売り切れ
食い倒す	食い倒し
踏みだす	踏みだし
きれあがる	きれあがり
咬む	咬み
飾る	飾り
へばりつく	へばりつき
すねる	すね
座する	すね
あおみがかる	あおみがかり
引き落とす	引き落とし
はなしこむ	はなしこみ
ふりかける	ふりかけ
申出る	申出
漏れる	漏れ
つきあたる	つきあたり
ふりかえる	ふりかえり
とっつく	とっつき
むすびつける	むすびつけ
かたどれる	かたどれ
萎む	萎み
耀かす	耀かし
刺殺す	刺殺し
よう	よい
たたき出せる	たたき出せ
接する	たたき出せ
放す	放し
掴み掛る	掴み掛り
遊びあきる	遊びあき
すべり込む	すべり込み
追いまわす	追いまわし
挑む	挑み
押し入る	押し入り
のぼせる	のぼせ
ざわめく	ざわめき
いりつける	いりつけ
質せる	質せ
たえしのぶ	たえしのび
給する	たえしのび
擦付ける	擦付け
ひきつくろう	ひきつくろい
そやす	そやし
引き延ばす	引き延ばし
付き添う	付き添い
刺し違える	刺し違え
売り上げる	売り上げ
よだつ	よだち
聞きだす	聞きだし
利く	利き
染み入る	染み入り
うなずける	うなずけ
ぞんずる	うなずけ
よびおこす	よびおこし
はなせる	はなせ
冷える	冷え
読みくだす	読みくだし
盛り返す	盛り返し
わきたつ	わきたち
溺らす	溺らし
やきあげる	やきあげ
振り落とせる	振り落とせ
まきつく	まきつき
ひっ返す	ひっ返し
引っぱる	引っぱり
まちかまえる	まちかまえ
よこす	よこし
使われだす	使われだし
じゃれる	じゃれ
賞する	じゃれ
借り越す	借り越し
買いつける	買いつけ
はおる	はおり
はしる	はしり
焦げ付く	焦げ付き
借受ける	借受け
さしでる	さしで
さかまく	さかまき
きんじる	きんじ
はらせる	はらせ
生める	生め
つるし上げる	つるし上げ
口説ける	口説け
まねく	まねき
あやす	あやし
染る	染り
かじりつく	かじりつき
煮える	煮え
持直す	持直し
かきちらす	かきちらし
慕う	慕い
載る	載り
頼みこむ	頼みこみ
引っ篭る	引っ篭り
更ける	更け
咳き込む	咳き込み
押しかける	押しかけ
引っ剥がす	引っ剥がし
はずれる	はずれ
切り合う	切り合い
あやぶむ	あやぶみ
捉える	捉え
むすべる	むすべ
取り替える	取り替え
寝返る	寝返り
そっする	寝返り
乗込む	乗込み
こころえる	こころえ
潰せる	潰せ
持越す	持越し
混ぜっ返す	混ぜっ返し
こいねがう	こいねがい
ちゃかす	ちゃかし
焚きしめる	焚きしめ
打ち落とす	打ち落とし
け飛ばす	け飛ばし
まぜ返す	まぜ返し
よう	よい
ふりあう	ふりあい
わらわす	わらわし
寄りつく	寄りつき
はじきだせる	はじきだせ
ひらめかす	ひらめかし
嗣げる	嗣げ
かきまぜる	かきまぜ
怖じける	怖じけ
うりだせる	うりだせ
擦り込む	擦り込み
ゆきたつ	ゆきたち
しかける	しかけ
うつしだせる	うつしだせ
押しきる	押しきり
勿体ぶる	勿体ぶり
ふる	ふり
尽くす	尽くし
みてとる	みてとり
まるめ込む	まるめ込み
束ねる	束ね
ねがいさげる	ねがいさげ
もじる	もじり
粒立つ	粒立ち
まよわす	まよわし
たがう	たがい
集える	集え
寄り掛る	寄り掛り
じとつく	じとつき
払える	払え
つきあわせる	つきあわせ
嫌う	嫌い
奉る	奉り
受けとめる	受けとめ
息詰まる	息詰まり
紛う	紛い
ゆきかえる	ゆきかえり
うつしだす	うつしだし
したてる	したて
押しつめる	押しつめ
悲しむ	悲しみ
あずかる	あずかり
年寄る	年寄り
かぶせる	かぶせ
むける	むけ
泣き伏す	泣き伏し
ちゃらつかす	ちゃらつかし
さぐり合う	さぐり合い
絶する	さぐり合い
縮かむ	縮かみ
よばれる	よばれ
おどりでる	おどりで
うちとる	うちとり
泣沈む	泣沈み
おちつく	おちつき
すいだす	すいだし
貴べる	貴べ
心づく	心づき
握り締める	握り締め
負える	負え
はりめぐらせる	はりめぐらせ
刺す	刺し
作りあげる	作りあげ
訊く	訊き
ふさぐ	ふさぎ
脅し取る	脅し取り
召し上がれる	召し上がれ
かたちづくれる	かたちづくれ
ためこめる	ためこめ
わすれる	わすれ
つくり上げる	つくり上げ
競い合う	競い合い
こる	こり
ききあわせる	ききあわせ
のぞき込める	のぞき込め
追っぱらう	追っぱらい
受け合える	受け合え
ぎゅうじる	ぎゅうじり
ふみはずす	ふみはずし
はたせる	はたせ
賺す	賺し
かきむしる	かきむしり
踏出す	踏出し
つかれはてる	つかれはて
やり過す	やり過し
仕上がる	仕上がり
取回す	取回し
ズレる	ズレ
面する	ズレ
言尽す	言尽し
割当てる	割当て
怒れる	怒れ
ときおこす	ときおこし
引立てる	引立て
競合う	競合い
素見す	素見し
切り返す	切り返し
砕く	砕き
しめきる	しめきり
息づく	息づき
囲える	囲え
引っ張る	引っ張り
打ち壊す	打ち壊し
いう	いい
押し返せる	押し返せ
入り浸る	入り浸り
いら立つ	いら立ち
襲いかかる	襲いかかり
熾きる	熾き
くり出す	くり出し
きかざれる	きかざれ
かられる	かられ
呼ぶ	呼び
書出す	書出し
くぐり抜ける	くぐり抜け
ざんする	くぐり抜け
そりおとす	そりおとし
しめつける	しめつけ
たんずる	しめつけ
好む	好み
競べる	競べ
切り捨てる	切り捨て
ほりあげる	ほりあげ
のたうちまわる	のたうちまわり
捕らわれる	捕らわれ
凍みる	凍み
こころゆく	こころゆき
つっきる	つっきり
どやす	どやし
笑い転げる	笑い転げ
掛る	掛り
住む	住み
約まる	約まり
あいしあう	あいしあい
頑張れる	頑張れ
させる	させ
おかす	おかし
あます	あまし
泣き付く	泣き付き
あわれむ	あわれみ
積み重ねる	積み重ね
うちあわす	うちあわし
訳せる	訳せ
詫びる	詫び
創り出せる	創り出せ
担げる	担げ
追い上げる	追い上げ
根づく	根づき
立ち会える	立ち会え
祭り上げる	祭り上げ
こもどす	こもどし
乗かかる	乗かかり
創る	創り
練直す	練直し
かがやく	かがやき
うちあわせる	うちあわせ
遜る	遜り
かする	遜り
戦く	戦き
腹立てる	腹立て
擦り込める	擦り込め
勝ち得る	勝ち得
みごもる	みごもり
討ち果たせる	討ち果たせ
野次る	野次り
よみがえる	よみがえり
踏み抜く	踏み抜き
生かす	生かし
おいつめる	おいつめ
採れる	採れ
つきやぶる	つきやぶり
めぐりあう	めぐりあい
尽くせる	尽くせ
進む	進み
赴く	赴き
くりいれる	くりいれ
しゃっちょこ張る	しゃっちょこ張り
めしぐす	めしぐし
煮つまる	煮つまり
渦巻く	渦巻き
動く	動き
くり抜く	くり抜き
試みる	試み
汚す	汚し
食い入る	食い入り
反らせる	反らせ
晴らせる	晴らせ
取っ組める	取っ組め
選ぶ	選び
彫る	彫り
振りしぼる	振りしぼり
吸寄せる	吸寄せ
かぎだす	かぎだし
紛らす	紛らし
詰めこむ	詰めこみ
どうきづける	どうきづけ
見過す	見過し
つけ入る	つけ入り
ぬきあわせる	ぬきあわせ
巻き込む	巻き込み
結上げる	結上げ
才弾ける	才弾け
ときほぐす	ときほぐし
結ぼれる	結ぼれ
まいれる	まいれ
うりとばす	うりとばし
すりむく	すりむき
剥げる	剥げ
たくする	剥げ
したがう	したがい
見せる	見せ
そまる	そまり
煮付ける	煮付け
ぶっつける	ぶっつけ
しずむ	しずみ
切り結ぶ	切り結び
納める	納め
引さがる	引さがり
陥れる	陥れ
つまみだす	つまみだし
引き絞れる	引き絞れ
取留める	取留め
預かる	預かり
図抜ける	図抜け
安らぐ	安らぎ
瞬ぐ	瞬ぎ
くべる	くべ
おちくぼむ	おちくぼみ
擦り付ける	擦り付け
組合う	組合い
たすかる	たすかり
俯ける	俯け
かみあわせる	かみあわせ
購う	購い
はね返る	はね返り
振れる	振れ
とびまわる	とびまわり
廻らす	廻らし
持ち寄れる	持ち寄れ
折りあえる	折りあえ
めかす	めかし
来れる	来れ
えりわける	えりわけ
ふんぞる	ふんぞり
おせる	おせ
搖れる	搖れ
にえたつ	にえたち
罵る	罵り
欺ける	欺け
まがりくねる	まがりくねり
涼む	涼み
祝する	涼み
立ち合う	立ち合い
疑る	疑り
慶べる	慶べ
連れ添える	連れ添え
やり返せる	やり返せ
燃えたつ	燃えたち
あがりこむ	あがりこみ
拗れる	拗れ
かつぎこむ	かつぎこみ
ひきずる	ひきずり
埋れる	埋れ
ほかす	ほかし
静める	静め
成かわる	成かわり
かげる	かげり
つぶれる	つぶれ
出し切る	出し切り
吸い取れる	吸い取れ
諭す	諭し
取り紛れる	取り紛れ
取りまわす	取りまわし
おしむ	おしみ
みだれとぶ	みだれとび
買い進む	買い進み
うる	買い進み
あう	あい
捕まる	捕まり
足せる	足せ
うわむく	うわむき
だれる	だれ
わかいしあう	わかいしあい
振り返る	振り返り
おいすがる	おいすがり
はねる	はね
直せる	直せ
重ね合う	重ね合い
いたす	いたし
埋もる	埋もり
取り崩す	取り崩し
かける	かけ
かみくだける	かみくだけ
見る	見
中る	中り
あらいおとす	あらいおとし
おしながせる	おしながせ
蹴倒す	蹴倒し
噛みくだく	噛みくだき
まなぶ	まなび
あおばむ	あおばみ
攻め懸ける	攻め懸け
研ぎ澄ます	研ぎ澄まし
訛る	訛り
おがめる	おがめ
吊りあがる	吊りあがり
履き違える	履き違え
封じこめる	封じこめ
ねめる	ねめ
魘われる	魘われ
押し付ける	押し付け
散残る	散残り
書き古す	書き古し
抜きとる	抜きとり
わき起こせる	わき起こせ
絞り出せる	絞り出せ
逃げ出せる	逃げ出せ
うかれでる	うかれで
相次ぐ	相次ぎ
差付ける	差付け
聞取る	聞取り
どうける	どうけ
被れる	被れ
とり入れる	とり入れ
飛び乗る	飛び乗り
乗捨てる	乗捨て
うけつげる	うけつげ
しぼりだせる	しぼりだせ
刺し殺す	刺し殺し
追いちらす	追いちらし
かいいれる	かいいれ
とりみだす	とりみだし
おもほす	おもほし
すぼまる	すぼまり
殴り飛ばす	殴り飛ばし
思い知らせる	思い知らせ
甘える	甘え
きりかかる	きりかかり
坐す	坐し
おもいあわせる	おもいあわせ
ぎしきばる	ぎしきばり
取りつぐ	取りつぎ
延ばす	延ばし
報える	報え
うまれかわれる	うまれかわれ
組み直せる	組み直せ
うりさばける	うりさばけ
うりつくす	うりつくし
仕分ける	仕分け
こだわる	こだわり
崇める	崇め
味わう	味わい
ふりはなす	ふりはなし
しゃちほこばる	しゃちほこばり
ぶっ飛ばす	ぶっ飛ばし
おぼえこむ	おぼえこみ
痺れる	痺れ
なぎ払う	なぎ払い
保つ	保ち
抱き上げる	抱き上げ
紡ぐ	紡ぎ
切返す	切返し
しかりつける	しかりつけ
ひあがる	ひあがり
へがす	へがし
戦がす	戦がし
煌めく	煌めき
見当たる	見当たり
雑ざる	雑ざり
うごめく	うごめき
見込める	見込め
飛廻る	飛廻り
引っ張れる	引っ張れ
飲み明かす	飲み明かし
負かせる	負かせ
張りつめる	張りつめ
検する	張りつめ
打ち込む	打ち込み
のせる	のせ
うなづける	うなづけ
もらう	もらい
請け合う	請け合い
考え付く	考え付き
成すます	成すまし
はべる	はべり
挑める	挑め
みちゆく	みちゆき
はね返す	はね返し
繰り越せる	繰り越せ
即する	繰り越せ
さっきだつ	さっきだち
触れまわる	触れまわり
押し流す	押し流し
碾く	碾き
隠し持つ	隠し持ち
詰め込める	詰め込め
追い付ける	追い付け
まくる	まくり
欺く	欺き
うだる	うだり
取上せる	取上せ
摺れる	摺れ
あずかれる	あずかれ
アテる	アテ
けあげる	けあげ
ふりほどく	ふりほどき
張れる	張れ
たる	たり
だましこむ	だましこみ
頼み入る	頼み入り
取りつくろう	取りつくろい
かいうける	かいうけ
きりきざむ	きりきざみ
はぎ合せる	はぎ合せ
かえる	かえ
引絞る	引絞り
曲りくねる	曲りくねり
養う	養い
笑割れる	笑割れ
走り出す	走り出し
取廻す	取廻し
にくめる	にくめ
打続く	打続き
うるむ	うるみ
めしとる	めしとり
漕ぐ	漕ぎ
担わす	担わし
めしだす	めしだし
厭う	厭い
泣き伏せる	泣き伏せ
たぎつ	たぎち
なれあう	なれあい
しみる	しみ
みつけだす	みつけだし
仰れる	仰れ
しみとおる	しみとおり
こげつかす	こげつかし
おもいもうける	おもいもうけ
断ち切れる	断ち切れ
取決める	取決め
ぬぐい去れる	ぬぐい去れ
やって来る	やって来
あいせる	あいせ
つっ走る	つっ走り
おとしめる	おとしめ
開け払う	開け払い
関連付ける	関連付け
誇れる	誇れ
かいす	かいし
踏んづける	踏んづけ
動き回る	動き回り
炒める	炒め
になえる	になえ
がめる	がめり
受け止める	受け止め
消す	消し
擡げる	擡げ
うりこむ	うりこみ
よみふける	よみふけり
差しかえる	差しかえ
擂りつぶす	擂りつぶし
ゆする	ゆすり
見積もる	見積もり
めいじる	めいじ
もちまわれる	もちまわれ
てりつける	てりつけ
かきだせる	かきだせ
容体ぶる	容体ぶり
立ち入れる	立ち入れ
待ち侘びる	待ち侘び
捜し出せる	捜し出せ
申し込める	申し込め
取直す	取直し
かたりあえる	かたりあえ
振捨てる	振捨て
のりあわす	のりあわし
いななく	いななき
しそこなう	しそこない
招く	招き
つき合える	つき合え
曲げる	曲げ
すり寄る	すり寄り
語り明かせる	語り明かせ
苛める	苛め
通う	通い
巻込む	巻込み
暖める	暖め
まちあぐむ	まちあぐみ
いかりくるう	いかりくるい
組む	組み
殴る	殴り
たちかかる	たちかかり
たなびく	たなびき
差し越す	差し越し
さしころせる	さしころせ
まぎらかす	まぎらかし
冷ませる	冷ませ
しくめる	しくめ
引き延ばせる	引き延ばせ
つかみかかる	つかみかかり
付従う	付従い
わかがえれる	わかがえれ
ふりすてる	ふりすて
ひかす	ひかし
たちゆく	たちゆき
悄気込む	悄気込み
引きあげる	引きあげ
引っ繰り返す	引っ繰り返し
取り纏める	取り纏め
うかびあがる	うかびあがり
照り映える	照り映え
きく	きき
飛び越える	飛び越え
つけこむ	つけこみ
そめかえす	そめかえし
かちとれる	かちとれ
慢ずる	かちとれ
打ちあける	打ちあけ
さそいあわせる	さそいあわせ
ききながす	ききながし
かざれる	かざれ
まける	まけ
かきみだす	かきみだし
いせる	いせ
脅かす	脅かし
やすむ	やすみ
溶け込む	溶け込み
済ます	済まし
いきつく	いきつき
見当る	見当り
崩れさる	崩れさり
くいきる	くいきり
じんどる	じんどり
かんがえこむ	かんがえこみ
よこたえる	よこたえ
居並ぶ	居並び
見過ごす	見過ごし
持ち掛ける	持ち掛け
あとづける	あとづけ
想う	想い
勧める	勧め
つのめだつ	つのめだち
画く	画き
かえりざく	かえりざき
やってのける	やってのけ
のみつぶす	のみつぶし
打抜く	打抜き
参ずる	打抜き
かきふるす	かきふるし
たむける	たむけ
旅立つ	旅立ち
フッカケる	フッカケ
御する	フッカケ
踏む	踏み
あわれがる	あわれがり
移り変わる	移り変わり
たげる	たげ
打ち寄せる	打ち寄せ
寝静まる	寝静まり
さきんずる	寝静まり
うかぶ	うかび
しょぼぬれる	しょぼぬれ
ゆきくれる	ゆきくれ
おける	おけ
組みたてる	組みたて
押し詰める	押し詰め
駆りたてる	駆りたて
押しまくる	押しまくり
ぶち込む	ぶち込み
すべりおちる	すべりおち
抜かわる	抜かわり
いなす	いなし
総毛立つ	総毛立ち
裏返せる	裏返せ
かす	かし
はりつける	はりつけ
みはからう	みはからい
めがける	めがけ
流れ出す	流れ出し
もてあつかう	もてあつかい
経つ	経ち
眩く	眩き
うねる	うねり
くちずさむ	くちずさみ
どなりつける	どなりつけ
湧き出る	湧き出
いいつける	いいつけ
つれ去る	つれ去り
引き合う	引き合い
よりつく	よりつき
奪い合う	奪い合い
終える	終え
潤す	潤し
食う	食い
旧びる	旧び
切下げる	切下げ
いきおいこむ	いきおいこみ
くる	き
なじむ	なじみ
ふるいたつ	ふるいたち
責立てる	責立て
しるす	しるし
連れ合う	連れ合い
引っぱたく	引っぱたき
建て直す	建て直し
とりかたづける	とりかたづけ
押しつける	押しつけ
足す	足し
行き着ける	行き着け
わかる	わかり
愛する	わかり
いばえる	いばえ
粧う	粧い
おくりだせる	おくりだせ
説ける	説け
ながれつける	ながれつけ
せり出す	せり出し
芽だつ	芽だち
鑑みる	鑑み
たちいれる	たちいれ
突き立てる	突き立て
めり込む	めり込み
言い張る	言い張り
くくる	くくり
ついばむ	ついばみ
かろしめる	かろしめ
引離す	引離し
しだく	しだき
つくる	つくり
懸隔たる	懸隔たり
うわむける	うわむけ
乗後れる	乗後れ
泣きはらす	泣きはらし
立ちふさがる	立ちふさがり
わがねる	わがね
取離す	取離し
ねじ上げる	ねじ上げ
うずく	うずき
取り壊す	取り壊し
でなおす	でなおし
あてこする	あてこすり
つげる	つげ
光る	光り
くされる	くされ
くぐれる	くぐれ
押し退ける	押し退け
くどく	くどき
のぼせあがる	のぼせあがり
死ねる	死ね
ながれる	ながれ
落ちのびる	落ちのび
おしたおす	おしたおし
継ぐ	継ぎ
勤める	勤め
詰む	詰み
こらえる	こらえ
連れ込める	連れ込め
蒸せる	蒸せ
依る	依り
したしめる	したしめ
要する	したしめ
粟立つ	粟立ち
使いこなす	使いこなし
物慣れる	物慣れ
かちすすめる	かちすすめ
よびもどす	よびもどし
みだせる	みだせ
捩じくれる	捩じくれ
取りもつ	取りもち
かけあわす	かけあわし
しにかわる	しにかわり
終わらす	終わらし
見い出す	見い出し
伐る	伐り
うみおとす	うみおとし
ほうじる	ほうじ
泡立てる	泡立て
誉める	誉め
ながしこめる	ながしこめ
伏し拝む	伏し拝み
取り結ぶ	取り結び
のりくむ	のりくみ
企む	企み
独りごつ	独りごち
とりけせる	とりけせ
調子付く	調子付き
縫える	縫え
なくす	なくし
からみつく	からみつき
愚図る	愚図り
持ち込める	持ち込め
しょっぴく	しょっぴき
尖らす	尖らし
送れる	送れ
吹きとばす	吹きとばし
撫でる	撫で
差せる	差せ
潜む	潜み
おしうつる	おしうつり
質す	質し
付ける	付け
取り回す	取り回し
みはらせる	みはらせ
勝ち進む	勝ち進み
ふるえあがる	ふるえあがり
見下す	見下し
伸べる	伸べ
取り揃う	取り揃い
うちしずむ	うちしずみ
をろがむ	をろがみ
ぬきんでる	ぬきんで
一皮むく	一皮むき
ふうじこむ	ふうじこみ
抱きつく	抱きつき
混ぜ合わせる	混ぜ合わせ
荒らせる	荒らせ
おわす	おわし
なぐさむ	なぐさみ
伏し沈む	伏し沈み
失ふ	失ひ
追い払う	追い払い
かぎわける	かぎわけ
凭れる	凭れ
歓べる	歓べ
つれる	つれ
持ち回れる	持ち回れ
はくす	はくし
規則立つ	規則立ち
ねじける	ねじけ
りゃくせる	りゃくせ
摸する	りゃくせ
泊まれる	泊まれ
とりこす	とりこし
つらねる	つらね
付け足せる	付け足せ
待合せる	待合せ
立て直す	立て直し
あらえる	あらえ
入れかえる	入れかえ
ビビる	ビビり
祷る	祷り
みおとす	みおとし
くう	くい
かいこす	かいこし
結びつく	結びつき
与える	与え
得る	与え
撃止める	撃止め
増せる	増せ
溶く	溶き
逃げ延びる	逃げ延び
ねがいでる	ねがいで
勝れる	勝れ
うらぎる	うらぎり
きょうずる	うらぎり
ひきまわす	ひきまわし
だらける	だらけ
和む	和み
くらす	くらし
つっ切る	つっ切り
きりむすぶ	きりむすび
追い抜く	追い抜き
うるおう	うるおい
つかる	つかり
そんずる	つかり
くみ出す	くみ出し
なり変わる	なり変わり
うかびでる	うかびで
くみたてる	くみたて
差し入れる	差し入れ
つかまる	つかまり
歪む	歪み
抜かす	抜かし
干からびる	干からび
扠措く	扠措き
寝忘れる	寝忘れ
旅立てる	旅立て
崩せる	崩せ
引き合せる	引き合せ
えがける	えがけ
類える	類え
継ぎ合せる	継ぎ合せ
突っ返せる	突っ返せ
うみつける	うみつけ
ねだる	ねだり
打合う	打合い
飛び降りる	飛び降り
ぬるむ	ぬるみ
ほっする	ぬるみ
噛み分ける	噛み分け
置き忘れる	置き忘れ
もみ消す	もみ消し
尋め行く	尋め行き
かっとばす	かっとばし
かつぎこめる	かつぎこめ
釣り上げる	釣り上げ
取り込める	取り込め
逆上せる	逆上せ
おしわける	おしわけ
打ち取る	打ち取り
引きずり回せる	引きずり回せ
後れる	後れ
住み替える	住み替え
成り下がる	成り下がり
せかせる	せかせ
責め付ける	責め付け
差し回す	差し回し
いいかえす	いいかえし
減らす	減らし
あてる	あて
しらちゃける	しらちゃけ
とけこめる	とけこめ
さく	さき
ねとつく	ねとつき
飾り付ける	飾り付け
生み出せる	生み出せ
切羽詰る	切羽詰り
きりさく	きりさき
すりむける	すりむけ
ばける	ばけ
居残る	居残り
せいする	居残り
こみあげる	こみあげ
たぶ	たび
引き下ろせる	引き下ろせ
偲ぶ	偲び
張り倒す	張り倒し
おかせる	おかせ
肥る	肥り
引裂く	引裂き
染み透る	染み透り
騰がる	騰がり
散り残る	散り残り
梳く	梳き
綴り合せる	綴り合せ
うりなやむ	うりなやみ
賄う	賄い
ふきこむ	ふきこみ
賭ける	賭け
事足る	事足り
ころげる	ころげ
ポシャる	ポシャり
飛びだす	飛びだし
明け払う	明け払い
噛みころす	噛みころし
ねとる	ねとり
ズレ込む	ズレ込み
成す	成し
覚え込む	覚え込み
おくりだす	おくりだし
運び込める	運び込め
はぎ合わす	はぎ合わし
はらえる	はらえ
立ちのぼる	立ちのぼり
咽ぶ	咽び
さしきる	さしきり
慶ぶ	慶び
張回す	張回し
根差す	根差し
辷る	辷り
もうしつける	もうしつけ
立合う	立合い
思い出せる	思い出せ
読み分ける	読み分け
くらう	くらい
うねりくねる	うねりくねり
泣崩れる	泣崩れ
蝕む	蝕み
たくす	たくし
とどまる	とどまり
やせほそる	やせほそり
打込める	打込め
もうしうける	もうしうけ
だしあう	だしあい
うちあげる	うちあげ
押し出す	押し出し
いどむ	いどみ
拉げる	拉げ
がいす	がいし
見おろす	見おろし
切り払う	切り払い
ひんまがる	ひんまがり
打付ける	打付け
投げ込む	投げ込み
ねつく	ねつき
乗り掛る	乗り掛り
踏みならせる	踏みならせ
さえぎる	さえぎり
いやまさる	いやまさり
ようだてる	ようだて
波うつ	波うち
差し掛ける	差し掛け
詰切る	詰切り
はりとばす	はりとばし
出かける	出かけ
すぐる	すぐり
頑張る	頑張り
織りなす	織りなし
生延びる	生延び
スレ違う	スレ違い
投げ飛ばす	投げ飛ばし
おごる	おごり
せきいる	せきいり
判じる	判じ
さしまわせる	さしまわせ
だきおこす	だきおこし
勝ち誇る	勝ち誇り
押隠す	押隠し
へこたれる	へこたれ
でばる	でばり
脱す	脱し
生きながらえる	生きながらえ
戦慄く	戦慄き
すたれる	すたれ
張り上げる	張り上げ
よみこなせる	よみこなせ
待ちかねる	待ちかね
ほうる	ほうり
ろくする	ほうり
くわれる	くわれ
すすり上げる	すすり上げ
担う	担い
まかなう	まかない
騰る	騰り
さからえる	さからえ
はせまわる	はせまわり
読む	読み
受け入れる	受け入れ
引き連れる	引き連れ
儲ける	儲け
ハマる	ハマり
もちこす	もちこし
押し上げる	押し上げ
召上がる	召上がり
割込む	割込み
くりだせる	くりだせ
もつれ込む	もつれ込み
こまりはてる	こまりはて
立てかける	立てかけ
いきかえれる	いきかえれ
こぎ着く	こぎ着き
立去る	立去り
りっする	立去り
取り上げる	取り上げ
ひれ伏す	ひれ伏し
思い知る	思い知り
下掛る	下掛り
差迫る	差迫り
くみかえる	くみかえ
差し合う	差し合い
出立つ	出立ち
ひもとく	ひもとき
うずくまる	うずくまり
温む	温み
あけはなせる	あけはなせ
洒落る	洒落
こそぐる	こそぐり
はばむ	はばみ
積み出せる	積み出せ
くいのばす	くいのばし
なずらえる	なずらえ
乗り込める	乗り込め
しねる	しね
押し流せる	押し流せ
雇う	雇い
模する	雇い
嘆く	嘆き
しぐれる	しぐれ
したう	したい
投げ飛ばせる	投げ飛ばせ
起きる	起き
切払う	切払い
やけだす	やけだし
ふき取る	ふき取り
知れ渡る	知れ渡り
訳す	訳し
住み込む	住み込み
荒れる	荒れ
こごむ	こごみ
まつりあげる	まつりあげ
休する	まつりあげ
あらわす	あらわし
智慧づく	智慧づき
生い茂る	生い茂り
垂れ篭める	垂れ篭め
翔ぶ	翔び
あみあげる	あみあげ
なまける	なまけ
取り切れる	取り切れ
もり立てる	もり立て
飲みほす	飲みほし
まきこむ	まきこみ
纏う	纏い
乗り回せる	乗り回せ
すすりあげる	すすりあげ
助け合える	助け合え
ものもうす	ものもうし
すてさる	すてさり
免じる	免じ
うけだせる	うけだせ
和解し合う	和解し合い
とりくめる	とりくめ
受け持つ	受け持ち
振りほどく	振りほどき
卒する	振りほどき
つづりあわす	つづりあわし
一皮剥ける	一皮剥け
先駆ける	先駆け
えらびだす	えらびだし
うちすえる	うちすえ
使い込む	使い込み
さまたげる	さまたげ
すたる	すたり
書する	すたり
不貞てる	不貞て
とびこめる	とびこめ
見蕩れる	見蕩れ
慥かめる	慥かめ
つまみ上げる	つまみ上げ
のます	のまし
涸らす	涸らし
撰する	涸らし
寝かしつける	寝かしつけ
歩きつめる	歩きつめり
診る	診
ぬいこむ	ぬいこみ
きりこむ	きりこみ
膨らます	膨らまし
ちゃう	ちゃい
宿る	宿り
取りかかる	取りかかり
巻き返せる	巻き返せ
すり込む	すり込み
追回す	追回し
登れる	登れ
差し立てる	差し立て
打ち勝てる	打ち勝て
ふきぬける	ふきぬけ
切回す	切回し
うつす	うつし
つみだせる	つみだせ
切合う	切合い
はいする	切合い
裏切る	裏切り
かいきれる	かいきれ
埋め込む	埋め込み
取りあわせる	取りあわせ
閉め出す	閉め出し
出来合う	出来合い
騒がせる	騒がせ
ほどこす	ほどこし
習わせる	習わせ
ぬけだす	ぬけだし
追越す	追越し
ばらつく	ばらつき
ばてる	ばて
傷付ける	傷付け
うちやぶれる	うちやぶれ
ふきわける	ふきわけ
棲む	棲み
頻る	頻り
きそう	きそい
ねじ込む	ねじ込み
たてこむ	たてこみ
いく	いき
ひずむ	ひずみ
取り置く	取り置き
はしゃぐ	はしゃぎ
とう	とい
どかす	どかし
あらわれる	あらわれ
かりうける	かりうけ
繰り寄せる	繰り寄せ
まくれる	まくれ
とりちらす	とりちらし
ものなれる	ものなれ
角ぐむ	角ぐみ
思いまどう	思いまどい
押し隠す	押し隠し
あらそう	あらそい
取っ付く	取っ付き
血迷う	血迷い
だする	血迷い
絡げる	絡げ
言い合せる	言い合せ
かかげる	かかげ
おいかえせる	おいかえせ
かつぎ込む	かつぎ込み
切替える	切替え
軋む	軋み
切り捲る	切り捲り
綻ばす	綻ばし
しのびなく	しのびなき
つくりだせる	つくりだせ
ひきしぼれる	ひきしぼれ
乗回す	乗回し
かんじとる	かんじとり
控える	控え
わりびく	わりびき
呼びいれる	呼びいれ
切伏せる	切伏せ
掻きたてる	掻きたて
煮えたつ	煮えたち
補い合う	補い合い
住み着ける	住み着け
寝付く	寝付き
念じる	念じ
きりまわせる	きりまわせ
吹っ切る	吹っ切り
甘ったれる	甘ったれ
勝ち残る	勝ち残り
慌てる	慌て
癒せる	癒せ
乗組む	乗組み
咳き上げる	咳き上げ
つきとめる	つきとめ
潰れる	潰れ
わりだせる	わりだせ
博す	博し
組み入れる	組み入れ
かしぐ	かしぎ
やり過ごせる	やり過ごせ
崩ずる	やり過ごせ
言いおく	言いおき
有り余る	有り余り
わらいとばす	わらいとばし
逃がす	逃がし
まちがう	まちがい
ねじきる	ねじきり
神しずまる	神しずまり
やとえる	やとえ
切り伏せる	切り伏せ
滲む	滲み
あせる	あせ
ひょうする	あせ
吸取る	吸取り
よじのぼる	よじのぼり
殖やせる	殖やせ
ちんずる	殖やせ
またげる	またげ
繰回す	繰回し
笑わせる	笑わせ
ふりしぼる	ふりしぼり
かつぎあげる	かつぎあげ
使い切る	使い切り
脅す	脅し
歩き疲れる	歩き疲れ
かたよる	かたより
裂ける	裂け
帰す	帰し
かみ合う	かみ合い
分る	分り
戦える	戦え
切りつめる	切りつめ
言い表せる	言い表せ
啼く	啼き
たたむ	たたみ
おこたる	おこたり
せめる	せめ
もちなおす	もちなおし
譲り渡せる	譲り渡せ
よみする	譲り渡せ
彌増さる	彌増さり
やむ	やみ
長ける	長け
おとせる	おとせ
きがまえる	きがまえ
乗越す	乗越し
見渡せる	見渡せ
かくしもてる	かくしもて
かんがえる	かんがえ
うたがう	うたがい
損する	うたがい
うめく	うめき
くらいつく	くらいつき
返せる	返せ
すっこむ	すっこみ
運べる	運べ
まわる	まわり
おとる	おとり
萌え出る	萌え出
晴渡る	晴渡り
果てる	果て
録する	果て
移せる	移せ
悄気げる	悄気げ
言い返せる	言い返せ
ぎんずる	言い返せ
止る	止り
みさげる	みさげ
阻む	阻み
来なさる	来なさり
折重なる	折重なり
ふっ飛ぶ	ふっ飛び
通がる	通がり
てまどる	てまどり
しにはてる	しにはて
向かい合わす	向かい合わし
当てはめる	当てはめ
とびこせる	とびこせ
ためる	ため
なきふす	なきふし
さらう	さらい
ぬりたてる	ぬりたて
かたりあかせる	かたりあかせ
接ぎ合せる	接ぎ合せ
とりだせる	とりだせ
募る	募り
ひっこぬく	ひっこぬき
つけ足す	つけ足し
見通せる	見通せ
みあきる	みあき
思いあまる	思いあまり
追う	追い
もれきく	もれきき
ふゆごもる	ふゆごもり
飛び歩く	飛び歩き
刷り込む	刷り込み
くいつめる	くいつめ
くぐる	くぐり
いいきる	いいきり
かき合せる	かき合せ
荒立てる	荒立て
閲する	荒立て
焦げつかす	焦げつかし
のりまわせる	のりまわせ
隠す	隠し
そだつ	そだち
被える	被え
でる	で
殴れる	殴れ
洩れる	洩れ
いびりだす	いびりだし
しがみつく	しがみつき
いただく	いただき
打見る	打見
討取る	討取り
誤る	誤り
受流す	受流し
責め立てる	責め立て
尋ねる	尋ね
かびる	かび
ほおばる	ほおばり
射抜く	射抜き
啄む	啄み
よりすがる	よりすがり
浸ける	浸け
撃ち破れる	撃ち破れ
突合せる	突合せ
謡う	謡い
立ち篭める	立ち篭め
のりだす	のりだし
立ちつくす	立ちつくし
吹き分ける	吹き分け
香る	香り
せめあぐむ	せめあぐみ
払い戻せる	払い戻せ
さしかざす	さしかざし
ひっぱる	ひっぱり
似つく	似つき
用いる	用い
とりさげる	とりさげ
取り混ぜる	取り混ぜ
ほだされる	ほだされ
いきつける	いきつけ
目指す	目指し
立ち直れる	立ち直れ
惑う	惑い
てつだえる	てつだえ
きりたおせる	きりたおせ
ならう	ならい
拝める	拝め
落ちこむ	落ちこみ
かつ	かち
ねらう	ねらい
焙る	焙り
としとる	としとり
犇めく	犇めき
ごろつく	ごろつき
翻せる	翻せ
くずす	くずし
扱える	扱え
哭く	哭き
とびでる	とびで
書き留める	書き留め
悩む	悩み
のがれる	のがれ
突き刺さる	突き刺さり
役だつ	役だち
とげる	とげ
勝る	勝り
ぶった切る	ぶった切り
読み解く	読み解き
惹く	惹き
きらす	きらし
穿つ	穿ち
巻き付ける	巻き付け
るいする	巻き付け
うけあえる	うけあえ
差し響く	差し響き
ふみつける	ふみつけ
ならわせる	ならわせ
りゃくする	ならわせ
へせる	へせ
通いつめる	通いつめ
なげく	なげき
みつぐ	みつぎ
かがす	かがし
伸し歩く	伸し歩き
くばれる	くばれ
縛り付ける	縛り付け
みすえる	みすえ
暮らす	暮らし
持ちこむ	持ちこみ
掛かる	掛かり
掻い繕う	掻い繕い
噎せ返る	噎せ返り
混じる	混じり
付きまとう	付きまとい
しんじこめる	しんじこめ
ゆであがる	ゆであがり
寇する	ゆであがり
振りだす	振りだし
にごらせる	にごらせ
取繕う	取繕い
みくだせる	みくだせ
巻き起こす	巻き起こし
せり合う	せり合い
こいしたう	こいしたい
焼付ける	焼付け
ほとびる	ほとび
怨む	怨み
はじまる	はじまり
取り直せる	取り直せ
飽かす	飽かし
おしいれる	おしいれ
まぎれる	まぎれ
かぶりつく	かぶりつき
あつまる	あつまり
にげまどう	にげまどい
誤らせる	誤らせ
生き抜く	生き抜き
急がす	急がし
煽る	煽り
ひねくれる	ひねくれ
とめゆく	とめゆき
働き掛ける	働き掛け
やきなます	やきなまし
引きずり回す	引きずり回し
ゆれうごく	ゆれうごき
伸し掛る	伸し掛り
消える	消え
習う	習い
振掛ける	振掛け
おぼめく	おぼめき
もうしおくれる	もうしおくれ
しゃぶりつく	しゃぶりつき
浮出す	浮出し
喚く	喚き
染みとおる	染みとおり
標す	標し
奪える	奪え
縁付く	縁付き
歩み寄れる	歩み寄れ
たいす	たいし
だまかす	だまかし
湧く	湧き
コケる	コケ
ひっ付く	ひっ付き
思いつく	思いつき
焚ける	焚け
溺れる	溺れ
はかなむ	はかなみ
きりはらえる	きりはらえ
みまわす	みまわし
巣ごもる	巣ごもり
そびやかす	そびやかし
きずつける	きずつけ
傷つける	傷つけ
のっとれる	のっとれ
えつにいる	えつにいり
はらだつ	はらだち
預かれる	預かれ
たる	たり
煎じる	煎じ
毀れる	毀れ
おいさらばえる	おいさらばえ
おれあう	おれあい
つき刺さる	つき刺さり
笑われる	笑われ
かき回す	かき回し
かみあわす	かみあわし
たかる	たかり
はたらかす	はたらかし
織りまぜる	織りまぜ
縁る	縁り
取りすがる	取りすがり
うっちゃらかす	うっちゃらかし
表わす	表わし
型どる	型どり
乗り越せる	乗り越せ
作り直す	作り直し
さしちがえる	さしちがえ
浮き上がる	浮き上がり
かけはなれる	かけはなれ
眺める	眺め
見離す	見離し
説き明かす	説き明かし
すっぽかす	すっぽかし
いなむ	いなみ
てく	てき
とうずる	てき
連れ込む	連れ込み
漉す	漉し
持ち回る	持ち回り
しとげる	しとげ
かき混ぜる	かき混ぜ
差し掛かる	差し掛かり
取り散らす	取り散らし
癒える	癒え
晴れ上がる	晴れ上がり
失する	晴れ上がり
つぎこむ	つぎこみ
言い漏らす	言い漏らし
おぼす	おぼし
バレる	バレ
ほそる	ほそり
とまどう	とまどい
ゆる	ゆり
こさえる	こさえ
鬻ぐ	鬻ぎ
めざす	めざし
蕾む	蕾み
ぬがす	ぬがし
しゃがめる	しゃがめ
追い詰める	追い詰め
押し通せる	押し通せ
戸惑う	戸惑い
とりはずせる	とりはずせ
そむく	そむき
浮かす	浮かし
選びとれる	選びとれ
からむ	からみ
銘打つ	銘打ち
振るえる	振るえ
心得る	心得
混じる	混じ
付け足す	付け足し
立ちこめる	立ちこめ
跳ぶ	跳び
引抜く	引抜き
出向ける	出向け
差つかえる	差つかえ
わたりあるく	わたりあるき
つぶる	つぶり
打捨てる	打捨て
申しかねる	申しかね
速める	速め
賜わる	賜わり
怒らす	怒らし
なだめる	なだめ
きどる	きどり
追い散らす	追い散らし
知る	知り
かかれる	かかれ
かいもどせる	かいもどせ
笑わす	笑わし
振舞う	振舞い
うりまくる	うりまくり
きぶくれる	きぶくれ
借る	借り
呼び込む	呼び込み
蹴違える	蹴違え
そくす	そくし
いましめる	いましめ
さそいあわす	さそいあわし
ふるい落とせる	ふるい落とせ
扱く	扱き
平伏す	平伏し
あぶらぎる	あぶらぎり
わりだす	わりだし
突っ放す	突っ放し
へだてる	へだて
なりさがれる	なりさがれ
呼掛ける	呼掛け
点く	点き
せきこむ	せきこみ
かくばる	かくばり
涙ぐむ	涙ぐみ
画する	涙ぐみ
つまむ	つまみ
靠れる	靠れ
つかえる	つかえ
にぎりしめる	にぎりしめ
小戻す	小戻し
減ずる	小戻し
にぎやかす	にぎやかし
ぶら下がる	ぶら下がり
売りさばける	売りさばけ
さておく	さておき
伸び上がる	伸び上がり
よびつづける	よびつづけ
託つ	託ち
たずさえる	たずさえ
つき合せる	つき合せ
吊り上がる	吊り上がり
出廻る	出廻り
かき消える	かき消え
したたらす	したたらし
すがめる	すがめ
ことづかる	ことづかり
見通す	見通し
はがせる	はがせ
手慣れる	手慣れ
聞き分ける	聞き分け
きあわす	きあわし
しりあえる	しりあえ
見破る	見破り
反る	反り
しぼむ	しぼみ
才走る	才走り
形作る	形作り
片付ける	片付け
くる	き
いあわせる	いあわせ
引っ被る	引っ被り
噛み合せる	噛み合せ
振りさけみる	振りさけみ
見回す	見回し
あおむく	あおむき
すだく	すだき
えんする	すだき
結え付ける	結え付け
病む	病み
膨らむ	膨らみ
追いまくる	追いまくり
捲揚げる	捲揚げ
引き返す	引き返し
寝ころべる	寝ころべ
擦り剥ける	擦り剥け
出つくす	出つくし
思い設ける	思い設け
しめせる	しめせ
終える	終え
落とし込める	落とし込め
呼寄せる	呼寄せ
いきのびる	いきのび
施せる	施せ
たもつ	たもち
立てこもれる	立てこもれ
ふんづける	ふんづけ
こわす	こわし
嵩張る	嵩張り
区切れる	区切れ
押し込む	押し込み
あらいながす	あらいながし
おびき出せる	おびき出せ
とけ込む	とけ込み
持ち寄る	持ち寄り
もちあるく	もちあるき
振絞る	振絞り
しりあう	しりあい
とまりこむ	とまりこみ
談ずる	とまりこみ
かてる	かて
焦がす	焦がし
思える	思え
たどり着ける	たどり着け
ひきあわせる	ひきあわせ
泊り込む	泊り込み
追いはらう	追いはらい
目ざす	目ざし
割り切れる	割り切れ
科する	割り切れ
みはなす	みはなし
しむける	しむけ
ねじ伏せる	ねじ伏せ
かえりみる	かえりみ
引き回す	引き回し
しく	しき
かする	かすり
みちびく	みちびき
載っかる	載っかり
ほめる	ほめ
さきのこる	さきのこり
悩ます	悩まし
世慣れる	世慣れ
にらみ合う	にらみ合い
だぶつく	だぶつき
住み成す	住み成し
わく	わき
垣間見る	垣間見
かくせる	かくせ
論る	論り
あたう	あたい
かけ込む	かけ込み
融かす	融かし
簸る	簸
きあわせる	きあわせ
わりつける	わりつけ
つきあわす	つきあわし
ひきあう	ひきあい
まわせる	まわせ
切裂く	切裂き
たくましゅうする	切裂き
かきのこす	かきのこし
浮く	浮き
いじめる	いじめ
食らえる	食らえ
飛び下りる	飛び下り
踏み止まる	踏み止まり
囲う	囲い
なきくずれる	なきくずれ
賣る	賣り
掛け合せる	掛け合せ
射し込む	射し込み
御座る	御座い
さしあげる	さしあげ
ふるいおこす	ふるいおこし
しょぼたれる	しょぼたれ
ちょろまかす	ちょろまかし
使いこなせる	使いこなせ
もえうつる	もえうつり
いいつかる	いいつかり
はねのける	はねのけ
焼払う	焼払い
楽しめる	楽しめ
たらし込む	たらし込み
這いだす	這いだし
呼び続ける	呼び続け
あわ立つ	あわ立ち
めす	めし
句切る	句切り
触れこむ	触れこみ
いなおる	いなおり
分捕る	分捕り
葺く	葺き
痩せる	痩せ
引き受ける	引き受け
寂れる	寂れ
たたき込む	たたき込み
判る	判り
暖まる	暖まり
漕ぎつける	漕ぎつけ
咲く	咲き
ほりこめる	ほりこめ
かみくだく	かみくだき
伸び上がれる	伸び上がれ
かいあさる	かいあさり
すが立つ	すが立ち
いきせききる	いきせききり
もえつきる	もえつき
ひねりまわす	ひねりまわし
おいこす	おいこし
からげる	からげ
践む	践み
割り込む	割り込み
受け継ぐ	受け継ぎ
思ひ寄る	思ひ寄り
こじらす	こじらし
おしもどす	おしもどし
はじき返す	はじき返し
冷やせる	冷やせ
まじる	まじり
きりおとす	きりおとし
さらせる	さらせ
食い下がれる	食い下がれ
つくす	つくし
時雨れる	時雨れ
座る	座り
まねる	まね
済む	済み
疎んずる	済み
すべりだす	すべりだし
霜枯れる	霜枯れ
かんじる	かんじ
えづく	えづき
煮立てる	煮立て
あびせかける	あびせかけ
もつれる	もつれ
押し遣る	押し遣り
凍りつく	凍りつき
達っする	凍りつき
資する	凍りつき
透かす	透かし
濁る	濁り
込み合う	込み合い
えっする	込み合い
絞り上げる	絞り上げ
擦り切る	擦り切り
産す	産し
仰げる	仰げ
まいくるう	まいくるい
寄せ掛ける	寄せ掛け
陳ずる	寄せ掛け
捲き込む	捲き込み
うちとめる	うちとめ
ふすべる	ふすべ
得する	ふすべ
ずり上がる	ずり上がり
踏まえる	踏まえ
まわれる	まわれ
いいけす	いいけし
じゅんじる	じゅんじ
いてつく	いてつき
ちらす	ちらし
遺す	遺し
拱く	拱き
のめる	のめ
となりあわす	となりあわし
ふみこえる	ふみこえ
誘ふ	誘ひ
まいあがる	まいあがり
打ちだせる	打ちだせ
蹴返す	蹴返し
浴びせる	浴びせ
背く	背き
きめつける	きめつけ
暮す	暮し
継る	継り
問ただす	問ただし
つかわれだす	つかわれだし
なさる	なさい
連れあう	連れあい
ぶんどる	ぶんどり
押詰める	押詰め
ちらかす	ちらかし
おどしとる	おどしとり
ひっこせる	ひっこせ
介す	介し
ぱさつく	ぱさつき
抜放つ	抜放ち
取出す	取出し
であえる	であえ
損なう	損ない
ほどく	ほどき
刃向かえる	刃向かえ
苦しむ	苦しみ
身ごもる	身ごもり
うすずく	うすずき
生れる	生れ
かきのこせる	かきのこせ
行きつく	行きつき
飛び違う	飛び違い
むらす	むらし
やにさがる	やにさがり
うたう	うたい
見知る	見知り
ききとれる	ききとれ
おいつく	おいつき
語らう	語らい
武張る	武張り
請じ入れる	請じ入れ
さきだてる	さきだて
あがなう	あがない
かけ合う	かけ合い
さしころす	さしころし
ほする	さしころし
もがける	もがけ
尽くす	尽くし
塗る	塗り
引き取る	引き取り
出る	出
手掛ける	手掛け
かいまみる	かいまみ
かたむく	かたむき
開きなおる	開きなおり
映ろう	映ろい
にこむ	にこみ
たちどまる	たちどまり
こいする	たちどまり
現す	現し
すいつける	すいつけ
ひき殺す	ひき殺し
いびる	いびり
引き退ける	引き退け
愛し合える	愛し合え
生る	生り
ぬぐい去る	ぬぐい去り
表れる	表れ
寄り添える	寄り添え
てばなせる	てばなせ
表す	表し
動きだす	動きだし
せりあえる	せりあえ
おいあげる	おいあげ
いいおよぼす	いいおよぼし
吼える	吼え
へんする	吼え
ひきかえせる	ひきかえせ
在りあわせる	在りあわせ
聞込む	聞込み
よせる	よせ
ゆりうごかせる	ゆりうごかせ
むしゃぶりつく	むしゃぶりつき
にぎりつぶせる	にぎりつぶせ
おいはらえる	おいはらえ
見つかる	見つかり
閃かす	閃かし
浮き足立つ	浮き足立ち
廃る	廃り
振り向く	振り向き
書き表す	書き表し
燃え尽きる	燃え尽き
生みつける	生みつけ
みつめる	みつめ
のぞき込む	のぞき込み
交わる	交わり
思わす	思わし
やる	やり
聴く	聴き
にる	に
つまる	つまり
上せる	上せ
たきしめる	たきしめ
げする	たきしめ
うちきる	うちきり
触込む	触込み
靡く	靡き
さしつかわす	さしつかわし
遣りこなす	遣りこなし
青みがかる	青みがかり
攻め落す	攻め落し
掻き混ぜる	掻き混ぜ
蹶る	蹶り
せめつける	せめつけ
引き抜く	引き抜き
ふりおこす	ふりおこし
仰向ける	仰向け
定義付ける	定義付け
染めわける	染めわけ
押し出せる	押し出せ
しす	しし
うかれだす	うかれだし
申し立てる	申し立て
いだける	いだけ
好き好む	好き好み
点ずる	好き好み
枯らす	枯らし
のびる	のび
綴り合す	綴り合し
見紛う	見紛い
澱む	澱み
巣立てる	巣立て
知合う	知合い
紐解ける	紐解け
わき起こす	わき起こし
おもいおよぶ	おもいおよび
暮れる	暮れ
かんがえぬく	かんがえぬき
吐かす	吐かし
俯く	俯き
空惚ける	空惚け
にげだす	にげだし
色めく	色めき
からめる	からめ
いう	いい
だんずる	いい
こびへつらう	こびへつらい
読み込む	読み込み
よじる	よじり
いたわる	いたわり
引合う	引合い
行う	行い
押し掛ける	押し掛け
捏ねる	捏ね
ひきわける	ひきわけ
分かれる	分かれ
習わす	習わし
立のく	立のき
見やる	見やり
引き留める	引き留め
入り込める	入り込め
ひっくり返す	ひっくり返し
べたつく	べたつき
のす	のし
かきすてる	かきすて
こびり付く	こびり付き
うきあがる	うきあがり
吸い込む	吸い込み
きよめる	きよめ
だいする	きよめ
写せる	写せ
さめる	さめ
補う	補い
起き上がれる	起き上がれ
とりこめる	とりこめ
攻める	攻め
待ち焦がれる	待ち焦がれ
にらみ合わす	にらみ合わし
跡づける	跡づけ
よりたおせる	よりたおせ
わりきれる	わりきれ
報ずる	わりきれ
およぶ	および
備わる	備わり
晴れ渡る	晴れ渡り
とりはこべる	とりはこべ
つつみこむ	つつみこみ
てわたせる	てわたせ
値切る	値切り
干す	干し
浮かび上がる	浮かび上がり
おくりかえす	おくりかえし
ふっとぶ	ふっとび
張り合わす	張り合わし
逃げる	逃げ
吹まくる	吹まくり
いいたてる	いいたて
行き届く	行き届き
罹る	罹り
汚れる	汚れ
罷る	罷り
立て掛ける	立て掛け
すむ	すみ
ぎす	ぎし
書散らす	書散らし
涌かす	涌かし
伝える	伝え
そえる	そえ
打ち消せる	打ち消せ
ずらかる	ずらかり
やすらぐ	やすらぎ
はしりさる	はしりさり
乱せる	乱せ
うわまわる	うわまわり
剥く	剥き
巣くう	巣くい
引きずる	引きずり
ゆでこぼす	ゆでこぼし
押切る	押切り
草生す	草生し
撒ける	撒け
昂る	昂り
ひきあわす	ひきあわし
ぬう	ぬい
うらがえる	うらがえり
受け流せる	受け流せ
たでる	たで
つつく	つつき
籠る	籠り
余す	余し
くれのこる	くれのこり
書き入れる	書き入れ
取りつける	取りつけ
飾れる	飾れ
まねきいれる	まねきいれ
買いためる	買いため
ぬぐい取る	ぬぐい取り
焼け付く	焼け付き
衰える	衰え
げすばる	げすばり
言捨てる	言捨て
開け放つ	開け放ち
躍り出る	躍り出
おぼらす	おぼらし
ため込める	ため込め
竄する	ため込め
ぬいあわせる	ぬいあわせ
しゃくれる	しゃくれ
かせげる	かせげ
素っ破抜く	素っ破抜き
突破る	突破り
うつろう	うつろい
もちこたえる	もちこたえ
見合せる	見合せ
なびかす	なびかし
旧る	旧り
行き暮す	行き暮し
食い延す	食い延し
行ける	行け
ごまかす	ごまかし
でっち上げる	でっち上げ
ひびかす	ひびかし
もたらす	もたらし
置く	置き
聞き合わせる	聞き合わせ
さわげる	さわげ
勉める	勉め
ひびわれる	ひびわれ
競い立つ	競い立ち
瞬く	瞬き
売飛ばす	売飛ばし
かどわかす	かどわかし
遷り変る	遷り変り
ささる	ささり
たりる	たり
け落とせる	け落とせ
いきむ	いきみ
攻め上る	攻め上り
みれる	みれ
和する	みれ
ふるい落す	ふるい落し
あおのける	あおのけ
ひきぬける	ひきぬけ
みはれる	みはれ
為成す	為成し
まきちらす	まきちらし
ねじ合う	ねじ合い
なやみぬく	なやみぬき
わたりあえる	わたりあえ
思い切る	思い切り
できあう	できあい
とろける	とろけ
迷う	迷い
おぎなえる	おぎなえ
熾す	熾し
高鳴る	高鳴り
つかわす	つかわし
立まじる	立まじり
渫う	渫い
暮れ残る	暮れ残り
穢す	穢し
組合す	組合し
膨らせる	膨らせ
反らす	反らし
練り歩く	練り歩き
反っくり返る	反っくり返り
使い古す	使い古し
けなす	けなし
措く	措き
踏みやぶる	踏みやぶり
殺気だつ	殺気だち
開く	開き
つけたす	つけたし
ゆき過ぎる	ゆき過ぎ
刑する	ゆき過ぎ
おます	おまし
すみつべる	すみつべ
付き添える	付き添え
うらやむ	うらやみ
しばれる	しばれ
言い触らす	言い触らし
委する	言い触らし
燃やす	燃やし
おしかえす	おしかえし
はせ向う	はせ向い
たどれる	たどれ
ねじる	ねじり
やせおとろえる	やせおとろえ
相うつ	相うち
いいくるめる	いいくるめ
さざめく	さざめき
連れ去る	連れ去り
つらぬける	つらぬけ
熟す	熟し
呼び出せる	呼び出せ
書き表せる	書き表せ
削げる	削げ
つとまる	つとまり
舐る	舐り
涼める	涼め
隠し持てる	隠し持て
切りくずす	切りくずし
眠り込む	眠り込み
つきもどす	つきもどし
打消せる	打消せ
激つ	激ち
さる	さり
混ぜる	混ぜ
言い残す	言い残し
雪崩込む	雪崩込み
登りつめる	登りつめ
銘ずる	登りつめ
ふせる	ふせ
みそなはす	みそなはし
なきしきる	なきしきり
聞きおよぶ	聞きおよび
もどす	もどし
苅る	苅り
押し寄せる	押し寄せ
騒ぎ出す	騒ぎ出し
思う	思い
みくらべる	みくらべ
まわりこむ	まわりこみ
曲がる	曲がり
てびかえる	てびかえ
含む	含み
費える	費え
ずるける	ずるけ
ばたつかせる	ばたつかせ
能くする	ばたつかせ
捩じ上げる	捩じ上げ
くみかわす	くみかわし
煤ける	煤け
入りかわる	入りかわり
見詰める	見詰め
仰せる	仰せ
ひきよせる	ひきよせ
うちかさなる	うちかさなり
獲る	獲
差し遣わす	差し遣わし
温める	温め
吐き出せる	吐き出せ
問合せる	問合せ
満たせる	満たせ
すすり泣く	すすり泣き
ひっこもる	ひっこもり
うなだれる	うなだれ
振り切れる	振り切れ
味わえる	味わえ
摂る	摂り
押しだす	押しだし
ふみこめる	ふみこめ
待ち受ける	待ち受け
事足りる	事足り
とりすがる	とりすがり
喰える	喰え
憾む	憾み
こきまぜる	こきまぜ
済す	済し
抜連ねる	抜連ね
入れ合せる	入れ合せ
天てらす	天てらし
言い旧す	言い旧し
秋めく	秋めき
払い下げる	払い下げ
禁ずる	払い下げ
つりあう	つりあい
あみ出す	あみ出し
封じこむ	封じこみ
ひっつく	ひっつき
なのりでる	なのりで
作り上げる	作り上げ
すみこむ	すみこみ
持あがる	持あがり
吹すさぶ	吹すさび
ランクづける	ランクづけ
野次れる	野次れ
削り倒せる	削り倒せ
切あがる	切あがり
しゃがむ	しゃがみ
突っ転ばす	突っ転ばし
はしれる	はしれ
のぞける	のぞけ
取り抑える	取り抑え
奮いおこす	奮いおこし
つるせる	つるせ
やすんずる	つるせ
充たす	充たし
かけこむ	かけこみ
捲ける	捲け
いたす	いたし
積重なる	積重なり
言いだす	言いだし
燃え立つ	燃え立ち
はきかける	はきかけ
引きしぼる	引きしぼり
経る	経
しでかす	しでかし
交ぜっ返す	交ぜっ返し
欠かす	欠かし
きらめく	きらめき
綯い交ぜる	綯い交ぜ
恥づ	恥ぢ
はき出す	はき出し
引っ提げる	引っ提げ
好く	好き
ぬく	ぬき
鋤き起す	鋤き起し
みいだす	みいだし
撃ち込む	撃ち込み
繰広げる	繰広げ
走りでる	走りで
もうしわたす	もうしわたし
取り次ぐ	取り次ぎ
座れる	座れ
夾める	夾め
ききすます	ききすまし
紛らわす	紛らわし
装束く	装束き
圧する	装束き
ハネ上がる	ハネ上がり
もちさる	もちさり
食荒らす	食荒らし
のみほす	のみほし
取り組む	取り組み
はせる	はせ
ひっ込める	ひっ込め
突き飛ばす	突き飛ばし
当てる	当て
込み入る	込み入り
痛み入る	痛み入り
申しあげる	申しあげ
ではずれる	ではずれ
やすらう	やすらい
即す	即し
ゆりうごかす	ゆりうごかし
律する	ゆりうごかし
言い募る	言い募り
発す	発し
煮え立つ	煮え立ち
まくしたてる	まくしたて
突きだす	突きだし
言張る	言張り
でさかる	でさかり
ききただす	ききただし
書捨てる	書捨て
用立てる	用立て
迷い込む	迷い込み
申し付ける	申し付け
こきつかう	こきつかい
ほころばす	ほころばし
寝っ転がる	寝っ転がり
わだかまる	わだかまり
くじける	くじけ
世離れる	世離れ
しみ付く	しみ付き
すいこめる	すいこめ
剰る	剰り
揺り動かす	揺り動かし
起る	起り
掻い込む	掻い込み
撥ねつける	撥ねつけ
刷り上げる	刷り上げ
恋焦がれる	恋焦がれ
覆す	覆し
脈打つ	脈打ち
包み込める	包み込め
思い煩う	思い煩い
咎める	咎め
ひとなれる	ひとなれ
ぬぐ	ぬぎ
まぜあわす	まぜあわし
ぶらさげる	ぶらさげ
当る	当り
のみこめる	のみこめ
這いまつわる	這いまつわり
ふさぎ込む	ふさぎ込み
つぐなう	つぐない
曲がれる	曲がれ
歩み寄る	歩み寄り
はじらう	はじらい
ちびる	ちび
かき暮れる	かき暮れ
突きぬける	突きぬけ
取立てる	取立て
己惚れる	己惚れ
噛みつく	噛みつき
打返せる	打返せ
からまる	からまり
もとづく	もとづき
まみえる	まみえ
かんする	まみえ
擂る	擂り
薙ぎ払う	薙ぎ払い
高ずる	薙ぎ払い
ゆく	ゆき
かくしもつ	かくしもち
悟れる	悟れ
欠ける	欠け
切離す	切離し
諌む	諌み
めもる	めもり
食い潰す	食い潰し
組み込める	組み込め
もぐる	もぐり
凄む	凄み
おいぼれる	おいぼれ
小切る	小切り
諷する	小切り
否む	否み
くいつなぐ	くいつなぎ
ことたる	ことたり
引っ立てる	引っ立て
そめだせる	そめだせ
ひっかかる	ひっかかり
しぼりだす	しぼりだし
乗り出す	乗り出し
弛む	弛み
とりかわせる	とりかわせ
ききあきる	ききあき
流し込める	流し込め
みせる	みせ
たずねあわせる	たずねあわせ
走り込む	走り込み
ぶっぱなす	ぶっぱなし
おりたつ	おりたち
供える	供え
振り替える	振り替え
笑い返す	笑い返し
憑かれる	憑かれ
とえる	とえ
めく	めき
買い越す	買い越し
むれる	むれ
でんぐり返る	でんぐり返り
書きとる	書きとり
振払う	振払い
引き起こす	引き起こし
降り暮す	降り暮し
よづく	よづき
にらみあわせる	にらみあわせ
みかわす	みかわし
もちまわる	もちまわり
節くれだつ	節くれだち
増やせる	増やせ
のぞかせる	のぞかせ
そよがす	そよがし
退る	退り
紛れこむ	紛れこみ
繰上げる	繰上げ
くっつく	くっつき
ばらす	ばらし
かんぐる	かんぐり
解きほぐす	解きほぐし
おどりあがる	おどりあがり
彌次る	彌次り
せまる	せまり
列ねる	列ね
うつ向く	うつ向き
溶合う	溶合い
配れる	配れ
ずりあがる	ずりあがり
困りきる	困りきり
謂う	謂い
うちつれる	うちつれ
打くつろぐ	打くつろぎ
安んずる	打くつろぎ
いいあう	いいあい
おこなう	おこない
示し合せる	示し合せ
しなす	しなし
たたきおこせる	たたきおこせ
向かい合う	向かい合い
飲み回す	飲み回し
評する	飲み回し
言い返す	言い返し
立直る	立直り
遠ざかる	遠ざかり
くりぬける	くりぬけ
とり除く	とり除き
みかねる	みかね
びくつく	びくつき
ぎょする	びくつき
振りまわす	振りまわし
けつまずく	けつまずき
のぼりつめるる	のぼりつめる
支える	支え
にらみあう	にらみあい
割振る	割振り
われる	われ
行き当る	行き当り
切りつける	切りつけ
引き起す	引き起し
売りまくれる	売りまくれ
狂する	売りまくれ
厭く	厭き
住替る	住替り
うかれる	うかれ
折り畳める	折り畳め
しょうじいれる	しょうじいれ
あそびほうける	あそびほうけ
見分ける	見分け
慰む	慰み
立上がる	立上がり
あたえる	あたえ
駆けずりまわる	駆けずりまわり
項垂れる	項垂れ
ふるまう	ふるまい
かたぶく	かたぶき
おさえつける	おさえつけ
探し求める	探し求め
投ずる	探し求め
まげる	まげ
点てる	点て
蹴っとばす	蹴っとばし
富める	富め
片づく	片づき
作り替える	作り替え
おもいたつ	おもいたち
祷れる	祷れ
まとめる	まとめ
だしきる	だしきり
させる	させ
とびちがう	とびちがい
かけよる	かけより
うちぬける	うちぬけ
つみかえる	つみかえ
けし飛ぶ	けし飛び
もちかける	もちかけ
呼び戻せる	呼び戻せ
浮かぶ	浮かび
そだてる	そだて
うちこむ	うちこみ
しっける	しっけ
飛び越せる	飛び越せ
くつがえす	くつがえし
かんづく	かんづき
忍び泣く	忍び泣き
いきあたる	いきあたり
めくる	めくり
つきだす	つきだし
責める	責め
咲におう	咲におい
くらます	くらまし
うらなう	うらない
言付かる	言付かり
バラつく	バラつき
始める	始め
引き止める	引き止め
引っかかる	引っかかり
製する	引っかかり
寝ぼける	寝ぼけ
尽かす	尽かし
そらんずる	尽かし
搗く	搗き
思いやる	思いやり
引受ける	引受け
はきかえる	はきかえ
だきつく	だきつき
醸し出せる	醸し出せ
来合せる	来合せ
睨み合せる	睨み合せ
すくむ	すくみ
さませる	さませ
ならせる	ならせ
燃え広がる	燃え広がり
紛れ込む	紛れ込み
張り足す	張り足し
垂こめる	垂こめ
漉せる	漉せ
打抜ける	打抜け
はさまる	はさまり
差っ引く	差っ引き
炊く	炊き
とりおく	とりおき
倦む	倦み
組み合う	組み合い
つくばう	つくばい
立ちはだかる	立ちはだかり
打ち返せる	打ち返せ
繰り出す	繰り出し
ちかよせる	ちかよせ
噛む	噛み
べんずる	噛み
わりふれる	わりふれ
計らう	計らい
駁する	計らい
力づける	力づけ
書きたてる	書きたて
せおいこむ	せおいこみ
乗りかかる	乗りかかり
取り除ける	取り除け
らっしゃる	らっしゃい
見下ろす	見下ろし
召し寄せる	召し寄せ
浮かべる	浮かべ
あばれる	あばれ
醒める	醒め
つくりあげる	つくりあげ
憎む	憎み
こけむす	こけむし
突付ける	突付け
きざみつける	きざみつけ
すり混ぜる	すり混ぜ
こわせる	こわせ
塗りつぶす	塗りつぶし
ほける	ほけ
おもいなおせる	おもいなおせ
押しつぶせる	押しつぶせ
引きだす	引きだし
あむ	あみ
はしりまわる	はしりまわり
すくいだせる	すくいだせ
開き直る	開き直り
打連れる	打連れ
わきばさむ	わきばさみ
おもいとどまる	おもいとどまり
だしきれる	だしきれ
下る	下り
鯱張る	鯱張り
覆る	覆り
ふきでる	ふきで
とりころす	とりころし
ながしこむ	ながしこみ
受けあう	受けあい
おっぱらう	おっぱらい
積める	積め
清める	清め
有る	有り
到る	到り
吸いつける	吸いつけ
取り離す	取り離し
突きあわせる	突きあわせ
貼る	貼り
片づける	片づけ
おっことす	おっことし
掻きまぜる	掻きまぜ
がんばれる	がんばれ
撤する	がんばれ
飛び出でる	飛び出で
追い込む	追い込み
きたえる	きたえ
取り外す	取り外し
ふみにじれる	ふみにじれ
さしひびく	さしひびき
放りだす	放りだし
ゆらす	ゆらし
けたてる	けたて
立ちあがる	立ちあがり
くりこめる	くりこめ
さけべる	さけべ
きめこむ	きめこみ
飛び越す	飛び越し
しむ	しみ
だせる	だせ
霜がれる	霜がれ
だっする	霜がれ
ふやせる	ふやせ
言い誤る	言い誤り
引っ越す	引っ越し
あるきまわれる	あるきまわれ
むしかえす	むしかえし
のりきれる	のりきれ
打立てる	打立て
合す	合し
とりのぼせる	とりのぼせ
やり直せる	やり直せ
務まる	務まり
炊ける	炊け
かう	かい
ぬげる	ぬげ
数えたてる	数えたて
きりすてる	きりすて
見出す	見出し
うえつける	うえつけ
くちごもる	くちごもり
こう	こい
読みかける	読みかけ
おだてる	おだて
とじこむ	とじこみ
ゆう	ゆい
綴じる	綴じ
悦に入る	悦に入り
せせら笑う	せせら笑い
申し上げる	申し上げ
寝過ごす	寝過ごし
作りだす	作りだし
うちとれる	うちとれ
たしかめる	たしかめ
なづける	なづけ
あっする	なづけ
きわだつ	きわだち
打合わす	打合わし
けんする	打合わし
そい遂げる	そい遂げ
推し移る	推し移り
擦れあう	擦れあい
相成る	相成り
口走る	口走り
為損なう	為損ない
変わる	変わり
抑える	抑え
継ぎ足せる	継ぎ足せ
振向ける	振向け
溶かせる	溶かせ
打ちつける	打ちつけ
煤ばむ	煤ばみ
よろめく	よろめき
見切れる	見切れ
とり上げる	とり上げ
虐げる	虐げ
おいもとめる	おいもとめ
燻らす	燻らし
立ち直る	立ち直り
ふりはらう	ふりはらい
すくみあがる	すくみあがり
とりあわせる	とりあわせ
突っきる	突っきり
誘く	誘き
漬ける	漬け
そわる	そわり
つみたてる	つみたて
はかどる	はかどり
萌す	萌し
きりとる	きりとり
あやまらす	あやまらし
乾く	乾き
打砕ける	打砕け
たのみこめる	たのみこめ
並び立てる	並び立て
痛む	痛み
冒す	冒し
買いたたく	買いたたき
選びだす	選びだし
渡り歩く	渡り歩き
張り切れる	張り切れ
爪繰る	爪繰り
取りのける	取りのけ
切放す	切放し
いつくしむ	いつくしみ
ゆきとどく	ゆきとどき
ぐちる	ぐちり
耳だつ	耳だち
またせる	またせ
さがしあてる	さがしあて
成り変わる	成り変わり
待たす	待たし
みはる	みはり
そめつける	そめつけ
取り仕切る	取り仕切り
呪う	呪い
とりよせる	とりよせ
さそいだせる	さそいだせ
すいよせる	すいよせ
汲みだす	汲みだし
立て直せる	立て直せ
うごける	うごけ
うずまる	うずまり
しらける	しらけ
零れる	零れ
くける	くけ
けずる	けずり
おしつぶせる	おしつぶせ
明け暮れる	明け暮れ
おどりあかす	おどりあかし
勇み立つ	勇み立ち
ふるえ上がる	ふるえ上がり
塞げる	塞げ
かすめる	かすめ
乗りこなせる	乗りこなせ
抉る	抉り
差し上げる	差し上げ
行きあたる	行きあたり
薄らぐ	薄らぎ
救ける	救け
きりそろえる	きりそろえ
ぬらつく	ぬらつき
けどる	けどり
成りすます	成りすまし
移す	移し
推せる	推せ
当て嵌る	当て嵌り
はり合う	はり合い
馴れあう	馴れあい
繰越す	繰越し
刈り取る	刈り取り
ぬりたくる	ぬりたくり
見霽かす	見霽かし
断ち切る	断ち切り
捲したてる	捲したて
まとめあげる	まとめあげ
うちみる	うちみ
添わせる	添わせ
釣上がる	釣上がり
すみつぶ	すみつび
こぎつく	こぎつき
涙す	涙し
待ち合わせる	待ち合わせ
くみだす	くみだし
貼れる	貼れ
願える	願え
詰め寄る	詰め寄り
ゆき着く	ゆき着き
属す	属し
通える	通え
焼き切る	焼き切り
干上がる	干上がり
縫い合わす	縫い合わし
かたりあう	かたりあい
しおたれる	しおたれ
断ずる	しおたれ
うきあしだつ	うきあしだち
そぼつ	そぼち
おしひろめる	おしひろめ
追付く	追付き
急き込む	急き込み
射すくめる	射すくめ
話しこむ	話しこみ
うらがれる	うらがれ
煮えくり返る	煮えくり返り
組立てる	組立て
煌む	煌み
おもいかえす	おもいかえし
捧げる	捧げ
すく	すき
会う	会い
はんする	会い
つかみあう	つかみあい
はらいだせる	はらいだせ
いきおいづく	いきおいづき
剪む	剪み
泣きじゃくる	泣きじゃくり
とびまわれる	とびまわれ
押し開く	押し開き
くだける	くだけ
そめる	そめ
上げる	上げ
溯る	溯り
長らえる	長らえ
ちらかる	ちらかり
相継ぐ	相継ぎ
引越す	引越し
ふりさけみる	ふりさけみ
ちらつく	ちらつき
透る	透り
ほお張る	ほお張り
干割れる	干割れ
骨張る	骨張り
打ち破れる	打ち破れ
こする	打ち破れ
尋ね合せる	尋ね合せ
成り代わる	成り代わり
まがれる	まがれ
とりくずす	とりくずし
揺るぐ	揺るぎ
略せる	略せ
かまえる	かまえ
組み伏せる	組み伏せ
具する	組み伏せ
傾く	傾き
生き残る	生き残り
のし上がれる	のし上がれ
命ずる	のし上がれ
よろこぶ	よろこび
狩る	狩り
繋がる	繋がり
すぼむ	すぼみ
ねらいうてる	ねらいうて
さわがす	さわがし
竦める	竦め
そぼ降る	そぼ降り
うりこめる	うりこめ
負う	負い
くすぶる	くすぶり
みなれる	みなれ
知り抜く	知り抜き
とりまく	とりまき
こころざす	こころざし
吹雪く	吹雪き
用だつ	用だち
もどれる	もどれ
ころげこむ	ころげこみ
くいとめる	くいとめ
かんれんづける	かんれんづけ
曲る	曲り
出会す	出会し
透す	透し
涙する	透し
そうなる	そうなり
生き返る	生き返り
損ずる	生き返り
鋏む	鋏み
軋る	軋り
おじゃる	おじゃり
やって退ける	やって退け
さらす	さらし
いんしょうづける	いんしょうづけ
いからせる	いからせ
似せる	似せ
立ち代る	立ち代り
みやぶる	みやぶり
まぎらす	まぎらし
ささやきあう	ささやきあい
身じろぐ	身じろぎ
しりぞく	しりぞき
おきだせる	おきだせ
記す	記し
攻め落とせる	攻め落とせ
そそぎいれる	そそぎいれ
透き通る	透き通り
かいこむ	かいこみ
みせかける	みせかけ
片付く	片付き
釣上げる	釣上げ
のける	のけ
おもいしらせる	おもいしらせ
やせ細る	やせ細り
理解し合える	理解し合え
ていぎづける	ていぎづけ
つなぎとめる	つなぎとめ
残せる	残せ
突放す	突放し
請する	突放し
落とせる	落とせ
縮らす	縮らし
うつ伏す	うつ伏し
絶え果てる	絶え果て
起きあがれる	起きあがれ
まつれる	まつれ
でる	で
力む	力み
ダブる	ダブり
一皮むける	一皮むけ
糺す	糺し
抜きだす	抜きだし
逃げ切る	逃げ切り
すべれる	すべれ
突っ撥ねる	突っ撥ね
秀でる	秀で
つけ狙う	つけ狙い
抱込む	抱込み
きっする	抱込み
泣かせる	泣かせ
打ち据える	打ち据え
酔潰れる	酔潰れ
捜し出す	捜し出し
たたす	たたし
くるめく	くるめき
充つ	充ち
巫山戯る	巫山戯
暴く	暴き
蹴上げる	蹴上げ
咲き揃う	咲き揃い
そぐう	そぐい
捏ち上げる	捏ち上げ
躍り上がる	躍り上がり
乗りかえる	乗りかえ
約める	約め
読み取れる	読み取れ
漂わす	漂わし
あせする	漂わし
瞑する	漂わし
けおとせる	けおとせ
めぐる	めぐり
きりはなせる	きりはなせ
差替える	差替え
もちこせる	もちこせ
打ち払う	打ち払い
たえしのべる	たえしのべ
坐り込む	坐り込み
読みふける	読みふけり
かじける	かじけ
聞入れる	聞入れ
呻く	呻き
けんしきばる	けんしきばり
書き込む	書き込み
仄めく	仄めき
滲みる	滲み
言える	言え
解き離す	解き離し
口説き落とす	口説き落とし
引回す	引回し
買い取れる	買い取れ
出し抜く	出し抜き
めんずる	出し抜き
立迷う	立迷い
いいはなつ	いいはなち
すかす	すかし
やくだつ	やくだち
消え去る	消え去り
待ちこがれる	待ちこがれ
長びく	長びき
しぼりとる	しぼりとり
斎う	斎い
脂下がる	脂下がり
かきしるす	かきしるし
知ろし食す	知ろし食し
やきはらう	やきはらい
めぐむ	めぐみ
働かす	働かし
手間どる	手間どり
呟く	呟き
投げだす	投げだし
かぶる	かぶり
くりゃる	くりゃり
凍る	凍り
書き出す	書き出し
喋る	喋り
へいする	喋り
言い表す	言い表し
ふきこぼれる	ふきこぼれ
疵付ける	疵付け
はねあげる	はねあげ
吹飛ばす	吹飛ばし
有りふれる	有りふれ
行き詰る	行き詰り
りきむ	りきみ
おもいとまる	おもいとまり
にたつ	にたち
追っ掛ける	追っ掛け
しめる	しめり
侍る	侍り
しおる	しおり
へるる	へる
攻め立てる	攻め立て
ついやす	ついやし
づく	づき
説き付ける	説き付け
振り出す	振り出し
おどりこむ	おどりこみ
吟ずる	おどりこみ
篭める	篭め
近寄れる	近寄れ
きばれる	きばれ
すみきる	すみきり
訪ねる	訪ね
そわせる	そわせ
しのばせる	しのばせ
接ぐ	接ぎ
たぐる	たぐり
せぎる	せぎり
耐える	耐え
よりあう	よりあい
あいてどる	あいてどり
攻寄せる	攻寄せ
棚びく	棚びき
うながす	うながし
射止める	射止め
担ぐ	担ぎ
よびたてる	よびたて
落ち着ける	落ち着け
吊るせる	吊るせ
広める	広め
うらがえす	うらがえし
ねむる	ねむり
ふんぞり返る	ふんぞり返り
骨折る	骨折り
托す	托し
どく	どき
さんじる	さんじ
撃ち取る	撃ち取り
取りあつめる	取りあつめ
並み居る	並み居
集める	集め
給わる	給わり
逢える	逢え
端折る	端折り
たちわる	たちわり
取崩す	取崩し
あるきはじめる	あるきはじめ
ひきしめる	ひきしめ
かきなす	かきなし
決めつける	決めつけ
くみいれる	くみいれ
はげる	はげ
めぐまれる	めぐまれ
為る	為り
強がる	強がり
鳴らせる	鳴らせ
舁く	舁き
かきくだす	かきくだし
浮かれだす	浮かれだし
達す	達し
つるむ	つるみ
詰め切る	詰め切り
訳する	詰め切り
淀む	淀み
はなしあう	はなしあい
かっぱらう	かっぱらい
聞き出す	聞き出し
持ち堪える	持ち堪え
たばさむ	たばさみ
切り落とせる	切り落とせ
散らかる	散らかり
載っける	載っけ
笑い飛ばす	笑い飛ばし
かいする	笑い飛ばし
かきならす	かきならし
吹こぼれる	吹こぼれ
考え出せる	考え出せ
よくする	考え出せ
裁く	裁き
ふみやぶる	ふみやぶり
組み付く	組み付き
繰り広げる	繰り広げ
きりつめる	きりつめ
翳す	翳し
閊える	閊え
さす	さし
ききかじる	ききかじり
欹てる	欹て
投棄てる	投棄て
かたる	かたり
馨る	馨り
おほとのごもる	おほとのごもり
かち取れる	かち取れ
存える	存え
さまよえる	さまよえ
切りとる	切りとり
ゆがく	ゆがき
すれる	すれ
徹する	すれ
燃え付く	燃え付き
かどばる	かどばり
まいる	まいり
結び付く	結び付き
気負い立つ	気負い立ち
組みつける	組みつけ
代われる	代われ
舞える	舞え
しみ入る	しみ入り
つきたてる	つきたて
入りこむ	入りこみ
包む	包み
咬める	咬め
飾りつける	飾りつけ
はらだてる	はらだて
あえぐ	あえぎ
鳴り渡る	鳴り渡り
執り行える	執り行え
忍ばす	忍ばし
召捕る	召捕り
突き通す	突き通し