引き込む	引き込め
すきかえす	すきかえせ
看取る	看取れ
睦む	睦め
きこす	きこせ
つける	つけろ
封切る	封切れ
逃げまどう	逃げまどえ
さしだす	さしだせ
わりきる	わりきれ
飛び抜ける	飛び抜けろ
書き直せる	書き直せろ
ひしめきあう	ひしめきあえ
乗り組む	乗り組め
引き戻す	引き戻せ
持てる	持てろ
立あう	立あえ
基づく	基づけ
弓引く	弓引け
ぶち壊す	ぶち壊せ
わきあがる	わきあがれ
語りつぐ	語りつげ
問掛ける	問掛けろ
狙われる	狙われろ
埋めあわす	埋めあわせ
喚ぶ	喚べ
しりぞける	しりぞけろ
こす	こせ
大人ぶる	大人ぶれ
居る	居ろ
ねじふせる	ねじふせろ
しゃくりあげる	しゃくりあげろ
にごせる	にごせろ
較べる	較べろ
罷り越す	罷り越せ
射せる	射せろ
描きだす	描きだせ
けっとばす	けっとばせ
満つ	満て
明け放す	明け放せ
返り咲ける	返り咲けろ
誘い合わせる	誘い合わせろ
つきつける	つきつけろ
埋る	埋れ
かき乱す	かき乱せ
だまし取る	だまし取れ
配り歩く	配り歩け
抱き込む	抱き込め
めしあがる	めしあがれ
つうずる	めしあがれ
ずば抜ける	ずば抜けろ
泣きぬれる	泣きぬれろ
くしけずる	くしけずれ
つみとる	つみとれ
割戻す	割戻せ
さだまる	さだまれ
睨み合う	睨み合え
かわれる	かわれろ
そむ	そめ
後らす	後らせ
ごわする	ごわしろ
迷わす	迷わせ
泥む	泥め
仕出す	仕出せ
おくする	おくしろ
逆らえる	逆らえろ
居あわせる	居あわせろ
苛立つ	苛立て
堕ちる	堕ちろ
慮る	慮れ
怖じ気立つ	怖じ気立て
きずく	きずけ
とりあつかえる	とりあつかえろ
扱き雑ぜる	扱き雑ぜろ
はじける	はじけろ
ふしおがむ	ふしおがめ
黙る	黙れ
のめす	のめせ
危ぶむ	危ぶめ
いりびたる	いりびたれ
洗い流す	洗い流せ
呉れる	呉れろ
定まる	定まれ
ばかせる	ばかせろ
語りあう	語りあえ
敬える	敬えろ
食らわせる	食らわせろ
わたる	わたれ
いいまわす	いいまわせ
打ち抜ける	打ち抜けろ
ヒネる	ヒネれ
転げでる	転げでろ
打ちのめす	打ちのめせ
思い合せる	思い合せろ
萎れる	萎れろ
総べる	総べろ
鳴らす	鳴らせ
貸出す	貸出せ
差し換える	差し換えろ
もぐり込む	もぐり込め
睨む	睨め
打ちつづく	打ちつづけ
おいかける	おいかけろ
ふりつもる	ふりつもれ
かわく	かわけ
はしりだせる	はしりだせろ
省みる	省みろ
出合う	出合え
といかえす	といかえせ
かぶさる	かぶされ
こづく	こづけ
這う	這え
縫う	縫え
降込む	降込め
はめこむ	はめこめ
すみわたる	すみわたれ
いふ	いへ
思へる	思へろ
刷りこむ	刷りこめ
くらわせる	くらわせろ
ゆすぶる	ゆすぶれ
触れ合える	触れ合えろ
はねあがる	はねあがれ
察する	察しろ
ころげおちる	ころげおちろ
すぐす	すぐせ
押しかえす	押しかえせ
ただよわす	ただよわせ
結論づける	結論づけろ
しばり上げる	しばり上げろ
欠く	欠け
乗り継ぐ	乗り継げ
ひめる	ひめろ
むせびなく	むせびなけ
やじる	やじれ
けっする	けっしろ
みかぎる	みかぎれ
わりあてる	わりあてろ
かき立てる	かき立てろ
あわてふためく	あわてふためけ
吸付ける	吸付けろ
ごねる	ごねろ
ほざく	ほざけ
せめぐ	せめげ
食さがる	食さがれ
追い打つ	追い打て
休まれる	休まれろ
動じる	動じろ
染まる	染まれ
立ち迷う	立ち迷え
染め上げる	染め上げろ
たちむかう	たちむかえ
はかれる	はかれろ
巻き付く	巻き付け
光らせる	光らせろ
挫ける	挫けろ
燃え移る	燃え移れ
鈍する	鈍しろ
ふくれあがる	ふくれあがれ
いいそこなう	いいそこなえ
ぶんなげる	ぶんなげろ
生い立つ	生い立て
ごたつく	ごたつけ
うろたえる	うろたえろ
燃える	燃えろ
はむかう	はむかえ
推する	推しろ
取逃す	取逃せ
乗り通す	乗り通せ
よそおう	よそおえ
さむけだつ	さむけだて
こぼれおちる	こぼれおちろ
かいつくす	かいつくせ
祀る	祀れ
痛め付ける	痛め付けろ
持ちきる	持ちきれ
疑える	疑えろ
掻き曇る	掻き曇れ
返り咲く	返り咲け
うばえる	うばえろ
願い出る	願い出ろ
落ち延びる	落ち延びろ
辱める	辱めろ
おったてる	おったてろ
編み出す	編み出せ
呼び止める	呼び止めろ
澄みきる	澄みきれ
踏みきる	踏みきれ
寄り付く	寄り付け
だきこむ	だきこめ
轟かせる	轟かせろ
仰ける	仰けろ
毒する	毒しろ
かかえる	かかえろ
ほふる	ほふれ
捻る	捻れ
触り合う	触り合え
角張る	角張れ
悦ぶ	悦べ
いちづける	いちづけろ
仕込める	仕込めろ
くいこめる	くいこめろ
組みこむ	組みこめ
おそう	おそえ
あつかえる	あつかえろ
嘱する	嘱しろ
なげきくらす	なげきくらせ
けやぶる	けやぶれ
つくりなおす	つくりなおせ
まるめる	まるめろ
しびれる	しびれろ
溶けあう	溶けあえ
突き合わす	突き合わせ
はぐる	はぐれ
頼む	頼め
ゆがむ	ゆがめ
はみ出る	はみ出ろ
あおむ	あおめ
玩ぶ	玩べ
裁てる	裁てろ
ちりいそぐ	ちりいそげ
棚引く	棚引け
引き下がる	引き下がれ
てぐすねひく	てぐすねひけ
括れる	括れろ
引き締まる	引き締まれ
参れる	参れろ
立ちならぶ	立ちならべ
そらうそぶく	そらうそぶけ
羨む	羨め
ふきかえす	ふきかえせ
はぐ	はげ
みはらす	みはらせ
けおされる	けおされろ
洒落れる	洒落れろ
おもいやる	おもいやれ
ふとる	ふとれ
ちぢらす	ちぢらせ
うちまくる	うちまくれ
明け残る	明け残れ
ひきわたす	ひきわたせ
ならびたてる	ならびたてろ
書き出せる	書き出せろ
聞きつける	聞きつけろ
研ぐ	研げ
つきはなせる	つきはなせろ
萌む	萌め
ませる	ませろ
折り込める	折り込めろ
ふり入れる	ふり入れろ
押し分ける	押し分けろ
見慣れる	見慣れろ
跳ねのける	跳ねのけろ
染む	染め
訃ぐ	訃げ
拒める	拒めろ
貫き通せる	貫き通せろ
くねる	くねれ
ふりやむ	ふりやめ
ゆらぐ	ゆらげ
読み切れる	読み切れろ
ようだつ	ようだて
またす	またせ
畳み込める	畳み込めろ
掛け合える	掛け合えろ
誘い出す	誘い出せ
のりまわす	のりまわせ
ほぐせる	ほぐせろ
ぜっする	ぜっしろ
蔵する	蔵しろ
食い違う	食い違え
印す	印せ
手古摺る	手古摺れ
まびける	まびけろ
わりこむ	わりこめ
しくむ	しくめ
怪しむ	怪しめ
締めつける	締めつけろ
受ける	受けろ
立ちどまる	立ちどまれ
はいりきる	はいりきれ
証す	証せ
漕げる	漕げろ
捜しまわる	捜しまわれ
ゆきわたる	ゆきわたれ
相入れる	相入れろ
奏す	奏せ
悦べる	悦べろ
料る	料れ
吸い寄せる	吸い寄せろ
せぐくまる	せぐくまれ
よえる	よえろ
阻める	阻めろ
くるわす	くるわせ
わすれさる	わすれされ
隠る	隠れ
おもいのこす	おもいのこせ
探し出せる	探し出せろ
成さがる	成さがれ
およげる	およげろ
引き換える	引き換えろ
引き離せる	引き離せろ
さえわたる	さえわたれ
抱き起こせる	抱き起こせろ
むち打つ	むち打て
抗う	抗え
しょげかえる	しょげかえれ
取り調べる	取り調べろ
捕われる	捕われろ
なる	なれ
ふししずむ	ふししずめ
寂する	寂しろ
取り持つ	取り持て
おもいあたる	おもいあたれ
語りかける	語りかけろ
引っ越せる	引っ越せろ
おもいなす	おもいなせ
けす	けせ
ぎらつく	ぎらつけ
きりくむ	きりくめ
刻める	刻めろ
世ばなれる	世ばなれろ
ひっくくる	ひっくくれ
そぼぬれる	そぼぬれろ
教え諭す	教え諭せ
織り込める	織り込めろ
仰け反る	仰け反れ
けがれる	けがれろ
聞漏らす	聞漏らせ
あざける	あざけれ
飼う	飼え
引っ括める	引っ括めろ
ひょうげる	ひょうげろ
延べる	延べろ
かけ隔てる	かけ隔てろ
播く	播け
かすめ取る	かすめ取れ
くだす	くだせ
角立つ	角立て
ほこる	ほこれ
芽ぶく	芽ぶけ
疲れはてる	疲れはてろ
くわわる	くわわれ
追い付く	追い付け
差し上る	差し上れ
踏ん切る	踏ん切れ
ぬきはなつ	ぬきはなて
言い付ける	言い付けろ
そよ吹く	そよ吹け
ぼる	ぼれ
蹲る	蹲れ
繰下げる	繰下げろ
率いる	率いろ
化かす	化かせ
労する	労しろ
持ちかえれる	持ちかえれろ
つぎたす	つぎたせ
住成す	住成せ
締切る	締切れ
挙がる	挙がれ
突っぱる	突っぱれ
出歩ける	出歩けろ
せる	せれ
躙り寄る	躙り寄れ
排す	排せ
いさよう	いさよえ
飲み潰す	飲み潰せ
迎える	迎えろ
参らす	参らせ
張りつく	張りつけ
にげまわる	にげまわれ
押掛ける	押掛けろ
掻き集める	掻き集めろ
住みつぶ	住みつべ
妬む	妬め
愁える	愁えろ
はりつめる	はりつめろ
追い立てる	追い立てろ
そりかえる	そりかえれ
演ずる	そりかえれ
取り立てる	取り立てろ
縁どる	縁どれ
侍れる	侍れろ
飛び跳ねる	飛び跳ねろ
つかいこむ	つかいこめ
忌む	忌め
ひとかわむける	ひとかわむけろ
くりよせる	くりよせろ
掛け離れる	掛け離れろ
立替える	立替えろ
蹴落す	蹴落せ
寝そべる	寝そべれ
ひいでる	ひいでろ
ほりつける	ほりつけろ
拾う	拾え
もうしかねる	もうしかねろ
明るむ	明るめ
張詰める	張詰めろ
吸いこむ	吸いこめ
流れ着く	流れ着け
降り懸る	降り懸れ
植わる	植われ
追いやれる	追いやれろ
すり付ける	すり付けろ
乗りつける	乗りつけろ
飛あがる	飛あがれ
いきおいづける	いきおいづけろ
もどく	もどけ
うつむける	うつむけろ
たもちあう	たもちあえ
かっきづく	かっきづけ
取れる	取れろ
語り合う	語り合え
討ち果たす	討ち果たせ
まわす	まわせ
たちあがれる	たちあがれろ
取り毀す	取り毀せ
跡絶える	跡絶えろ
裏がえる	裏がえれ
解明かす	解明かせ
加え持つ	加え持て
あてこめる	あてこめろ
せき立てる	せき立てろ
くちる	くちろ
きがえる	きがえろ
輝り返す	輝り返せ
じれる	じれろ
やっかむ	やっかめ
あそびまわれる	あそびまわれろ
書入れる	書入れろ
のり出す	のり出せ
あてはまる	あてはまれ
ふえる	ふえろ
折れ曲がる	折れ曲がれ
惜しむ	惜しめ
かきおくる	かきおくれ
つきさせる	つきさせろ
ひりつく	ひりつけ
うかす	うかせ
薫ずる	うかせ
めしあげる	めしあげろ
ききかえす	ききかえせ
焼け出す	焼け出せ
掛ける	掛けろ
置忘れる	置忘れろ
筋ばる	筋ばれ
浮腫む	浮腫め
散らばる	散らばれ
与する	与しろ
負かる	負かれ
願える	願えろ
重なる	重なれ
弑する	弑しろ
つんざく	つんざけ
読通す	読通せ
まるめこむ	まるめこめ
息張る	息張れ
きおう	きおえ
直る	直れ
回り込む	回り込め
つんのめる	つんのめれ
おいしげる	おいしげれ
屈む	屈め
孵す	孵せ
取散らす	取散らせ
つぎあわせる	つぎあわせろ
まちあわせる	まちあわせろ
思い起す	思い起せ
決める	決めろ
漉く	漉け
引きおこす	引きおこせ
貧する	貧しろ
まるまる	まるまれ
うまれかわる	うまれかわれ
さきでる	さきでろ
突き合せる	突き合せろ
しわめる	しわめろ
出し切れる	出し切れろ
居直る	居直れ
よびだせる	よびだせろ
なんなんとする	なんなんとしろ
出会う	出会え
叶える	叶えろ
かいくぐる	かいくぐれ
遵う	遵え
混ざる	混ざれ
ずり落ちる	ずり落ちろ
挙げる	挙げろ
減る	減れ
はきちがえる	はきちがえろ
解け合う	解け合え
せぐりあげる	せぐりあげろ
みまわる	みまわれ
飲み込める	飲み込めろ
拭き込む	拭き込め
田舎びる	田舎びろ
かもしだせる	かもしだせろ
行なう	行なえ
うるおす	うるおせ
とがらす	とがらせ
来あわす	来あわせ
みせつける	みせつけろ
かたよせる	かたよせろ
拒む	拒め
閉じ込もる	閉じ込もれ
かりとる	かりとれ
おびやかす	おびやかせ
比す	比せ
仕損じる	仕損じろ
打切れる	打切れろ
息巻く	息巻け
追っ払う	追っ払え
扠置く	扠置け
飛びのる	飛びのれ
さかのぼる	さかのぼれ
休らう	休らえ
生れかわる	生れかわれ
かきたてる	かきたてろ
くっつける	くっつけろ
寝とぼける	寝とぼけろ
擂れる	擂れろ
瀬切る	瀬切れ
試せる	試せろ
託す	託せ
洩る	洩れ
向ける	向けろ
ぬすめる	ぬすめろ
つれそう	つれそえ
もりたてる	もりたてろ
ふみこたえる	ふみこたえろ
とりあつめる	とりあつめろ
哮る	哮れ
見初める	見初めろ
突っ返す	突っ返せ
立ち退ける	立ち退けろ
寝ころぶ	寝ころべ
試す	試せ
だきあわせる	だきあわせろ
てっする	てっしろ
しのげる	しのげろ
チラつく	チラつけ
書抜く	書抜け
後ずさる	後ずされ
起す	起せ
さえずる	さえずれ
裂く	裂け
そこなう	そこなえ
みいる	みいれ
突ぷす	突ぷせ
はじき出す	はじき出せ
うめこむ	うめこめ
出ばる	出ばれ
乗り切れる	乗り切れろ
ふくせる	ふくせろ
かいもどす	かいもどせ
仕舞う	仕舞え
かける	かけろ
往ぬ	往ね
聞える	聞えろ
読替える	読替えろ
はこびこむ	はこびこめ
暇どる	暇どれ
頂ける	頂けろ
競り落す	競り落せ
立込む	立込め
晴あがる	晴あがれ
費す	費せ
けたおす	けたおせ
いいのこす	いいのこせ
きりだす	きりだせ
とりくずせる	とりくずせろ
くいあう	くいあえ
ほそめる	ほそめろ
切取る	切取れ
吐く	吐け
のろける	のろけろ
しろしめす	しろしめせ
じする	じしろ
具える	具えろ
取りこむ	取りこめ
渡せる	渡せろ
ほめそやす	ほめそやせ
彩れる	彩れろ
むくむ	むくめ
与る	与れ
そろえる	そろえろ
ねがう	ねがえ
嵌る	嵌れ
沖する	沖しろ
持する	持しろ
もがく	もがけ
おれ込む	おれ込め
運び出す	運び出せ
いがみあう	いがみあえ
はさみ切る	はさみ切れ
ふんだくる	ふんだくれ
まなべる	まなべろ
にごる	にごれ
すきこのむ	すきこのめ
座す	座せ
頑ばる	頑ばれ
ずぬける	ずぬけろ
縛りつける	縛りつけろ
くみ取る	くみ取れ
履く	履け
とりおさえる	とりおさえろ
話し込む	話し込め
駆立てる	駆立てろ
のりつぐ	のりつげ
あらす	あらせ
はきだす	はきだせ
いたむ	いため
売りはらう	売りはらえ
ひきかえる	ひきかえろ
ふりしきる	ふりしきれ
やすまる	やすまれ
きたす	きたせ
ようする	ようしろ
かきしるせる	かきしるせろ
はせむかう	はせむかえ
近寄せる	近寄せろ
錬れる	錬れろ
挙る	挙れ
差回す	差回せ
鬱ぐ	鬱げ
含まる	含まれ
遷す	遷せ
練る	練れ
寛げる	寛げろ
ころがりこむ	ころがりこめ
汲み取れる	汲み取れろ
仕掛ける	仕掛けろ
めさる	めされ
はいる	はいれ
造る	造れ
抱留める	抱留めろ
啜り上げる	啜り上げろ
堕す	堕せ
はやまる	はやまれ
入りびたる	入りびたれ
つったてる	つったてろ
きわだたす	きわだたせ
みせびらかす	みせびらかせ
めあわせる	めあわせろ
あやしむ	あやしめ
乞う	乞え
あざなう	あざなえ
切り回す	切り回せ
ながれでる	ながれでろ
伴う	伴え
宛てがう	宛てがえ
取り直す	取り直せ
摘む	摘め
見て取る	見て取れ
ひっかつぐ	ひっかつげ
引具する	引具しろ
引き伸ばせる	引き伸ばせろ
考えつく	考えつけ
しわる	しわれ
揺する	揺すれ
みちたりる	みちたりろ
聞返す	聞返せ
作る	作れ
くやむ	くやめ
ふり向く	ふり向け
手折る	手折れ
ぬえる	ぬえろ
残れる	残れろ
下さる	下され
てんずる	下され
やみほうける	やみほうけろ
駆け込める	駆け込めろ
やしなう	やしなえ
冷める	冷めろ
むかえいれる	むかえいれろ
慰する	慰しろ
あきあきする	あきあきしろ
勤まる	勤まれ
移れる	移れろ
吹掛ける	吹掛けろ
盛上げる	盛上げろ
落し入れる	落し入れろ
はせ着ける	はせ着けろ
しこめる	しこめろ
きりまくる	きりまくれ
引ける	引けろ
凌ぐ	凌げ
張り合える	張り合えろ
みまかる	みまかれ
言いなす	言いなせ
説おこす	説おこせ
くっする	くっしろ
懸かる	懸かれ
ふさげる	ふさげろ
いそがす	いそがせ
唄える	唄えろ
もる	もれ
こびりつく	こびりつけ
引換える	引換えろ
はじめる	はじめろ
よろこびあう	よろこびあえ
すみなす	すみなせ
ともす	ともせ
食散らす	食散らせ
つみのこす	つみのこせ
伺う	伺え
導く	導け
たたみこむ	たたみこめ
寛ぐ	寛げ
折り畳む	折り畳め
はらいこむ	はらいこめ
しゃがれる	しゃがれろ
垣間みる	垣間みろ
みすごせる	みすごせろ
差し昇る	差し昇れ
うごかす	うごかせ
黒みがかる	黒みがかれ
垂れこめる	垂れこめろ
持上げる	持上げろ
立働く	立働け
あみだす	あみだせ
つきのける	つきのけろ
返す	返せ
整える	整えろ
食み出でる	食み出でろ
ききおよぶ	ききおよべ
進ぜる	進ぜろ
かなぐりすてる	かなぐりすてろ
送り込む	送り込め
かみ締める	かみ締めろ
振り乱す	振り乱せ
見失う	見失え
彷徨く	彷徨け
離れる	離れろ
張り飛ばす	張り飛ばせ
白茶ける	白茶けろ
はちきれる	はちきれろ
漬かる	漬かれ
振乱す	振乱せ
筋張る	筋張れ
わめく	わめけ
張りきる	張りきれ
差す	差せ
つきとばす	つきとばせ
賦する	賦しろ
そりくり返る	そりくり返れ
ひわれる	ひわれろ
押さえつける	押さえつけろ
振り撒く	振り撒け
切り抜く	切り抜け
舐めずる	舐めずれ
振り翳す	振り翳せ
連ねる	連ねろ
生き延びる	生き延びろ
まぶす	まぶせ
たて込む	たて込め
ひく	ひけ
鋳込む	鋳込め
滑べる	滑べれ
みすごす	みすごせ
感極まる	感極まれ
言いくるめる	言いくるめろ
いみきらう	いみきらえ
刈り急ぐ	刈り急げ
賭す	賭せ
僻する	僻しろ
競り合える	競り合えろ
泣ぬれる	泣ぬれろ
みまもれる	みまもれろ
怒り狂う	怒り狂え
撓める	撓めろ
つがえる	つがえろ
待ち合わす	待ち合わせ
盗む	盗め
側める	側めろ
先細る	先細れ
うけつぐ	うけつげ
探れる	探れろ
鼻じろむ	鼻じろめ
挟む	挟め
いこむ	いこめ
たのしむ	たのしめ
うりまくれる	うりまくれろ
混ぜかえす	混ぜかえせ
取り出す	取り出せ
よびとめる	よびとめろ
抜き出す	抜き出せ
跨る	跨れ
ほかなる	ほかなれ
あり合せる	あり合せろ
なきこむ	なきこめ
つけ込む	つけ込め
競り上げる	競り上げろ
言い繕う	言い繕え
繙く	繙け
推し進める	推し進めろ
価する	価しろ
もりあわせる	もりあわせろ
いじる	いじれ
釣り出す	釣り出せ
やっつける	やっつけろ
ひり出す	ひり出せ
言い逃れる	言い逃れろ
とびだせる	とびだせろ
かえす	かえせ
しょう	しょえ
いじける	いじけろ
もたげる	もたげろ
出ぱる	出ぱれ
こう	こえ
騙かす	騙かせ
苦しめる	苦しめろ
やみつく	やみつけ
打出せる	打出せろ
ひっ掻く	ひっ掻け
えんづく	えんづけ
窪める	窪めろ
ちまよう	ちまよえ
すぎる	すぎろ
転がせる	転がせろ
たちいる	たちいれ
着飾れる	着飾れろ
つきしたがう	つきしたがえ
ふりこむ	ふりこめ
書き分ける	書き分けろ
浴する	浴しろ
編出す	編出せ
飛込む	飛込め
驚き入る	驚き入れ
笑み割れる	笑み割れろ
とりはからえる	とりはからえろ
掬ぶ	掬べ
暗ます	暗ませ
茹でる	茹でろ
取り戻せる	取り戻せろ
病みつく	病みつけ
ネグる	ネグれ
卷く	卷け
はこぶ	はこべ
せんじる	せんじろ
祈れる	祈れろ
命じる	命じろ
喜ぶ	喜べ
みしる	みしれ
爛れる	爛れろ
囀る	囀れ
さきだつ	さきだて
薨ずる	さきだて
見兼ねる	見兼ねろ
あいともなう	あいともなえ
小突く	小突け
おりあげる	おりあげろ
きらめむ	きらめめ
掻き起す	掻き起せ
思いかえす	思いかえせ
やりかえせる	やりかえせろ
ちばしる	ちばしれ
かみわける	かみわけろ
さしおく	さしおけ
なれ合う	なれ合え
見かける	見かけろ
おおわれる	おおわれろ
かちあう	かちあえ
たたき起こせる	たたき起こせろ
成り済ます	成り済ませ
おじけづく	おじけづけ
くみ出せる	くみ出せろ
なやむ	なやめ
頼み込む	頼み込め
ゆずる	ゆずれ
転ずる	ゆずれ
息まく	息まけ
ひぞる	ひぞれ
青む	青め
づける	づけろ
ひろう	ひろえ
ござる	ござれ
蹴出す	蹴出せ
ふする	ふしろ
きりはらう	きりはらえ
遣いこむ	遣いこめ
もたせ掛ける	もたせ掛けろ
遣り込める	遣り込めろ
なかす	なかせ
ちえづく	ちえづけ
混ぜ合う	混ぜ合え
噛める	噛めろ
煮え返る	煮え返れ
飾り立てる	飾り立てろ
古びる	古びろ
とび出る	とび出ろ
感じる	感じろ
奬める	奬めろ
吊す	吊せ
つれもどせる	つれもどせろ
握れる	握れろ
えり分ける	えり分けろ
焚き染める	焚き染めろ
由る	由れ
あまんじる	あまんじろ
振替える	振替えろ
産みつける	産みつけろ
植え込める	植え込めろ
沸き起これる	沸き起これろ
目覚める	目覚めろ
委せる	委せろ
住み慣れる	住み慣れろ
思ほす	思ほせ
みちがえる	みちがえろ
せめのぼる	せめのぼれ
気どる	気どれ
したしむ	したしめ
持ち合わせる	持ち合わせろ
置換わる	置換われ
聞流す	聞流せ
追い落とす	追い落とせ
焦れ込む	焦れ込め
歌う	歌え
極める	極めろ
ねせる	ねせろ
つづめる	つづめろ
ろんずる	つづめろ
書き下ろす	書き下ろせ
綴れる	綴れろ
かねる	かねろ
凍り付く	凍り付け
見損なう	見損なえ
すんたる	すんたれ
計る	計れ
開き直れる	開き直れろ
取りそろえる	取りそろえろ
割り戻せる	割り戻せろ
しみこむ	しみこめ
にげうせる	にげうせろ
しつける	しつけろ
すりまぜる	すりまぜろ
とりあう	とりあえ
匂わせる	匂わせろ
転がり込む	転がり込め
貸切る	貸切れ
縫い込む	縫い込め
ひきつづける	ひきつづけろ
割りあてる	割りあてろ
ぼうする	ぼうしろ
ひたす	ひたせ
振り落とす	振り落とせ
ひきおろす	ひきおろせ
みおろせる	みおろせろ
立ふさがる	立ふさがれ
切付ける	切付けろ
目慣れる	目慣れろ
ころがる	ころがれ
付き従う	付き従え
はたらきかける	はたらきかけろ
ちかづける	ちかづけろ
立ち返る	立ち返れ
むかつく	むかつけ
芽生える	芽生えろ
侮れる	侮れろ
取り去れる	取り去れろ
ぶちこわす	ぶちこわせ
期す	期せ
伝わる	伝われ
任じる	任じろ
つま先立つ	つま先立て
うけあう	うけあえ
垂れ込む	垂れ込め
勝取る	勝取れ
ちからつきる	ちからつきろ
踏んばる	踏んばれ
かちこせる	かちこせろ
たがる	たがれ
おく	おけ
咲き乱れる	咲き乱れろ
ねんじる	ねんじろ
留める	留めろ
打ちよせる	打ちよせろ
つっこめる	つっこめろ
おもう	おもえ
已める	已めろ
つちかう	つちかえ
ききかえせる	ききかえせろ
みやる	みやれ
仇する	仇しろ
きょうする	きょうしろ
むきなおる	むきなおれ
突き放す	突き放せ
引き立てる	引き立てろ
やききる	やききれ
取上げる	取上げろ
あばれまわる	あばれまわれ
きりとれる	きりとれろ
忍び込める	忍び込めろ
取りあつかう	取りあつかえ
掻っ切る	掻っ切れ
突き止める	突き止めろ
もえひろがる	もえひろがれ
ねぼける	ねぼけろ
むかいあわす	むかいあわせ
捏ね返す	捏ね返せ
拘わる	拘われ
遣う	遣え
たまわる	たまわれ
ひっ篭る	ひっ篭れ
酔いしれる	酔いしれろ
とどろく	とどろけ
かかわりあう	かかわりあえ
カミつく	カミつけ
いいきかせる	いいきかせろ
隔てる	隔てろ
攻あぐむ	攻あぐめ
ハサむ	ハサめ
かざりたてる	かざりたてろ
呷る	呷れ
てわたす	てわたせ
取もつ	取もて
はぎとれる	はぎとれろ
組替える	組替えろ
寝過す	寝過せ
けむる	けむれ
ゆらせる	ゆらせろ
畏れ入る	畏れ入れ
歩ける	歩けろ
すりつぶす	すりつぶせ
踏める	踏めろ
臆する	臆しろ
踏み越える	踏み越えろ
けかえす	けかえせ
疼く	疼け
語りこめる	語りこめろ
ぬきとれる	ぬきとれろ
つけ加える	つけ加えろ
なきさけぶ	なきさけべ
くじく	くじけ
名指す	名指せ
しょたいじみる	しょたいじみろ
焦がれる	焦がれろ
会わす	会わせ
坐る	坐れ
入れ揚げる	入れ揚げろ
舐める	舐めろ
うけながす	うけながせ
てつだう	てつだえ
慈しむ	慈しめ
握り潰す	握り潰せ
たえいる	たえいれ
さばける	さばけろ
からみあう	からみあえ
おる	おれ
まきおこせる	まきおこせろ
はげおちる	はげおちろ
よめる	よめろ
かきぬける	かきぬけろ
打ち捨てる	打ち捨てろ
みやぶれる	みやぶれろ
受入れる	受入れろ
掛合う	掛合え
はなしあえる	はなしあえろ
迫り出す	迫り出せ
すする	すすれ
見極める	見極めろ
畳み込む	畳み込め
擦りむける	擦りむけろ
脱捨てる	脱捨てろ
訃げる	訃げろ
しずれる	しずれろ
取りなす	取りなせ
咲きそろう	咲きそろえ
あたりちらす	あたりちらせ
取り落す	取り落せ
押し迫る	押し迫れ
けぶる	けぶれ
途絶える	途絶えろ
熔ける	熔けろ
かんがみる	かんがみろ
かけへだてる	かけへだてろ
あかちゃける	あかちゃけろ
懐く	懐け
来あわせる	来あわせろ
叱りつける	叱りつけろ
ながれあるく	ながれあるけ
伸び悩む	伸び悩め
おえる	おえろ
験する	験しろ
略する	略しろ
追いすがる	追いすがれ
かがめる	かがめろ
さうぞく	さうぞけ
溶きほぐす	溶きほぐせ
すりきれる	すりきれろ
とりとめる	とりとめろ
立ち塞がる	立ち塞がれ
たくむ	たくめ
便じる	便じろ
聘する	聘しろ
破ける	破けろ
行き過ぎる	行き過ぎろ
うきだす	うきだせ
ひくまる	ひくまれ
恋い焦がれる	恋い焦がれろ
糊する	糊しろ
すみかわる	すみかわれ
死におくれる	死におくれろ
理る	理れ
こと切れる	こと切れろ
採りあげる	採りあげろ
かけこめる	かけこめろ
倍する	倍しろ
へこます	へこませ
燃えつきる	燃えつきろ
す	せ
引っさげる	引っさげろ
破る	破れ
へる	へろ
閉じ込める	閉じ込めろ
ひしぐ	ひしげ
つかれ果てる	つかれ果てろ
くろめる	くろめろ
たちかえる	たちかえれ
かざる	かざれ
酔いつぶれる	酔いつぶれろ
仕あがる	仕あがれ
持ち込む	持ち込め
嘆き暮す	嘆き暮せ
垂れる	垂れろ
あえる	あえろ
篩い落す	篩い落せ
いきとどく	いきとどけ
付まとう	付まとえ
ぶつける	ぶつけろ
こみいる	こみいれ
ゆずれる	ゆずれろ
うらびれる	うらびれろ
哮り立つ	哮り立て
くいさがる	くいさがれ
上げる	上げろ
回す	回せ
生れ変る	生れ変れ
滅ぶ	滅べ
利す	利せ
ちらめく	ちらめけ
伍する	伍しろ
たてかえる	たてかえろ
伺ふ	伺へ
絶つ	絶て
透きとおる	透きとおれ
布く	布け
とがる	とがれ
こなれる	こなれろ
とっちめる	とっちめろ
ふめる	ふめろ
出す	出せ
おしかくす	おしかくせ
こぐらかる	こぐらかれ
そう	そえ
突っ切る	突っ切れ
締め出す	締め出せ
のぞめる	のぞめろ
読み破る	読み破れ
弛める	弛めろ
仰ぐ	仰げ
ねじ切る	ねじ切れ
迸る	迸れ
かちほこる	かちほこれ
有り得る	有り得ろ
掻き消える	掻き消えろ
よみくだす	よみくだせ
煎じつめる	煎じつめろ
泣き腫らす	泣き腫らせ
貶する	貶しろ
突飛ばす	突飛ばせ
とぎれる	とぎれろ
明らむ	明らめ
あさる	あされ
待ちかまえる	待ちかまえろ
したがえる	したがえろ
畳める	畳めろ
呼び戻す	呼び戻せ
打上げる	打上げろ
言放つ	言放て
抱き込める	抱き込めろ
そめあがる	そめあがれ
見繕う	見繕え
若返れる	若返れろ
つかいこなす	つかいこなせ
泣き沈む	泣き沈め
釈ける	釈けろ
跳びつく	跳びつけ
きたえあげる	きたえあげろ
うけとれる	うけとれろ
ねじまげる	ねじまげろ
割り引ける	割り引けろ
陥る	陥れ
沸きあがる	沸きあがれ
嘶える	嘶えろ
立ち向かえる	立ち向かえろ
引き降ろせる	引き降ろせろ
替る	替れ
よみかえす	よみかえせ
ひきちぎれる	ひきちぎれろ
弔える	弔えろ
汗する	汗しろ
窪まる	窪まれ
配する	配しろ
せせる	せせれ
褪める	褪めろ
さえ返る	さえ返れ
よむ	よめ
すがりつく	すがりつけ
理解し合う	理解し合え
験す	験せ
まく	まけ
たくらむ	たくらめ
みたてる	みたてろ
思い浮かべる	思い浮かべろ
焚きつける	焚きつけろ
作れる	作れろ
のびあがる	のびあがれ
あいす	あいせ
あらだつ	あらだて
はりきれる	はりきれろ
立ち退く	立ち退け
おびき寄せる	おびき寄せろ
這いずる	這いずれ
手折れる	手折れろ
嘉する	嘉しろ
剃り落とせる	剃り落とせろ
候う	候え
しゃくり上げる	しゃくり上げろ
貫く	貫け
葬る	葬れ
語り込む	語り込め
食い荒らす	食い荒らせ
取り乱す	取り乱せ
参らせる	参らせろ
譏る	譏れ
もうでる	もうでろ
死する	死しろ
継ぎあわせる	継ぎあわせろ
悴む	悴め
住みなす	住みなせ
しとる	しとれ
とんがらかす	とんがらかせ
交ぜ返す	交ぜ返せ
立ち止る	立ち止れ
押黙る	押黙れ
書きあげる	書きあげろ
貸し切る	貸し切れ
あつらえる	あつらえろ
沸く	沸け
跳上がる	跳上がれ
飲込む	飲込め
つみあげる	つみあげろ
徹す	徹せ
まどう	まどえ
引き揚げる	引き揚げろ
書き付ける	書き付けろ
見落とす	見落とせ
掻き毟る	掻き毟れ
付け廻す	付け廻せ
消うせる	消うせろ
さがしもとめる	さがしもとめろ
かけあう	かけあえ
慣らせる	慣らせろ
とりやめる	とりやめろ
痩ける	痩けろ
押し隠せる	押し隠せろ
架かる	架かれ
さわす	さわせ
こころがける	こころがけろ
ぬかす	ぬかせ
飢える	飢えろ
ながせる	ながせろ
成立つ	成立て
はなしだす	はなしだせ
弱める	弱めろ
打返す	打返せ
打ち合わす	打ち合わせ
打ち切る	打ち切れ
うなずく	うなずけ
ふくらます	ふくらませ
吐ける	吐けろ
差掛ける	差掛けろ
打ち返す	打ち返せ
打払う	打払え
思う	思え
汲み乾す	汲み乾せ
はね上がる	はね上がれ
さんけづく	さんけづけ
よこたわる	よこたわれ
寝取る	寝取れ
つっかえす	つっかえせ
あびる	あびろ
冀う	冀え
刺さる	刺され
ふきつける	ふきつけろ
はせつける	はせつけろ
乗り継げる	乗り継げろ
改める	改めろ
吹き荒ぶ	吹き荒べ
遠ざける	遠ざけろ
輝る	輝れ
懸隔てる	懸隔てろ
たちきる	たちきれ
吹き飛ばせる	吹き飛ばせろ
煩い付く	煩い付け
思い残す	思い残せ
そっくり返る	そっくり返れ
すておく	すておけ
召しかかえる	召しかかえろ
取り繕う	取り繕え
呆れかえる	呆れかえれ
しみ込む	しみ込め
取消す	取消せ
くさる	くされ
ほのめく	ほのめけ
聞分ける	聞分けろ
たもちあえる	たもちあえろ
ゆく	ゆけ
切れ込む	切れ込め
ねれる	ねれろ
むせる	むせろ
たかぶる	たかぶれ
ほどこせる	ほどこせろ
かかり合う	かかり合え
染み込む	染み込め
積み残す	積み残せ
食える	食えろ
張り付ける	張り付けろ
つり合う	つり合え
のし上がる	のし上がれ
思い切れる	思い切れろ
みかえる	みかえれ
はしりぬける	はしりぬけろ
拠る	拠れ
てる	てろ
だきとる	だきとれ
攀じ登る	攀じ登れ
こいこがれる	こいこがれろ
なみだする	なみだしろ
すべりこむ	すべりこめ
見粉う	見粉え
打落す	打落せ
きする	きしろ
ひきずりだせる	ひきずりだせろ
ころげでる	ころげでろ
建ち並ぶ	建ち並べ
往く	往け
みとる	みとれ
巡る	巡れ
読み流す	読み流せ
代る	代れ
罷める	罷めろ
かかえ込む	かかえ込め
まぜっかえす	まぜっかえせ
おりあう	おりあえ
ゐる	ゐろ
見せかける	見せかけろ
かつげる	かつげろ
きりまわす	きりまわせ
躊躇う	躊躇え
しんじる	しんじろ
堪え忍ぶ	堪え忍べ
すべりこめる	すべりこめろ
おとす	おとせ
射竦める	射竦めろ
付加わる	付加われ
捲れる	捲れろ
たがえる	たがえろ
かかわり合う	かかわり合え
はねだす	はねだせ
うたいまくる	うたいまくれ
過す	過せ
こおりつく	こおりつけ
科す	科せ
連れ帰る	連れ帰れ
まくる	まくれ
抓む	抓め
おどり上がる	おどり上がれ
切り立つ	切り立て
見馴れる	見馴れろ
振り分ける	振り分けろ
撃ち合う	撃ち合え
うかべる	うかべろ
饐える	饐えろ
思いとどまる	思いとどまれ
ふりおとす	ふりおとせ
組付く	組付け
聞き落す	聞き落せ
かき分ける	かき分けろ
洗える	洗えろ
うったえる	うったえろ
借切る	借切れ
こぎ着ける	こぎ着けろ
脹らす	脹らせ
分かつ	分かて
言いならわす	言いならわせ
挿頭す	挿頭せ
飛び込める	飛び込めろ
切出す	切出せ
いつぶす	いつぶせ
休まる	休まれ
降ろせる	降ろせろ
はためく	はためけ
もうす	もうせ
死にかける	死にかけろ
諌める	諌めろ
もとめる	もとめろ
駆回る	駆回れ
くりこせる	くりこせろ
キメる	キメろ
取片付ける	取片付けろ
いすくめる	いすくめろ
へんじる	へんじろ
ほつれる	ほつれろ
交わす	交わせ
うりはらえる	うりはらえろ
混ぜ返す	混ぜ返せ
あれくるう	あれくるえ
摂する	摂しろ
ねがえる	ねがえろ
ながす	ながせ
言い過ぎる	言い過ぎろ
すだてる	すだてろ
ぼかす	ぼかせ
押込める	押込めろ
立ち遅れる	立ち遅れろ
むくれる	むくれろ
ひるむ	ひるめ
降くらす	降くらせ
やすまれる	やすまれろ
通れる	通れろ
買いあさる	買いあされ
巡らす	巡らせ
持ち去る	持ち去れ
縅す	縅せ
拭き取る	拭き取れ
あまえる	あまえろ
じゅくす	じゅくせ
捻り回す	捻り回せ
過る	過れ
歩く	歩け
売りつくす	売りつくせ
ひらめく	ひらめけ
叙する	叙しろ
咲かせる	咲かせろ
おどりかかる	おどりかかれ
きかす	きかせ
契れる	契れろ
つきあげる	つきあげろ
おっつける	おっつけろ
恋う	恋え
くさらす	くさらせ
にじむ	にじめ
みとれる	みとれろ
欲張る	欲張れ
つっこむ	つっこめ
呼び込める	呼び込めろ
取去る	取去れ
嵌め込む	嵌め込め
焼きつける	焼きつけろ
恵まれる	恵まれろ
切かかる	切かかれ
見晴らす	見晴らせ
聞き出せる	聞き出せろ
眩む	眩め
得る	得ろ
さおさす	さおさせ
かわす	かわせ
替える	替えろ
といつめる	といつめろ
濾せる	濾せろ
突き抜ける	突き抜けろ
育て上げる	育て上げろ
見すかせる	見すかせろ
歴る	歴ろ
生きる	生きろ
道ける	道けろ
願う	願え
噛みわける	噛みわけろ
取り決める	取り決めろ
着ける	着けろ
気がつく	気がつけ
つつしむ	つつしめ
泳げる	泳げろ
おいる	おいろ
かいあげる	かいあげろ
書き抜く	書き抜け
乾涸びる	乾涸びろ
繋げる	繋げろ
割りふる	割りふれ
縮れる	縮れろ
紛らかす	紛らかせ
驚く	驚け
失う	失え
かりかえる	かりかえろ
かきそえる	かきそえろ
買い取る	買い取れ
口ごもる	口ごもれ
くいつく	くいつけ
突詰める	突詰めろ
とりけす	とりけせ
しにたえる	しにたえろ
煮詰まる	煮詰まれ
あきれ果てる	あきれ果てろ
役立てる	役立てろ
ありつく	ありつけ
動き出す	動き出せ
切り詰める	切り詰めろ
行交う	行交え
求め行く	求め行け
枯ればむ	枯ればめ
バカげる	バカげろ
絡まる	絡まれ
下げる	下げろ
曳ける	曳けろ
せっぱ詰まる	せっぱ詰まれ
組みつく	組みつけ
ほうりだす	ほうりだせ
手馴れる	手馴れろ
転がる	転がれ
抱き合う	抱き合え
しおれる	しおれろ
割り付ける	割り付けろ
飛ばせる	飛ばせろ
にじる	にじれ
よくばる	よくばれ
つめこめる	つめこめろ
夢見る	夢見ろ
はんじる	はんじろ
冷やす	冷やせ
めしかかえる	めしかかえろ
丸め込む	丸め込め
見落す	見落せ
飲潰す	飲潰せ
撃つ	撃て
むくう	むくえ
ありあまる	ありあまれ
つまどる	つまどれ
囃す	囃せ
認める	認めろ
ときめかす	ときめかせ
儀式張る	儀式張れ
恍ける	恍けろ
あたける	あたけろ
制する	制しろ
見せ付ける	見せ付けろ
流れる	流れろ
はせ参ずる	流れろ
掻き分ける	掻き分けろ
適す	適せ
出歩く	出歩け
舞上がる	舞上がれ
関係付ける	関係付けろ
舂く	舂け
縁付ける	縁付けろ
まかり間違う	まかり間違え
軽しめる	軽しめろ
ひっこす	ひっこせ
ゆき暮れる	ゆき暮れろ
ほれ込む	ほれ込め
ふりはじめる	ふりはじめろ
越える	越えろ
うめる	うめろ
誅する	誅しろ
學ぶ	學べ
被ける	被けろ
かきながす	かきながせ
詰めかける	詰めかけろ
窮め尽くす	窮め尽くせ
整え直す	整え直せ
遮れる	遮れろ
しれわたる	しれわたれ
すみなれる	すみなれろ
なげこめる	なげこめろ
投げ勝てる	投げ勝てろ
ていする	ていしろ
なやます	なやませ
突きとばす	突きとばせ
当たれる	当たれろ
さかだつ	さかだて
なげだせる	なげだせろ
かきこむ	かきこめ
振当てる	振当てろ
つかいわける	つかいわけろ
誣いる	誣いろ
ゆき渡る	ゆき渡れ
はたける	はたけろ
碎く	碎け
抱き着く	抱き着け
ひっくるめる	ひっくるめろ
吹っ飛ぶ	吹っ飛べ
押しこめる	押しこめろ
さいはじける	さいはじけろ
ととのう	ととのえ
誹る	誹れ
わきおこれる	わきおこれろ
はりあげる	はりあげろ
折り合う	折り合え
置きわすれる	置きわすれろ
ひざまずく	ひざまずけ
かたまる	かたまれ
言誤る	言誤れ
うち続く	うち続け
有り触れる	有り触れろ
生い育つ	生い育て
擦寄る	擦寄れ
書下す	書下せ
のこる	のこれ
当て擦る	当て擦れ
思いなす	思いなせ
杓う	杓え
とおせる	とおせろ
住みかえる	住みかえろ
そこしる	そこしれ
責め落とす	責め落とせ
染出す	染出せ
つかめる	つかめろ
いやます	いやませ
竦む	竦め
ならぶ	ならべ
詰る	詰れ
排する	排しろ
のしかかる	のしかかれ
集る	集れ
振分ける	振分けろ
かんがえつく	かんがえつけ
求まる	求まれ
ゆわえ付ける	ゆわえ付けろ
吊れる	吊れろ
聞き込む	聞き込め
もえあがる	もえあがれ
さきみだれる	さきみだれろ
侮る	侮れ
まかり通る	まかり通れ
押し切れる	押し切れろ
見とれる	見とれろ
つづまる	つづまれ
みさだめる	みさだめろ
こましゃくれる	こましゃくれろ
遊び回れる	遊び回れろ
うつしとる	うつしとれ
鞣す	鞣せ
でかける	でかけろ
勝ちぬく	勝ちぬけ
とって返す	とって返せ
ねぐ	ねげ
みいだせる	みいだせろ
掃きだす	掃きだせ
切り取る	切り取れ
飛のく	飛のけ
かみしだく	かみしだけ
詛う	詛え
片寄る	片寄れ
わき出る	わき出ろ
ぞんじあげる	ぞんじあげろ
寄り縋る	寄り縋れ
もとる	もとれ
めぐれる	めぐれろ
重立つ	重立て
黄ばむ	黄ばめ
書き散らす	書き散らせ
刺し通す	刺し通せ
おそれいる	おそれいれ
優る	優れ
もてなす	もてなせ
しゃくにさわる	しゃくにさわれ
よびあげる	よびあげろ
食い合う	食い合え
いきぬく	いきぬけ
鈍る	鈍れ
しげりあう	しげりあえ
話す	話せ
言い損なう	言い損なえ
押しつまる	押しつまれ
踏み破る	踏み破れ
請う	請え
たわむ	たわめ
降り積る	降り積れ
打出す	打出せ
響きわたる	響きわたれ
もぎ落とす	もぎ落とせ
膨れる	膨れろ
借入れる	借入れろ
翔る	翔れ
いきまく	いきまけ
そっくりかえる	そっくりかえれ
となりあう	となりあえ
相する	相しろ
まぬかれる	まぬかれろ
逢う	逢え
逃れる	逃れろ
食いつぶす	食いつぶせ
すわりこめる	すわりこめろ
強める	強めろ
剥ける	剥けろ
耳慣れる	耳慣れろ
よいしれる	よいしれろ
荒れ狂う	荒れ狂え
よみとれる	よみとれろ
欲ばる	欲ばれ
なげいれる	なげいれろ
わすれかける	わすれかけろ
てなずける	てなずけろ
抱ける	抱けろ
とりさる	とりされ
課す	課せ
焼き鈍す	焼き鈍せ
うっする	うっしろ
りょうる	りょうれ
わらいこける	わらいこけろ
同ずる	わらいこけろ
運び込む	運び込め
差向ける	差向けろ
もぐりこめる	もぐりこめろ
安らう	安らえ
紛える	紛えろ
ほころばせる	ほころばせろ
犯せる	犯せろ
読み出す	読み出せ
なきぬれる	なきぬれろ
祝える	祝えろ
おもんばかる	おもんばかれ
たたえる	たたえろ
よびよせる	よびよせろ
手渡せる	手渡せろ
いる	いろ
結い上げる	結い上げろ
かつえる	かつえろ
もったいぶる	もったいぶれ
こせる	こせろ
統べる	統べろ
送りこむ	送りこめ
差上る	差上れ
引き出す	引き出せ
盗み見る	盗み見ろ
おおせつかる	おおせつかれ
くるまれる	くるまれろ
区切る	区切れ
折り曲げる	折り曲げろ
逃げだす	逃げだせ
けがす	けがせ
要る	要れ
拗じくれる	拗じくれろ
及ぶ	及べ
ねじこむ	ねじこめ
ひきおとせる	ひきおとせろ
拗くれる	拗くれろ
身まかる	身まかれ
可愛がれる	可愛がれろ
泣明かす	泣明かせ
鳴しきる	鳴しきれ
すえる	すえろ
しばりつける	しばりつけろ
にじみでる	にじみでろ
震わす	震わせ
ぶら下げる	ぶら下げろ
恋こがれる	恋こがれろ
おもいあがる	おもいあがれ
ひきしぼる	ひきしぼれ
とりかえす	とりかえせ
つかれる	つかれろ
練り合わせる	練り合わせろ
所帯染みる	所帯染みろ
おどろく	おどろけ
はばかる	はばかれ
活かす	活かせ
打据える	打据えろ
うかがえる	うかがえろ
輸する	輸しろ
察す	察せ
振る舞う	振る舞え
諂う	諂え
取り去る	取り去れ
目論む	目論め
殴り込む	殴り込め
言い直す	言い直せ
のみつぶれる	のみつぶれろ
隣合わす	隣合わせ
おぎなう	おぎなえ
ひねり出す	ひねり出せ
洗い直す	洗い直せ
つかねる	つかねろ
おいちらす	おいちらせ
うけいれる	うけいれろ
かなう	かなえ
知抜く	知抜け
象れる	象れろ
受け出す	受け出せ
ゆすぐ	ゆすげ
あそびあきる	あそびあきろ
次ぐ	次げ
さぐりあう	さぐりあえ
える	えれ
揚る	揚れ
ねそびれる	ねそびれろ
すすぐ	すすげ
顕れる	顕れろ
赤みがかる	赤みがかれ
嗜める	嗜めろ
うがつ	うがて
掻き乱す	掻き乱せ
生み付ける	生み付けろ
綴じ込む	綴じ込め
あつかう	あつかえ
噛み砕ける	噛み砕けろ
祟る	祟れ
さんざめく	さんざめけ
話せる	話せろ
打ちあわせる	打ちあわせろ
ぐずる	ぐずれ
べんじる	べんじろ
携える	携えろ
請け負う	請け負え
ながしいれる	ながしいれろ
くいさがれる	くいさがれろ
たたき落とす	たたき落とせ
飲明かす	飲明かせ
似合う	似合え
きかせる	きかせろ
寄越す	寄越せ
湿す	湿せ
にげのびる	にげのびろ
まかりでる	まかりでろ
たちのく	たちのけ
つぼまる	つぼまれ
よろこばす	よろこばせ
いいつのる	いいつのれ
耽ける	耽けろ
聞き置く	聞き置け
ふりまわせる	ふりまわせろ
めとる	めとれ
てる	てれ
うたがえる	うたがえろ
甘んずる	うたがえろ
たちされる	たちされろ
おののく	おののけ
燃やせる	燃やせろ
生ずる	燃やせろ
導き出す	導き出せ
嵩む	嵩め
ふみぬける	ふみぬけろ
ひらめる	ひらめろ
すれあう	すれあえ
虐める	虐めろ
うけとる	うけとれ
たたきおとす	たたきおとせ
築ける	築けろ
どく	どけ
蠢く	蠢け
たぎる	たぎれ
呼び付ける	呼び付けろ
心掛ける	心掛けろ
のり出せる	のり出せろ
ふりきれる	ふりきれろ
汲みあげる	汲みあげろ
捻り出す	捻り出せ
はずかしめる	はずかしめろ
交える	交えろ
いいおわる	いいおわれ
組込む	組込め
打ち放す	打ち放せ
拾える	拾えろ
おもいめぐらす	おもいめぐらせ
つきとおる	つきとおれ
みのる	みのれ
革まる	革まれ
引っ掛ける	引っ掛けろ
来る	引っ掛けろ
抜取る	抜取れ
よわいする	よわいしろ
抜出す	抜出せ
大殿篭る	大殿篭れ
ちゅうする	ちゅうしろ
したためる	したためろ
生ける	生けろ
ひっくり返せる	ひっくり返せろ
あらためる	あらためろ
腐る	腐れ
鞭打つ	鞭打て
さわがせる	さわがせろ
思いめぐらす	思いめぐらせ
はくする	はくしろ
につまる	につまれ
並外れる	並外れろ
かがむ	かがめ
輝く	輝け
やく	やけ
ある	あれ
心温まる	心温まれ
なぐ	なげ
さきにおう	さきにおえ
しみ渡る	しみ渡れ
咲きみだれる	咲きみだれろ
うばいあえる	うばいあえろ
建てる	建てろ
頼める	頼めろ
かり集める	かり集めろ
ふみたおせる	ふみたおせろ
やみほおける	やみほおけろ
言習わす	言習わせ
ありあわせる	ありあわせろ
吐き出す	吐き出せ
導ける	導けろ
止まる	止まれ
正す	正せ
盛り殺す	盛り殺せ
しまう	しまえ
磨ぐ	磨げ
におわす	におわせ
さらえる	さらえろ
しわける	しわけろ
躱す	躱せ
討ち止める	討ち止めろ
交ぜる	交ぜろ
のける	のけろ
といあわせる	といあわせろ
嵌める	嵌めろ
憂ふ	嵌めろ
ひねりだす	ひねりだせ
恐る	恐ろ
居座れる	居座れろ
塗り付ける	塗り付けろ
執り成す	執り成せ
張る	張れ
にえかえる	にえかえれ
乗り掛ける	乗り掛けろ
帯する	帯しろ
にやける	にやけろ
しぶく	しぶけ
戦ふ	戦へ
てがける	てがけろ
でく	でけ
くいたおす	くいたおせ
差し伸べる	差し伸べろ
いきどおる	いきどおれ
張り切る	張り切れ
やめる	やめろ
誘き寄せる	誘き寄せろ
いきばる	いきばれ
たたきだせる	たたきだせろ
煎る	煎れ
おうじる	おうじろ
遊ばせる	遊ばせろ
けしかける	けしかけろ
突き出る	突き出ろ
行かす	行かせ
よくなる	よくなれ
あがる	あがれ
もつ	もて
迫り上げる	迫り上げろ
鉗む	鉗め
たっする	たっしろ
こえる	こえろ
ぬがせる	ぬがせろ
かみつく	かみつけ
捌く	捌け
聞き流す	聞き流せ
占める	占めろ
鳴りだす	鳴りだせ
赦す	赦せ
見返す	見返せ
威張る	威張れ
罅割れる	罅割れろ
みまう	みまえ
きはじめる	きはじめろ
飛降りる	飛降りろ
なぎ倒す	なぎ倒せ
振りまける	振りまけろ
とりくむ	とりくめ
ひそまる	ひそまれ
持ち直す	持ち直せ
意気込む	意気込め
見つけ出す	見つけ出せ
あきなう	あきなえ
見惚れる	見惚れろ
けだす	けだせ
占える	占えろ
持寄る	持寄れ
染入る	染入れ
ゆきあう	ゆきあえ
そそぎ入れる	そそぎ入れろ
もぎとれる	もぎとれろ
癒す	癒せ
氷る	氷れ
引き続く	引き続け
買占める	買占めろ
哀れむ	哀れめ
叱れる	叱れろ
のびあがれる	のびあがれろ
茶化す	茶化せ
申し入れる	申し入れろ
借り倒す	借り倒せ
押さえ込む	押さえ込め
乗り合わせる	乗り合わせろ
あきらめる	あきらめろ
渇する	渇しろ
見いだす	見いだせ
掻く	掻け
話し出す	話し出せ
先だつ	先だて
かっ切る	かっ切れ
打放す	打放せ
わりふる	わりふれ
うろ抜く	うろ抜け
授ける	授けろ
のぞきこめる	のぞきこめろ
はぐれる	はぐれろ
つれあう	つれあえ
引き絞る	引き絞れ
グレる	グレろ
聞き過す	聞き過せ
ただせる	ただせろ
それる	それろ
見くびる	見くびれ
買入れる	買入れろ
買い換える	買い換えろ
抑え込む	抑え込め
そびえたつ	そびえたて
嗅ぎつける	嗅ぎつけろ
ねころぶ	ねころべ
える	えろ
ほのめかす	ほのめかせ
面くらう	面くらえ
こころづく	こころづけ
摩り替える	摩り替えろ
かけ合せる	かけ合せろ
言い出せる	言い出せろ
詫び入る	詫び入れ
つくす	つくせ
亡くする	亡くしろ
よみあわす	よみあわせ
懸け離れる	懸け離れろ
選び出せる	選び出せろ
吐きだす	吐きだせ
近付ける	近付けろ
やれる	やれろ
過ぎる	過ぎろ
めぐらせる	めぐらせろ
まちがえる	まちがえろ
ききながせる	ききながせろ
扮する	扮しろ
乗外す	乗外せ
取り結べる	取り結べろ
かわせる	かわせろ
取り囲める	取り囲めろ
噴ける	噴けろ
老込む	老込め
もうしでる	もうしでろ
あそばす	あそばせ
儲かる	儲かれ
つぎ込む	つぎ込め
ねばる	ねばれ
縮こまる	縮こまれ
うまれおちる	うまれおちろ
見つめる	見つめろ
添う	添え
踏み切れる	踏み切れろ
よみかける	よみかけろ
うける	うけろ
乗っ取る	乗っ取れ
始める	始めろ
とりむすべる	とりむすべろ
踏とどまる	踏とどまれ
転じる	転じろ
積み込む	積み込め
参る	参れ
つるす	つるせ
はける	はけろ
ふきだす	ふきだせ
成り上がる	成り上がれ
匂う	匂え
もたせる	もたせろ
読取る	読取れ
ひまどる	ひまどれ
志す	志せ
けずりたおす	けずりたおせ
だしぬく	だしぬけ
聞き取れる	聞き取れろ
もたれかかる	もたれかかれ
はずす	はずせ
おしひらく	おしひらけ
まえる	まえろ
待ちくたびれる	待ちくたびれろ
苛む	苛め
ふみたおす	ふみたおせ
切り上げる	切り上げろ
はち切れる	はち切れろ
取り合わす	取り合わせ
借り換える	借り換えろ
力尽きる	力尽きろ
みえる	みえろ
組み付ける	組み付けろ
そり返る	そり返れ
作り出す	作り出せ
おしこむ	おしこめ
せまれる	せまれろ
食つなぐ	食つなげ
擦込む	擦込め
くむ	くめ
相まつ	相まて
わき起これる	わき起これろ
焼ける	焼けろ
緘する	緘しろ
貢げる	貢げろ
かたづける	かたづけろ
まもる	まもれ
ふやす	ふやせ
晒す	晒せ
たすけあえる	たすけあえろ
粘り抜く	粘り抜け
なげつける	なげつけろ
引っこ抜く	引っこ抜け
焙じる	焙じろ
舞い降りる	舞い降りろ
やぶける	やぶけろ
ときめく	ときめけ
引っ掛る	引っ掛れ
聞き糺す	聞き糺せ
くる	くれ
みあらわす	みあらわせ
ひとりごつ	ひとりごて
譲り合う	譲り合え
ツッパる	ツッパれ
策する	策しろ
気張る	気張れ
しゃちこ張る	しゃちこ張れ
差合う	差合え
言い及す	言い及せ
伏す	伏せ
病みほおける	病みほおけろ
取り返す	取り返せ
消え入る	消え入れ
こがす	こがせ
焼く	焼け
はやし立てる	はやし立てろ
いきすぎる	いきすぎろ
腰かける	腰かけろ
かおる	かおれ
にがりきる	にがりきれ
抱きとる	抱きとれ
はじきかえす	はじきかえせ
ぶばる	ぶばれ
ながめる	ながめろ
潜る	潜れ
惚れ込む	惚れ込め
掘り下げる	掘り下げろ
くばりあるく	くばりあるけ
哀しむ	哀しめ
向かわる	向かわれ
おし黙る	おし黙れ
追払う	追払え
ざらつく	ざらつけ
滾る	滾れ
褒めそやす	褒めそやせ
うばいかえす	うばいかえせ
そめなおせる	そめなおせろ
優れる	優れろ
弾き返す	弾き返せ
重んずる	弾き返せ
見入る	見入れ
とびつく	とびつけ
うりさばく	うりさばけ
築き上げる	築き上げろ
混ずる	築き上げろ
突き除ける	突き除けろ
分合う	分合え
とりかえる	とりかえろ
水漬く	水漬け
考へる	考へろ
洗い落とせる	洗い落とせろ
とりこぼす	とりこぼせ
かちえる	かちえろ
張倒す	張倒せ
にあう	にあえ
はねかえる	はねかえれ
とどむる	とどむれ
いみづける	いみづけろ
つながる	つながれ
巻き込める	巻き込めろ
持て囃す	持て囃せ
引きずり込める	引きずり込めろ
報せる	報せろ
際す	際せ
差しのべる	差しのべろ
醸す	醸せ
積み上げる	積み上げろ
うらぶれる	うらぶれろ
うみだせる	うみだせろ
かずける	かずけろ
見おろせる	見おろせろ
ひんする	ひんしろ
ひきかえす	ひきかえせ
繰入れる	繰入れろ
動機付ける	動機付けろ
存ずる	動機付けろ
取仕切る	取仕切れ
おいやる	おいやれ
表する	表しろ
艷めく	艷めけ
喋れる	喋れろ
かきけせる	かきけせろ
聞きいれる	聞きいれろ
飛び出せる	飛び出せろ
そよぐ	そよげ
おおせる	おおせろ
よびかわす	よびかわせ
向かえる	向かえろ
振り上げる	振り上げろ
慰める	慰めろ
にくがる	にくがれ
言いつける	言いつけろ
あびせる	あびせろ
誘える	誘えろ
極め込む	極め込め
くどきおとす	くどきおとせ
聞き入る	聞き入れ
呼び上げる	呼び上げろ
訝る	訝れ
かつぐ	かつげ
引掻く	引掻け
擦切れる	擦切れろ
属する	属しろ
せりあげる	せりあげろ
泡だつ	泡だて
下廻る	下廻れ
失す	失せ
討ち取る	討ち取れ
仕組める	仕組めろ
読み合わせる	読み合わせろ
掻っ込む	掻っ込め
攻め込む	攻め込め
たたきつける	たたきつけろ
ささくれる	ささくれろ
いいならわす	いいならわせ
売り急ぐ	売り急げ
繰りかえる	繰りかえろ
ぐする	ぐしろ
轟かす	轟かせ
おしはかれる	おしはかれろ
曵ける	曵けろ
忍ばせる	忍ばせろ
隣合わせる	隣合わせろ
取り合せる	取り合せろ
ゆきづまる	ゆきづまれ
組みかえる	組みかえろ
ゆうきづける	ゆうきづけろ
描く	描け
伸し上がる	伸し上がれ
けおとす	けおとせ
取寄せる	取寄せろ
たちあがる	たちあがれ
恵む	恵め
抜け出る	抜け出ろ
引きつける	引きつけろ
錆びる	錆びろ
つらぬく	つらぬけ
言いのがれる	言いのがれろ
ともなう	ともなえ
繰り上げる	繰り上げろ
ねる	ねれ
押しやる	押しやれ
寝かし付ける	寝かし付けろ
につける	につけろ
ならわす	ならわせ
ぶりかえす	ぶりかえせ
つがう	つがえ
沈める	沈めろ
ぶんなぐる	ぶんなぐれ
待ちあぐむ	待ちあぐめ
やけだされる	やけだされろ
取り組める	取り組めろ
おちつきはらう	おちつきはらえ
断る	断れ
いれる	いれろ
冷す	冷せ
はねかす	はねかせ
諳んじる	諳んじろ
くぐまる	くぐまれ
くらむ	くらめ
走らす	走らせ
さし当たる	さし当たれ
追いこむ	追いこめ
引き抜ける	引き抜けろ
まごつく	まごつけ
嚇す	嚇せ
叩き込む	叩き込め
養える	養えろ
準じる	準じろ
かきけす	かきけせ
可愛がる	可愛がれ
軽んずる	可愛がれ
飛び交う	飛び交え
かく	かけ
治める	治めろ
泣き崩れる	泣き崩れろ
充てる	充てろ
誇る	誇れ
浚う	浚え
明くらす	明くらせ
とりおとす	とりおとせ
ことわる	ことわれ
交す	交せ
拭える	拭えろ
ひきもどせる	ひきもどせろ
むせかえる	むせかえれ
ヤジる	ヤジれ
飽く	飽け
相変わる	相変われ
呼び寄せる	呼び寄せろ
ほほ笑みかける	ほほ笑みかけろ
戻る	戻れ
堕する	堕しろ
飲める	飲めろ
きりぬく	きりぬけ
写す	写せ
むかいあわせる	むかいあわせろ
扱きおろす	扱きおろせ
震え上がる	震え上がれ
書き落とす	書き落とせ
ふまえる	ふまえろ
はむかえる	はむかえろ
覚す	覚せ
彫り込む	彫り込め
聞きすごす	聞きすごせ
空とぼける	空とぼけろ
書換える	書換えろ
ひっぱれる	ひっぱれろ
贖う	贖え
しょする	しょしろ
塗り潰す	塗り潰せ
はまりこむ	はまりこめ
うばいあう	うばいあえ
たどり着く	たどり着け
脱がせる	脱がせろ
つけまわす	つけまわせ
入替える	入替えろ
攻め落とす	攻め落とせ
積み込める	積み込めろ
歌い上げる	歌い上げろ
見掛ける	見掛けろ
為遂げる	為遂げろ
腹ばう	腹ばえ
燃えさかる	燃えさかれ
へずる	へずれ
うちたおせる	うちたおせろ
題す	題せ
行ずる	題せ
ひょろつく	ひょろつけ
精出せる	精出せろ
言い尽くす	言い尽くせ
てむかう	てむかえ
詰め込む	詰め込め
喰らう	喰らえ
射掛ける	射掛けろ
思い返す	思い返せ
瀕する	瀕しろ
ちりはてる	ちりはてろ
武ばる	武ばれ
跼る	跼れ
残る	残れ
のばす	のばせ
つき合う	つき合え
ときふせる	ときふせろ
みこむ	みこめ
ひたる	ひたれ
妨げる	妨げろ
忍ぶ	忍べ
唱える	唱えろ
差し出す	差し出せ
見上ぐ	差し出せ
とおる	とおれ
ねじむける	ねじむけろ
どよめく	どよめけ
物語る	物語れ
酔払う	酔払え
はぶける	はぶけろ
まいらす	まいらせ
長ずる	まいらせ
超す	超せ
かしらだつ	かしらだて
かたらう	かたらえ
引つる	引つれ
ききほれる	ききほれろ
わきかえる	わきかえれ
掘り返せる	掘り返せろ
知らす	知らせ
果す	果せ
咳きあげる	咳きあげろ
燃あがる	燃あがれ
見切る	見切れ
気負う	気負え
息づまる	息づまれ
仕出かす	仕出かせ
たいらげる	たいらげろ
見棄てる	見棄てろ
しかめる	しかめろ
散る	散れ
とばせる	とばせろ
押し戻す	押し戻せ
おしえる	おしえろ
陣取る	陣取れ
口説く	口説け
上向ける	上向けろ
すくえる	すくえろ
爪立てる	爪立てろ
ひっくり返る	ひっくり返れ
引き取れる	引き取れろ
蹲う	蹲え
うずめる	うずめろ
見据える	見据えろ
てなれる	てなれろ
ときあるく	ときあるけ
取持つ	取持て
横たわる	横たわれ
おもんじる	おもんじろ
溢れる	溢れろ
死に果てる	死に果てろ
立至る	立至れ
亘る	亘れ
手挟む	手挟め
書留める	書留めろ
うりはらう	うりはらえ
覆せる	覆せろ
抜けでる	抜けでろ
すり抜ける	すり抜けろ
売りまくる	売りまくれ
倣う	倣え
きりさいなむ	きりさいなめ
なりさがる	なりさがれ
おきわすれる	おきわすれろ
折れ合える	折れ合えろ
禿げる	禿げろ
切りそろえる	切りそろえろ
立ち合える	立ち合えろ
居る	居れ
払う	払え
盛り潰す	盛り潰せ
踏み出せる	踏み出せろ
ゆする	ゆしろ
差引く	差引け
太れる	太れろ
まきあげる	まきあげろ
弄う	弄え
乗りきる	乗りきれ
汲める	汲めろ
行く	行け
いむ	いめ
撮む	撮め
わたれる	わたれろ
自惚れる	自惚れろ
たびだつ	たびだて
伝え聞く	伝え聞け
押し切る	押し切れ
わらいとばせる	わらいとばせろ
れいする	れいしろ
たゆたう	たゆたえ
もだす	もだせ
驕る	驕れ
起つ	起て
ゆわえつける	ゆわえつけろ
おれまがる	おれまがれ
たのみこむ	たのみこめ
飛び込む	飛び込め
うちしおれる	うちしおれろ
まかりとおる	まかりとおれ
ひび割れる	ひび割れろ
なぎふせる	なぎふせろ
刳り貫く	刳り貫け
潤む	潤め
ときはなつ	ときはなて
際だつ	際だて
煮つける	煮つけろ
吹き払える	吹き払えろ
へたばる	へたばれ
はばたく	はばたけ
切り放す	切り放せ
切抜ける	切抜けろ
競う	競え
いいかねる	いいかねろ
とりはなせる	とりはなせろ
見倣す	見倣せ
煽ぐ	煽げ
かばう	かばえ
唆す	唆せ
飲干す	飲干せ
すわり込む	すわり込め
狙う	狙え
とりかこむ	とりかこめ
彫りあげる	彫りあげろ
打ち合う	打ち合え
みうける	みうけろ
捕れる	捕れろ
のりすごす	のりすごせ
組み敷く	組み敷け
読みかえる	読みかえろ
突き当る	突き当れ
背ける	背けろ
あるきつかれる	あるきつかれろ
そそり立つ	そそり立て
出直す	出直せ
震る	震れ
振い落す	振い落せ
舞あがる	舞あがれ
置きかえる	置きかえろ
務める	務めろ
とじこもる	とじこもれ
脹れる	脹れろ
やせ衰える	やせ衰えろ
瞑る	瞑れ
駆け出す	駆け出せ
賜ぶ	賜べ
聞外す	聞外せ
売り捌く	売り捌け
了する	了しろ
おきあがる	おきあがれ
切り離せる	切り離せろ
据えつける	据えつけろ
のびゆく	のびゆけ
書き下す	書き下せ
司る	司れ
咳きこむ	咳きこめ
ひったくる	ひったくれ
みる	みろ
致す	致せ
ごわつく	ごわつけ
引っこぬく	引っこぬけ
たきあがる	たきあがれ
掻き立てる	掻き立てろ
いろどる	いろどれ
蔽う	蔽え
掻い摘む	掻い摘め
こじれる	こじれろ
聞届ける	聞届けろ
洗上げる	洗上げろ
容態ぶる	容態ぶれ
老ける	老けろ
切り替る	切り替れ
甘やかす	甘やかせ
逐う	逐え
いいかえる	いいかえろ
しょうこだてる	しょうこだてろ
さしこえる	さしこえろ
聞及ぶ	聞及べ
ひきわたせる	ひきわたせろ
はなれる	はなれろ
いさめる	いさめろ
抄く	抄け
かけへだたる	かけへだたれ
踏み込む	踏み込め
くらせる	くらせろ
授かる	授かれ
あじわう	あじわえ
戒める	戒めろ
みとめる	みとめろ
おしつける	おしつけろ
凹ます	凹ませ
塞き上げる	塞き上げろ
ふすぼる	ふすぼれ
かせる	かせろ
荒らげる	荒らげろ
営む	営め
考え直す	考え直せ
おくれる	おくれろ
駆込む	駆込め
あらしまわる	あらしまわれ
居すくまる	居すくまれ
切り開ける	切り開けろ
払い込む	払い込め
見つけだす	見つけだせ
這い蹲う	這い蹲え
老いさらばえる	老いさらばえろ
閉まる	閉まれ
はなす	はなせ
いすわれる	いすわれろ
くらわす	くらわせ
へしあう	へしあえ
突きつめる	突きつめろ
量り込む	量り込め
とくする	とくしろ
取り戻す	取り戻せ
とよむ	とよめ
やり込める	やり込めろ
しゃべる	しゃべれ
嗅ぎ当てる	嗅ぎ当てろ
巻き起す	巻き起せ
ととのえる	ととのえろ
噤む	噤め
調子づく	調子づけ
説明かす	説明かせ
暮らせる	暮らせろ
於く	於け
研ける	研けろ
なぐりとばす	なぐりとばせ
語れる	語れろ
行悩む	行悩め
ふんぎれる	ふんぎれろ
持掛ける	持掛けろ
やけしぬ	やけしね
さしくる	さしくれ
むしる	むしれ
講じる	講じろ
張り込む	張り込め
修まる	修まれ
つれだす	つれだせ
みとおす	みとおせ
もらえる	もらえろ
ふらつく	ふらつけ
断わる	断われ
入れ違う	入れ違え
おりかえす	おりかえせ
当て嵌める	当て嵌めろ
おちゆく	おちゆけ
つくりかえる	つくりかえろ
休む	休め
落ちつける	落ちつけろ
つきのめす	つきのめせ
古ぼける	古ぼけろ
矯める	矯めろ
折り重なる	折り重なれ
入びたる	入びたれ
たてこもれる	たてこもれろ
じょうずる	たてこもれろ
あきれはてる	あきれはてろ
かりだす	かりだせ
はみだす	はみだせ
参じる	参じろ
罷り通る	罷り通れ
醸せる	醸せろ
入り組む	入り組め
うれる	うれろ
選る	選れ
しる	しれ
及ぼせる	及ぼせろ
絎ける	絎けろ
除する	除しろ
へりくだる	へりくだれ
みゃくうつ	みゃくうて
はぐくめる	はぐくめろ
打てる	打てろ
だまし込む	だまし込め
揺るがす	揺るがせ
買い替える	買い替えろ
饗する	饗しろ
汗ばむ	汗ばめ
ひきぐする	ひきぐしろ
刈る	刈れ
走り出る	走り出ろ
賣れる	賣れろ
はめこめる	はめこめろ
来たす	来たせ
まじわる	まじわれ
突当る	突当れ
かさなる	かさなれ
つりあがる	つりあがれ
はせもどる	はせもどれ
刈り込む	刈り込め
たおす	たおせ
のたうち回る	のたうち回れ
目がける	目がけろ
碎ける	碎けろ
おもいうかべる	おもいうかべろ
つっかえせる	つっかえせろ
おわる	おわれ
押寄せる	押寄せろ
いれあわせる	いれあわせろ
凍てる	凍てろ
鋳る	鋳ろ
効く	効け
爪先立つ	爪先立て
おこれる	おこれろ
申し伝える	申し伝えろ
生す	生せ
閉ざす	閉ざせ
焼き付ける	焼き付けろ
借換える	借換えろ
坐りこむ	坐りこめ
あけわたる	あけわたれ
おしかくせる	おしかくせろ
育てる	育てろ
給ぶ	給べ
書き上げる	書き上げろ
えむ	えめ
配る	配れ
のりこなす	のりこなせ
あゆむ	あゆめ
矧げる	矧げろ
突っ走る	突っ走れ
さぐりあてる	さぐりあてろ
飛散る	飛散れ
滅ぼす	滅ぼせ
ふかめる	ふかめろ
縛する	縛しろ
駈る	駈れ
ほりさげる	ほりさげろ
もたせかける	もたせかけろ
わらえる	わらえろ
こじる	こじれ
泣腫らす	泣腫らせ
据付ける	据付けろ
吐出す	吐出せ
焦げる	焦げろ
おしつめる	おしつめろ
隠れる	隠れろ
打倒す	打倒せ
踏み鳴らす	踏み鳴らせ
寄せ付ける	寄せ付けろ
切り掛る	切り掛れ
在る	在れ
だきこめる	だきこめろ
言いたてる	言いたてろ
組み合せる	組み合せろ
いる	いれ
入れあげる	入れあげろ
ごうする	ごうしろ
ねいる	ねいれ
亡くなす	亡くなせ
暴れる	暴れろ
まします	ましませ
ぬきだす	ぬきだせ
なげかける	なげかけろ
荒れ果てる	荒れ果てろ
きこしめす	きこしめせ
噎せる	噎せろ
ひきとれる	ひきとれろ
あらしめる	あらしめろ
うちくだける	うちくだけろ
指す	指せ
つどえる	つどえろ
変える	変えろ
どやしつける	どやしつけろ
消えうせる	消えうせろ
叩き付ける	叩き付けろ
抜き連ねる	抜き連ねろ
飛かかる	飛かかれ
突っころばす	突っころばせ
のこせる	のこせろ
表せる	表せろ
であるく	であるけ
とりにがす	とりにがせ
差入れる	差入れろ
とりさばく	とりさばけ
取り外せる	取り外せろ
まん延する	まん延すろ
嘶く	嘶け
ぶちかます	ぶちかませ
なでつける	なでつけろ
平らぐ	平らげ
吊上げる	吊上げろ
いとう	いとえ
吹きかける	吹きかけろ
くぎる	くぎれ
かい出す	かい出せ
こき使える	こき使えろ
かこえる	かこえろ
とりもどせる	とりもどせろ
たたかう	たたかえ
なげすてる	なげすてろ
刺違える	刺違えろ
汲み込む	汲み込め
つぶせる	つぶせろ
のぼれる	のぼれろ
帰る	帰れ
忌み嫌う	忌み嫌え
熨す	熨せ
盛り分ける	盛り分けろ
なじる	なじれ
ばっする	ばっしろ
偏する	偏しろ
うまれる	うまれろ
ぬきとる	ぬきとれ
大人びる	大人びろ
贏ち得える	贏ち得えろ
差しいれる	差しいれろ
かきつける	かきつけろ
うけたまわる	うけたまわれ
捩じる	捩じれ
重ねる	重ねろ
怖がる	怖がれ
いこう	いこえ
あかるむ	あかるめ
行着く	行着け
燃え上がる	燃え上がれ
乗り後れる	乗り後れろ
盛りあがる	盛りあがれ
怠る	怠れ
入れ代わる	入れ代われ
売れ残る	売れ残れ
よりきる	よりきれ
締付ける	締付けろ
しみつく	しみつけ
取り揃える	取り揃えろ
のりかえる	のりかえろ
ふき清める	ふき清めろ
言い込める	言い込めろ
諒する	諒しろ
寝付ける	寝付けろ
肥える	肥えろ
よみあさる	よみあされ
ののしる	ののしれ
終る	終れ
わりもどす	わりもどせ
うちのめす	うちのめせ
上り詰めるる	上り詰めるろ
買い漁る	買い漁れ
捨てる	捨てろ
神さびる	神さびろ
根ざす	根ざせ
添いとげる	添いとげろ
さそいこむ	さそいこめ
きこえる	きこえろ
連れ立つ	連れ立て
さける	さけろ
成りたつ	成りたて
あけはなす	あけはなせ
遊ぶ	遊べ
たちなおれる	たちなおれろ
書ける	書けろ
なぐさめる	なぐさめろ
出迎える	出迎えろ
つくろう	つくろえ
おぎないあう	おぎないあえ
申し送れる	申し送れろ
冠す	冠せ
仰せつける	仰せつけろ
おいまわす	おいまわせ
にんじる	にんじろ
入れ換える	入れ換えろ
煮あがる	煮あがれ
滑り出す	滑り出せ
もてあそぶ	もてあそべ
拭く	拭け
息吹く	息吹け
つれそえる	つれそえろ
やしなえる	やしなえろ
波立つ	波立て
駆けずり回る	駆けずり回れ
撲り飛ばす	撲り飛ばせ
切り替わる	切り替われ
ふさがる	ふさがれ
たがやせる	たがやせろ
張り付く	張り付け
つぶだつ	つぶだて
奪い取る	奪い取れ
汲み取る	汲み取れ
泣き叫ぶ	泣き叫べ
巣食う	巣食え
だべる	だべれ
嵩ずる	だべれ
できる	できろ
わかせる	わかせろ
ねぢ伏せる	ねぢ伏せろ
問詰める	問詰めろ
ぶらさがれる	ぶらさがれろ
たたきだす	たたきだせ
だきすくめる	だきすくめろ
打ち崩せる	打ち崩せろ
切り換える	切り換えろ
青ばむ	青ばめ
ぬすむ	ぬすめ
腹だてる	腹だてろ
借れる	借れろ
きわめつくす	きわめつくせ
ひきうける	ひきうけろ
並び立つ	並び立て
たてこめる	たてこめろ
窺える	窺えろ
たわむれる	たわむれろ
彌増す	彌増せ
ほっぽる	ほっぽれ
はねつける	はねつけろ
かさねる	かさねろ
擬する	擬しろ
うかび出る	うかび出ろ
濁せる	濁せろ
扱ぐ	扱げ
報じる	報じろ
盗み出せる	盗み出せろ
褪せる	褪せろ
踏ん張れる	踏ん張れろ
ねぎれる	ねぎれろ
勝誇る	勝誇れ
間違う	間違え
ずばぬける	ずばぬけろ
とりなおす	とりなおせ
畳みかける	畳みかけろ
あまんずる	畳みかけろ
しゃっちょこばる	しゃっちょこばれ
きれる	きれろ
くわせる	くわせろ
打ち付ける	打ち付けろ
書取る	書取れ
いける	いけろ
結ぶ	結べ
続く	続け
蒔く	蒔け
浮き立てる	浮き立てろ
くずれる	くずれろ
射る	射ろ
抜け出す	抜け出せ
におわせる	におわせろ
切り崩せる	切り崩せろ
読み通す	読み通せ
憎まれる	憎まれろ
えいずる	憎まれろ
預ける	預けろ
取りしきる	取りしきれ
よせつける	よせつけろ
わらわせる	わらわせろ
うりだす	うりだせ
縛る	縛れ
註する	註しろ
投げ捨てる	投げ捨てろ
つぐ	つげ
のぞむ	のぞめ
振り掛ける	振り掛けろ
上ずる	上ずれ
見出せる	見出せろ
揚げる	揚げろ
くもらす	くもらせ
ゆきかかる	ゆきかかれ
綴合せる	綴合せろ
引去る	引去れ
突き戻せる	突き戻せろ
相寄る	相寄れ
誤魔化す	誤魔化せ
益する	益しろ
あかす	あかせ
つたえる	つたえろ
取止める	取止めろ
悶える	悶えろ
えんずる	悶えろ
害する	害しろ
続ける	続けろ
掠る	掠れ
かいたたける	かいたたけろ
思い起こす	思い起こせ
習える	習えろ
のしあるく	のしあるけ
せめおとせる	せめおとせろ
目差す	目差せ
編み込む	編み込め
たけり立つ	たけり立て
かしげる	かしげろ
みのがせる	みのがせろ
のりくめる	のりくめろ
はる	はれ
もちいる	もちいろ
かたむける	かたむけろ
読み切る	読み切れ
辞す	辞せ
証拠立てる	証拠立てろ
屈める	屈めろ
くみあわす	くみあわせ
凭せ掛ける	凭せ掛けろ
かこう	かこえ
がる	がれ
感じ取る	感じ取れ
ひねる	ひねろ
出外れる	出外れろ
立ち後れる	立ち後れろ
うつりかわる	うつりかわれ
いいあらわす	いいあらわせ
糾う	糾え
つもる	つもれ
ふんする	ふんしろ
振りかぶる	振りかぶれ
剥がす	剥がせ
そめなおす	そめなおせ
賄える	賄えろ
寫す	寫せ
事欠く	事欠け
蒸かす	蒸かせ
みのがす	みのがせ
明け放つ	明け放て
持ち運ぶ	持ち運べ
いざる	いざれ
組合せる	組合せろ
減じる	減じろ
投げ出せる	投げ出せろ
見透かせる	見透かせろ
にらみあわす	にらみあわせ
持ち歩く	持ち歩け
しょびく	しょびけ
浮上がる	浮上がれ
かたりこめる	かたりこめろ
おもいがける	おもいがけろ
とりつげる	とりつげろ
なだれ込む	なだれ込め
かぎる	かぎれ
舞いあがる	舞いあがれ
散らかす	散らかせ
ほりおこす	ほりおこせ
見付ける	見付けろ
切り落とす	切り落とせ
あかめる	あかめろ
生む	生め
貢ぐ	貢げ
おくる	おくれ
攣れる	攣れろ
挟まる	挟まれ
とりまぜる	とりまぜろ
あみこむ	あみこめ
つたえきく	つたえきけ
外す	外せ
交われる	交われろ
わきおこす	わきおこせ
煽てる	煽てろ
きりたつ	きりたて
替わる	替われ
舞い狂う	舞い狂え
憎がる	憎がれ
乗り合わす	乗り合わせ
打落とせる	打落とせろ
とびたてる	とびたてろ
見習う	見習え
くださる	くだされ
ひそむ	ひそめ
跳ね除ける	跳ね除けろ
盗る	盗れ
賑わす	賑わせ
褄取る	褄取れ
削ぎ落す	削ぎ落せ
会す	会せ
踏み抜ける	踏み抜けろ
仰せつかる	仰せつかれ
さしたてる	さしたてろ
出し合う	出し合え
ちょうする	ちょうしろ
しぬ	しね
ぽしゃる	ぽしゃれ
さしつける	さしつけろ
借り入れる	借り入れろ
いいだす	いいだせ
拗じる	拗じれ
こおる	こおれ
食わせる	食わせろ
哀れがる	哀れがれ
煉りあわせる	煉りあわせろ
伏拝む	伏拝め
わかいしあえる	わかいしあえろ
問いつめる	問いつめろ
浮かれる	浮かれろ
わめきたてる	わめきたてろ
学びとれる	学びとれろ
読み下す	読み下せ
首肯く	首肯け
請ける	請けろ
ぶっこぬく	ぶっこぬけ
ぬらす	ぬらせ
えいじる	えいじろ
あれる	あれろ
くつがえる	くつがえれ
飛べる	飛べろ
曳く	曳け
躍る	躍れ
無くなる	無くなれ
おしすすめる	おしすすめろ
ちょうしづく	ちょうしづけ
書添える	書添えろ
法る	法れ
染め直す	染め直せ
仄めかす	仄めかせ
なみだぐむ	なみだぐめ
ゆきなやむ	ゆきなやめ
兆す	兆せ
わずらいつく	わずらいつけ
抱き竦める	抱き竦めろ
惚れる	惚れろ
たえぬく	たえぬけ
おしはかる	おしはかれ
たすけあう	たすけあえ
びびる	びびれ
あふれる	あふれろ
たちあう	たちあえ
わりこめる	わりこめろ
突き破る	突き破れ
ききとがめる	ききとがめろ
律す	律せ
きづかう	きづかえ
差違える	差違えろ
引き降ろす	引き降ろせ
踏み躙る	踏み躙れ
はやり立つ	はやり立て
買い込める	買い込めろ
差し回せる	差し回せろ
やせさらばえる	やせさらばえろ
就ける	就けろ
魅せる	魅せろ
売り飛ばす	売り飛ばせ
こげる	こげろ
たちふさがる	たちふさがれ
くじる	くじれ
あいせっする	あいせっしろ
うつる	うつれ
受付ける	受付けろ
とりしまる	とりしまれ
かちぬく	かちぬけ
申し受ける	申し受けろ
つらぬきとおせる	つらぬきとおせろ
おとろえる	おとろえろ
まぎる	まぎれ
かわりはてる	かわりはてろ
かけちがう	かけちがえ
見回れる	見回れろ
捩くれる	捩くれろ
費やせる	費やせろ
たてまつる	たてまつれ
つかう	つかえ
引き去る	引き去れ
推める	推めろ
引きずり込む	引きずり込め
乗り越える	乗り越えろ
指し示せる	指し示せろ
ほおえむ	ほおえめ
払い込める	払い込めろ
乾す	乾せ
ねざす	ねざせ
掘りだす	掘りだせ
通わす	通わせ
抱き締める	抱き締めろ
堪へる	堪へろ
駆け回る	駆け回れ
攻めかける	攻めかけろ
いさみたつ	いさみたて
讚える	讚えろ
もちかえれる	もちかえれろ
響く	響け
引っ担ぐ	引っ担げ
待ちあわせる	待ちあわせろ
活かる	活かれ
検める	検めろ
呑む	呑め
しだす	しだせ
取りさばく	取りさばけ
おきなおる	おきなおれ
連添う	連添え
脱ぎ捨てる	脱ぎ捨てろ
ふきすさぶ	ふきすさべ
噛み砕く	噛み砕け
使い慣れる	使い慣れろ
とどく	とどけ
入れちがう	入れちがえ
ひっくりかえせる	ひっくりかえせろ
くみなおせる	くみなおせろ
走り出せる	走り出せろ
みくだす	みくだせ
かけずりまわる	かけずりまわれ
噛みしだく	噛みしだけ
おくりこめる	おくりこめろ
位する	位しろ
貰える	貰えろ
意味付ける	意味付けろ
かくする	かくしろ
別ける	別けろ
下りる	下りろ
引き摺る	引き摺れ
とりきめる	とりきめろ
打勝てる	打勝てろ
なぞる	なぞれ
急き立てる	急き立てろ
逃げ失せる	逃げ失せろ
嘗める	嘗めろ
だまる	だまれ
助く	だまれ
うつれる	うつれろ
さししめす	さししめせ
逃げ帰る	逃げ帰れ
そそりたてる	そそりたてろ
よみこなす	よみこなせ
ちりのこる	ちりのこれ
いそぐ	いそげ
吊り上げる	吊り上げろ
償える	償えろ
うやまう	うやまえ
あげる	あげろ
振り起す	振り起せ
食い詰める	食い詰めろ
尊べる	尊べろ
傭う	傭え
おりる	おりろ
乗り捨てる	乗り捨てろ
書きためる	書きためろ
見透かす	見透かせ
突刺す	突刺せ
頷ける	頷けろ
つむ	つめ
つかみあげる	つかみあげろ
見放す	見放せ
染め出せる	染め出せろ
からびる	からびろ
差し押さえる	差し押さえろ
面食らう	面食らえ
締め切る	締め切れ
切れる	切れろ
食い散らす	食い散らせ
潤う	潤え
追いつける	追いつけろ
見取る	見取れ
申送る	申送れ
はぎあわせる	はぎあわせろ
努める	努めろ
おおせつける	おおせつけろ
向く	向け
乗上げる	乗上げろ
足りる	足りろ
縛める	縛めろ
歌わす	歌わせ
おもんみる	おもんみろ
照る	照れ
覚ます	覚ませ
見ほれる	見ほれろ
より抜く	より抜け
駆集める	駆集めろ
とめおく	とめおけ
逞しゅうする	逞しゅうしろ
とりはずす	とりはずせ
睨みつける	睨みつけろ
聞きただせる	聞きただせろ
はいずる	はいずれ
ゆきかう	ゆきかえ
比する	比しろ
けちがえる	けちがえろ
まさぐる	まさぐれ
示し合わす	示し合わせ
植え込む	植え込め
諮る	諮れ
よじのぼれる	よじのぼれろ
預る	預れ
打ちすえる	打ちすえろ
はだける	はだけろ
写し出せる	写し出せろ
ききだす	ききだせ
あばきだす	あばきだせ
投げ付ける	投げ付けろ
あまやかす	あまやかせ
譬える	譬えろ
難ずる	譬えろ
のみくだす	のみくだせ
つむぐ	つむげ
飛び退く	飛び退け
える	えろ
ひったてる	ひったてろ
みがける	みがけろ
はさむ	はさめ
ほこれる	ほこれろ
譲る	譲れ
行き違う	行き違え
落とし込む	落とし込め
懸る	懸れ
尋ねあわせる	尋ねあわせろ
添い遂げる	添い遂げろ
踏み締める	踏み締めろ
飛下りる	飛下りろ
落くぼむ	落くぼめ
呑みつぶす	呑みつぶせ
立ち回る	立ち回れ
降注ぐ	降注げ
とりもつ	とりもて
跳べる	跳べろ
乗合せる	乗合せろ
呑みつぶれる	呑みつぶれろ
遣り返す	遣り返せ
能う	能え
きりふせる	きりふせろ
呑める	呑めろ
へしおる	へしおれ
まいもどる	まいもどれ
示す	示せ
とびかかれる	とびかかれろ
つまされる	つまされろ
統べくくる	統べくくれ
積み替える	積み替えろ
召し上がる	召し上がれ
はりさける	はりさけろ
起こせる	起こせろ
抜かる	抜かれ
はしらす	はしらせ
へばる	へばれ
ふみしめる	ふみしめろ
しにおくれる	しにおくれろ
和える	和えろ
巻く	巻け
溶け合う	溶け合え
墜ちる	墜ちろ
ふんぎる	ふんぎれ
焼切る	焼切れ
駄べる	駄べれ
ゆきくらす	ゆきくらせ
収める	収めろ
道行く	道行け
わび入る	わび入れ
とじこめる	とじこめろ
もたれる	もたれろ
よなれる	よなれろ
ける	けれ
解せる	解せろ
なだれこむ	なだれこめ
讀む	讀め
とりもてる	とりもてろ
寝る	寝ろ
ほろぼす	ほろぼせ
臥す	臥せ
すごむ	すごめ
威かす	威かせ
見返せる	見返せろ
めでる	めでろ
商う	商え
まびく	まびけ
付き合う	付き合え
親しむ	親しめ
解き明かす	解き明かせ
しいる	しいろ
切り苛む	切り苛め
ゆるす	ゆるせ
掘る	掘れ
怖気立つ	怖気立て
はりつく	はりつけ
擦れ合う	擦れ合え
見晴かす	見晴かせ
やとう	やとえ
吹き掛ける	吹き掛けろ
くりのべる	くりのべろ
浮かれ出す	浮かれ出せ
漏らす	漏らせ
支払える	支払えろ
蹴破る	蹴破れ
せりあう	せりあえ
投捨てる	投捨てろ
固まる	固まれ
届出る	届出ろ
卸す	卸せ
吟じる	吟じろ
よたる	よたれ
乗りこえる	乗りこえろ
憩う	憩え
しらばくれる	しらばくれろ
出合える	出合えろ
付入る	付入れ
均す	均せ
元気づける	元気づけろ
打ち明ける	打ち明けろ
言いあわせる	言いあわせろ
ほどける	ほどけろ
浮かび上がれる	浮かび上がれろ
つけ廻す	つけ廻せ
どくづく	どくづけ
おっしゃれる	おっしゃれろ
啀み合う	啀み合え
押しつぶす	押しつぶせ
ひからす	ひからせ
押し黙る	押し黙れ
ねじ込める	ねじ込めろ
くりさげる	くりさげろ
たちあえる	たちあえろ
思し召す	思し召せ
かかわる	かかわれ
群だつ	群だて
ありえる	ありえろ
かぞえあげる	かぞえあげろ
来る	来れ
見合う	見合え
取巻く	取巻け
切りぬく	切りぬけ
いそげる	いそげろ
時化る	時化ろ
召し出す	召し出せ
うけひく	うけひけ
切りはずせる	切りはずせろ
奮いたつ	奮いたて
扼する	扼しろ
生まれ落ちる	生まれ落ちろ
かなえる	かなえろ
なげる	なげろ
あてはめる	あてはめろ
冠する	冠しろ
ゆきすぎる	ゆきすぎろ
よりかかる	よりかかれ
とべる	とべろ
取り計らう	取り計らえ
見違える	見違えろ
立つくす	立つくせ
成る	成れ
ボヤく	ボヤけ
持ちかける	持ちかけろ
煙たがる	煙たがれ
読みこなせる	読みこなせろ
書き流す	書き流せ
沁みる	沁みろ
押しわける	押しわけろ
切り崩す	切り崩せ
慣れる	慣れろ
学び取れる	学び取れろ
かつぎ込める	かつぎ込めろ
借り切る	借り切れ
とりしきる	とりしきれ
起き出す	起き出せ
にらみ合せる	にらみ合せろ
せっする	せっしろ
曲がりくねる	曲がりくねれ
ひらつく	ひらつけ
みこす	みこせ
暈ける	暈けろ
編み上げる	編み上げろ
かけぬける	かけぬけろ
ふるいおとす	ふるいおとせ
かじかむ	かじかめ
せがむ	せがめ
奥まる	奥まれ
ゆみひく	ゆみひけ
備付ける	備付けろ
かかす	かかせ
うつぶす	うつぶせ
はやりたつ	はやりたて
見合わす	見合わせ
染み渡る	染み渡れ
綯う	綯え
そめだす	そめだせ
ふっかける	ふっかけろ
埋め合す	埋め合せ
かくしきばる	かくしきばれ
押し詰まる	押し詰まれ
蹴躓く	蹴躓け
ぬぐいさる	ぬぐいされ
まごう	まごえ
外せる	外せろ
承る	承れ
抜き取れる	抜き取れろ
のっける	のっけろ
どる	どれ
出遅れる	出遅れろ
たくしこむ	たくしこめ
産気づく	産気づけ
みとどける	みとどけろ
振り回す	振り回せ
例える	例えろ
すいとれる	すいとれろ
脇挟む	脇挟め
差し支える	差し支えろ
浮ぶ	浮べ
動ける	動けろ
吹き払う	吹き払え
やくす	やくせ
言渡す	言渡せ
ほっとく	ほっとけ
仕込む	仕込め
立ち至る	立ち至れ
折れ合う	折れ合え
燻べる	燻べろ
誘う	誘え
あらたまる	あらたまれ
造り出す	造り出せ
あそびまわる	あそびまわれ
計らえる	計らえろ
ため込む	ため込め
きおいたつ	きおいたて
たまう	たまえ
死に損なう	死に損なえ
わるびれる	わるびれろ
ひねこびる	ひねこびろ
よりぬける	よりぬけろ
まちぶせる	まちぶせろ
銜える	銜えろ
のぞく	のぞけ
うらがえせる	うらがえせろ
瘠せる	瘠せろ
手懸ける	手懸けろ
はじめる	はじめろ
いとおしむ	いとおしめ
奮い起こせる	奮い起こせろ
わけあたえる	わけあたえろ
取混ぜる	取混ぜろ
突き進める	突き進めろ
生ながらえる	生ながらえろ
でしゃばる	でしゃばれ
ぞめく	ぞめけ
しばたく	しばたけ
立て込める	立て込めろ
かけあえる	かけあえろ
ふりみだす	ふりみだせ
抱き起こす	抱き起こせ
行き悩む	行き悩め
咲き匂う	咲き匂え
おそわる	おそわれ
やかす	やかせ
濯う	濯え
ねりなおせる	ねりなおせろ
いいかわす	いいかわせ
隣り合わす	隣り合わせ
飛びつく	飛びつけ
泊まる	泊まれ
悔やむ	悔やめ
探す	探せ
やりなおせる	やりなおせろ
おしだせる	おしだせろ
閉じる	閉じろ
出っぱる	出っぱれ
掠れる	掠れろ
せく	せけ
弾き返せる	弾き返せろ
くだせる	くだせろ
召しあがる	召しあがれ
傳える	傳えろ
もちよる	もちよれ
立向かう	立向かえ
春めく	春めけ
ころす	ころせ
嗅ぎ出す	嗅ぎ出せ
培う	培え
降り掛かる	降り掛かれ
剽げる	剽げろ
造りあげる	造りあげろ
ときはなす	ときはなせ
取下げる	取下げろ
おもる	おもれ
つめる	つめろ
ほうむる	ほうむれ
刻み込む	刻み込め
廃する	廃しろ
遅れる	遅れろ
つけあわせる	つけあわせろ
撲り付ける	撲り付けろ
いいおく	いいおけ
荒す	荒せ
書き記せる	書き記せろ
揃う	揃え
しのびこむ	しのびこめ
投じる	投じろ
填め込む	填め込め
もてる	もてろ
うりわたす	うりわたせ
銜める	銜めろ
買い上げる	買い上げろ
寝つける	寝つけろ
染みつく	染みつけ
取り集める	取り集めろ
すぎゆく	すぎゆけ
耳馴れる	耳馴れろ
ゆるまる	ゆるまれ
練り合せる	練り合せろ
途切れる	途切れろ
かいすすむ	かいすすめ
狂わせる	狂わせろ
興せる	興せろ
停める	停めろ
け落とす	け落とせ
燃す	燃せ
のぼる	のぼれ
のぼりつめる	のぼりつめろ
うれのこる	うれのこれ
酔っ払う	酔っ払え
嘆ずる	酔っ払え
あけくれる	あけくれろ
たちまじる	たちまじれ
くりあげる	くりあげろ
攻懸ける	攻懸けろ
言い交す	言い交せ
かぞえたてる	かぞえたてろ
ふさぎこむ	ふさぎこめ
伝へる	伝へろ
冲する	冲しろ
むき出す	むき出せ
きりおとせる	きりおとせろ
とじる	とじろ
着せる	着せろ
怨する	怨しろ
かいま見る	かいま見ろ
いいふくめる	いいふくめろ
けむたがる	けむたがれ
紛れる	紛れろ
取付ける	取付けろ
築く	築け
拓ける	拓けろ
引き離す	引き離せ
凝固まる	凝固まれ
焼き付く	焼き付け
痛めつける	痛めつけろ
着替える	着替えろ
かためる	かためろ
気構える	気構えろ
突っつく	突っつけ
すりあがる	すりあがれ
引下がる	引下がれ
いこう	いこえ
かぎ出す	かぎ出せ
ぼやかす	ぼやかせ
みつける	みつけろ
綾取る	綾取れ
申し出る	申し出ろ
すっぱぬく	すっぱぬけ
降らす	降らせ
すっぱ抜く	すっぱ抜け
迂る	迂れ
すき通る	すき通れ
献じる	献じろ
ぶっ殺す	ぶっ殺せ
支払う	支払え
打破れる	打破れろ
産み落す	産み落せ
ふりかえる	ふりかえろ
出尽くす	出尽くせ
つけいる	つけいれ
もてはやす	もてはやせ
含める	含めろ
困じる	困じろ
かりる	かりろ
救い出す	救い出せ
気に入る	気に入れ
窮する	窮しろ
ばる	ばれ
はしりぬく	はしりぬけ
捲く	捲け
てりはえる	てりはえろ
おもてだつ	おもてだて
ちかよれる	ちかよれろ
零す	零せ
膿む	膿め
鋤く	鋤け
せおう	せおえ
はりきる	はりきれ
入れ忘れる	入れ忘れろ
きずきあげる	きずきあげろ
決込む	決込め
落ち行く	落ち行け
危惧す	危惧せ
おいこせる	おいこせろ
貸し付ける	貸し付けろ
連立つ	連立て
むすぼれる	むすぼれろ
差越す	差越せ
芽ばえる	芽ばえろ
まぜあわせる	まぜあわせろ
汲み干す	汲み干せ
執り行う	執り行え
領する	領しろ
走り去る	走り去れ
やり合う	やり合え
見守る	見守れ
取鎮める	取鎮めろ
りょうする	りょうしろ
ほる	ほれ
条件付ける	条件付けろ
時めく	時めけ
ともなえる	ともなえろ
たいおうづける	たいおうづけろ
つりだす	つりだせ
障る	障れ
ぞうする	ぞうしろ
投げかける	投げかけろ
たれこむ	たれこめ
およぎつく	およぎつけ
捕らえる	捕らえろ
つみこめる	つみこめろ
たすけだせる	たすけだせろ
待受ける	待受けろ
おびきよせる	おびきよせろ
順序づける	順序づけろ
あまったれる	あまったれろ
とおす	とおせ
空嘯く	空嘯け
追い抜ける	追い抜けろ
夏めく	夏めけ
乗掛ける	乗掛けろ
請け負える	請け負えろ
据える	据えろ
毀す	毀せ
笑う	笑え
なみいる	なみいろ
笑いこける	笑いこけろ
差しかかる	差しかかれ
引っ下げる	引っ下げろ
そそる	そそれ
殺る	殺れ
おびき出す	おびき出せ
おっぽりだす	おっぽりだせ
乗れる	乗れろ
延びる	延びろ
つりあげる	つりあげろ
やきつく	やきつけ
はにかむ	はにかめ
向き合える	向き合えろ
研く	研け
探しあてる	探しあてろ
捩じ切る	捩じ切れ
先ばしる	先ばしれ
請け合える	請け合えろ
いかす	いかせ
名乗り出る	名乗り出ろ
混む	混め
すっぱ抜ける	すっぱ抜けろ
揉める	揉めろ
まよいこむ	まよいこめ
乱れ飛ぶ	乱れ飛べ
則す	則せ
当たる	当たれ
焼け死ぬ	焼け死ね
浮足立つ	浮足立て
はずせる	はずせろ
死そこなう	死そこなえ
寄り合う	寄り合え
つつめる	つつめろ
取調べる	取調べろ
列なる	列なれ
題する	題しろ
はらいのける	はらいのけろ
なげとばせる	なげとばせろ
えきする	えきしろ
督する	督しろ
振り向ける	振り向けろ
ならす	ならせ
はさみこむ	はさみこめ
とりのける	とりのけろ
たっとぶ	たっとべ
付く	付け
寄り倒せる	寄り倒せろ
嫉む	嫉め
くたばる	くたばれ
加わる	加われ
汲み上げる	汲み上げろ
乗りはずす	乗りはずせ
はらむ	はらめ
絞りあげる	絞りあげろ
出食わす	出食わせ
くんずる	出食わせ
済ませる	済ませろ
なしとげる	なしとげろ
釣る	釣れ
富む	富め
取計らう	取計らえ
そばだてる	そばだてろ
ほつす	ほつせ
切り出せる	切り出せろ
流れ着ける	流れ着けろ
言い終わる	言い終われ
駆けつける	駆けつけろ
みなせる	みなせろ
のく	のけ
くぼむ	くぼめ
読み取る	読み取れ
うたえる	うたえろ
にげまわれる	にげまわれろ
類する	類しろ
立つ	立て
おっしゃる	おっしゃれ
弱る	弱れ
サジェストする	サジェストしろ
写し取る	写し取れ
泣き暮す	泣き暮せ
受け流す	受け流せ
サボる	サボれ
張合う	張合え
絆される	絆されろ
張り替える	張り替えろ
引き渡せる	引き渡せろ
掻い潜る	掻い潜れ
もれる	もれろ
ききあわす	ききあわせ
もらえる	もらえろ
差し迫る	差し迫れ
撲る	撲れ
擲つ	擲て
割り振る	割り振れ
鳴りわたる	鳴りわたれ
ちがえる	ちがえろ
しだれる	しだれろ
くるめる	くるめろ
いざなう	いざなえ
ごまかせる	ごまかせろ
囁く	囁け
ずれる	ずれろ
あけのこる	あけのこれ
ひきつげる	ひきつげろ
すべらす	すべらせ
ぶん殴る	ぶん殴れ
言い古す	言い古せ
ついて行く	ついて行け
立直す	立直せ
まにあう	まにあえ
下がる	下がれ
吹かす	吹かせ
住み馴れる	住み馴れろ
はじる	はじろ
見せ掛ける	見せ掛けろ
ぶった斬る	ぶった斬れ
こたえる	こたえろ
蒸返す	蒸返せ
踏み倒せる	踏み倒せろ
鳴き頻る	鳴き頻れ
たどる	たどれ
時代掛る	時代掛れ
踊りあかす	踊りあかせ
踏みこむ	踏みこめ
吹きこぼれる	吹きこぼれろ
頭立つ	頭立て
おびきだす	おびきだせ
もの問う	もの問え
つぎこめる	つぎこめろ
そくする	そくしろ
貯まる	貯まれ
すりぬける	すりぬけろ
比える	比えろ
くり貫ける	くり貫けろ
かすれる	かすれろ
格式張る	格式張れ
ふくらす	ふくらせ
なんずる	ふくらせ
踏こたえる	踏こたえろ
踊れる	踊れろ
書き残せる	書き残せろ
なきふせる	なきふせろ
逃うせる	逃うせろ
たせる	たせろ
休める	休めろ
いわう	いわえ
攻寄る	攻寄れ
そびれる	そびれろ
ねすごす	ねすごせ
聞き漏らす	聞き漏らせ
溶ける	溶けろ
うつりすむ	うつりすめ
贈る	贈れ
受け引く	受け引け
上回る	上回れ
とびこす	とびこせ
あぐむ	あぐめ
もうける	もうけろ
ありふれる	ありふれろ
はみでる	はみでろ
起こる	起これ
裏付ける	裏付けろ
こくする	こくしろ
とりたてる	とりたてろ
馴らす	馴らせ
たける	たけれ
くみしく	くみしけ
隔たる	隔たれ
つぎ足す	つぎ足せ
みそれる	みそれろ
ちぬる	ちぬれ
にせる	にせろ
鳴かせる	鳴かせろ
裏づける	裏づけろ
こぎつける	こぎつけろ
絡み合う	絡み合え
鳴ける	鳴けろ
賑わわす	賑わわせ
いいあてる	いいあてろ
解ける	解けろ
差かかる	差かかれ
住み荒らす	住み荒らせ
ねしずまる	ねしずまれ
染める	染めろ
打ちきる	打ちきれ
とりあつかう	とりあつかえ
先んじる	先んじろ
世馴れる	世馴れろ
はぶく	はぶけ
写し取れる	写し取れろ
うえこむ	うえこめ
泣き込む	泣き込め
突っ張る	突っ張れ
すいこむ	すいこめ
まぬがれる	まぬがれろ
引替える	引替えろ
とおりぬける	とおりぬけろ
適する	適しろ
打明ける	打明けろ
思いこむ	思いこめ
博する	博しろ
満ちる	満ちろ
むけなおす	むけなおせ
白ける	白けろ
申しつける	申しつけろ
すすばむ	すすばめ
ゆきつく	ゆきつけ
いいくらす	いいくらせ
はい出す	はい出せ
生み出す	生み出せ
たのみいる	たのみいれ
まぎれこめる	まぎれこめろ
はばたける	はばたけろ
差し掛る	差し掛れ
かきあらわせる	かきあらわせろ
こめる	こめろ
とりだす	とりだせ
せめあう	せめあえ
きる	きろ
こまねく	こまねけ
信じる	信じろ
込入る	込入れ
ほろぶ	ほろべ
論ずる	ほろべ
うちかてる	うちかてろ
おりかさねる	おりかさねろ
ぶり返す	ぶり返せ
広まる	広まれ
引きちぎる	引きちぎれ
突ける	突けろ
がさつく	がさつけ
恋いこがれる	恋いこがれろ
ふっきる	ふっきれ
頼れる	頼れろ
召寄せる	召寄せろ
ひえこむ	ひえこめ
顰める	顰めろ
踏みにじれる	踏みにじれろ
食いつなぐ	食いつなげ
そうけだつ	そうけだて
取り付く	取り付け
たてかける	たてかけろ
かきわける	かきわけろ
聴き込む	聴き込め
あやかる	あやかれ
説きあるく	説きあるけ
ふりきる	ふりきれ
せめよる	せめよれ
蒸れる	蒸れろ
あらいおとせる	あらいおとせろ
連れ出す	連れ出せ
よりきれる	よりきれろ
言いくらす	言いくらせ
のっとる	のっとれ
抱える	抱えろ
へし合う	へし合え
とりはらう	とりはらえ
冷やかせる	冷やかせろ
嘆き明かす	嘆き明かせ
刈取る	刈取れ
ともる	ともれ
称する	称しろ
ほっつく	ほっつけ
撃ちまくる	撃ちまくれ
ほろびる	ほろびろ
みまわれる	みまわれろ
かさむ	かさめ
融ける	融けろ
申し送る	申し送れ
売り付ける	売り付けろ
だしぬける	だしぬけろ
ひっくりかえる	ひっくりかえれ
詰め替える	詰め替えろ
問える	問えろ
刻する	刻しろ
踏みつける	踏みつけろ
信じ込む	信じ込め
照り返す	照り返せ
選り分ける	選り分けろ
くいる	くいろ
ゆうする	ゆうしろ
乗入れる	乗入れろ
注する	注しろ
ゆるぐ	ゆるげ
断ち割れる	断ち割れろ
受け持てる	受け持てろ
吹き荒れる	吹き荒れろ
見えすく	見えすけ
となりあわせる	となりあわせろ
あいなる	あいなれ
求める	求めろ
置き換わる	置き換われ
たれる	たれろ
うら枯れる	うら枯れろ
沸き起こる	沸き起これ
ねぐる	ねぐれ
押し広める	押し広めろ
みすます	みすませ
樵る	樵れ
寝せる	寝せろ
吹き返す	吹き返せ
ささえる	ささえろ
染めあげる	染めあげろ
とりかえせる	とりかえせろ
もりつける	もりつけろ
索く	索け
ちぎれる	ちぎれろ
脂ぎる	脂ぎれ
思い描く	思い描け
ぬかる	ぬかれ
かいとる	かいとれ
かもす	かもせ
くつろげる	くつろげろ
そびえる	そびえろ
遮る	遮れ
くつろぐ	くつろげ
遊び呆ける	遊び呆けろ
明ける	明けろ
につく	につけ
せき入る	せき入れ
澄み渡る	澄み渡れ
ひきだす	ひきだせ
言う	言え
のさばる	のさばれ
みちる	みちろ
ひらける	ひらけろ
鼻白む	鼻白め
いてる	いてろ
馴れる	馴れろ
なまめく	なまめけ
くれる	くれろ
おしかぶさる	おしかぶされ
まくし立てる	まくし立てろ
接ぎ合わせる	接ぎ合わせろ
かきおろす	かきおろせ
差止める	差止めろ
きりかける	きりかけろ
絶え入る	絶え入れ
浮き上がれる	浮き上がれろ
持ち切る	持ち切れ
拵える	拵えろ
かみころせる	かみころせろ
あきれかえる	あきれかえれ
はげ上がる	はげ上がれ
とり成す	とり成せ
慨する	慨しろ
飲み干せる	飲み干せろ
揺出る	揺出ろ
付け入る	付け入れ
かぎだせる	かぎだせろ
おもねる	おもねれ
拐かす	拐かせ
ねむらせる	ねむらせろ
しゃべれる	しゃべれろ
云う	云え
さしまわす	さしまわせ
噴く	噴け
呼び交す	呼び交せ
あなどれる	あなどれろ
ぶっつかる	ぶっつかれ
立ち添う	立ち添え
重る	重れ
くみだせる	くみだせろ
すすみでる	すすみでろ
架する	架しろ
復す	復せ
ふける	ふけれ
嗅ぎ付ける	嗅ぎ付けろ
事える	事えろ
希う	希え
酌み交す	酌み交せ
聞かす	聞かせ
進み出る	進み出ろ
さまよう	さまよえ
敷ける	敷けろ
吸う	吸え
みじろぐ	みじろげ
もりあわす	もりあわせ
ぶったくる	ぶったくれ
ついてる	ついてろ
ばらまく	ばらまけ
かぎあてる	かぎあてろ
かち取る	かち取れ
つなぐ	つなげ
漬込む	漬込め
引き続ける	引き続けろ
追使う	追使え
乗り遅れる	乗り遅れろ
放り込む	放り込め
差し当る	差し当れ
讒する	讒しろ
見える	見えろ
見越せる	見越せろ
聴き入る	聴き入れ
仕掛る	仕掛ろ
混じえる	混じえろ
しぼりとれる	しぼりとれろ
ふきとれる	ふきとれろ
剃り忘れる	剃り忘れろ
こんずる	剃り忘れろ
たわめる	たわめろ
創れる	創れろ
締める	締めろ
取りはずす	取りはずせ
談じ込む	談じ込め
決定づける	決定づけろ
出し抜ける	出し抜けろ
だきおこせる	だきおこせろ
言い落す	言い落せ
吹き抜ける	吹き抜けろ
あざむく	あざむけ
言い合う	言い合え
うぬぼれる	うぬぼれろ
浮き出る	浮き出ろ
埋めあわせる	埋めあわせろ
かき揚げる	かき揚げろ
はぐくむ	はぐくめ
取り残す	取り残せ
見澄ます	見澄ませ
うちだせる	うちだせろ
ことなる	ことなれ
捕える	捕えろ
空うそぶく	空うそぶけ
遠のく	遠のけ
先立てる	先立てろ
練れる	練れろ
さとせる	さとせろ
いりまじる	いりまじれ
留まれる	留まれろ
突き破れる	突き破れろ
取り逃す	取り逃せ
よじる	よじろ
お目にかかる	お目にかかれ
じゃらす	じゃらせ
濁らす	濁らせ
聞出す	聞出せ
促す	促せ
飲み乾す	飲み乾せ
深ける	深けろ
うなづく	うなづけ
とびあがる	とびあがれ
寄添う	寄添え
拝み倒す	拝み倒せ
とおざかる	とおざかれ
映し出せる	映し出せろ
行暮れる	行暮れろ
買い付ける	買い付けろ
ひきいる	ひきいろ
くりかえる	くりかえろ
ハヤる	ハヤれ
呑み潰れる	呑み潰れろ
あらいあげる	あらいあげろ
焼き捨てる	焼き捨てろ
しにそこなう	しにそこなえ
伸びる	伸びろ
乗る	乗れ
睨み付ける	睨み付けろ
しなだれる	しなだれろ
取り込む	取り込め
引き締る	引き締れ
差換える	差換えろ
捩じ込む	捩じ込め
払いのける	払いのけろ
煮立つ	煮立て
さそいかける	さそいかけろ
被せる	被せろ
くつがえせる	くつがえせろ
そぼふる	そぼふれ
はげあがる	はげあがれ
聞く	聞け
あたれる	あたれろ
懲らしめる	懲らしめろ
そめわける	そめわけろ
差掛る	差掛れ
折合う	折合え
託する	託しろ
ぬいあげる	ぬいあげろ
乗り合せる	乗り合せろ
うたいあげる	うたいあげろ
なきわめく	なきわめけ
書きつける	書きつけろ
締出す	締出せ
無くする	無くしろ
けいする	けいしろ
にじり寄る	にじり寄れ
辿れる	辿れろ
苦りきる	苦りきれ
ひやかす	ひやかせ
愚痴る	愚痴れ
毟る	毟れ
打ち倒す	打ち倒せ
てきする	てきしろ
えがきだせる	えがきだせろ
遣り遂げる	遣り遂げろ
稔る	稔れ
きりこめる	きりこめろ
よみあげる	よみあげろ
いつわる	いつわれ
たれこめる	たれこめろ
飛かける	飛かけれ
取り締まる	取り締まれ
ずらせる	ずらせろ
とりされる	とりされろ
買いたたける	買いたたけろ
いこぼれる	いこぼれろ
くみする	くみしろ
浮かせる	浮かせろ
応える	応えろ
侵せる	侵せろ
そそりたつ	そそりたて
探り出す	探り出せ
言い交わす	言い交わせ
ぬくもる	ぬくもれ
持崩す	持崩せ
ちぢみあがる	ちぢみあがれ
窄む	窄め
厭う	厭え
はやらす	はやらせ
おっぱじめる	おっぱじめろ
望める	望めろ
なりひびく	なりひびけ
証する	証しろ
省ける	省けろ
たまる	たまれ
あらいたてる	あらいたてろ
逃げ回れる	逃げ回れろ
うちころす	うちころせ
張付ける	張付けろ
すすめる	すすめろ
懲らす	懲らせ
涌く	涌け
しょうする	しょうしろ
はしりだす	はしりだせ
しわばむ	しわばめ
心がける	心がけろ
突抜ける	突抜けろ
為さる	為され
擦りむく	擦りむけ
売り抜ける	売り抜けろ
つうがる	つうがれ
すみかえる	すみかえろ
あらせる	あらせろ
さわぎたてる	さわぎたてろ
得る	さわぎたてろ
なつける	なつけろ
染返す	染返せ
立ち上る	立ち上れ
あわだてる	あわだてろ
よみながす	よみながせ
下びる	下びろ
おさめる	おさめろ
張り巡らせる	張り巡らせろ
ひろがる	ひろがれ
ぎむづける	ぎむづけろ
かりあつめる	かりあつめろ
行き逢う	行き逢え
闌ける	闌けろ
溜まる	溜まれ
心する	心しろ
修める	修めろ
みほれる	みほれろ
でっちあげる	でっちあげろ
すくいだす	すくいだせ
困り果てる	困り果てろ
受け付ける	受け付けろ
申し述べる	申し述べろ
問い質す	問い質せ
捧ぐ	問い質せ
燃え盛る	燃え盛れ
寄せつける	寄せつけろ
篭もれる	篭もれろ
鳴り響く	鳴り響け
蹴っ飛ばす	蹴っ飛ばせ
いきづく	いきづけ
こまりぬく	こまりぬけ
沁む	沁め
うちたおす	うちたおせ
触れ合う	触れ合え
持ちこたえる	持ちこたえろ
馳せる	馳せろ
おりこむ	おりこめ
ふく	ふけ
振回す	振回せ
ねがえる	ねがえれ
こづきまわす	こづきまわせ
火取る	火取れ
履違える	履違えろ
とりもどす	とりもどせ
乗じる	乗じろ
切る	切れ
ひろめる	ひろめろ
引き出せる	引き出せろ
弥立つ	弥立て
かち得る	かち得ろ
啄める	啄めろ
かきくどく	かきくどけ
取り捨てる	取り捨てろ
めぐらす	めぐらせ
差しかざす	差しかざせ
よる	よれ
召抱える	召抱えろ
ひかえる	ひかえろ
きかざる	きかざれ
下押す	下押せ
押し下げる	押し下げろ
ねとぼける	ねとぼけろ
やじれる	やじれろ
急く	急け
しかれる	しかれろ
いきりたつ	いきりたて
細る	細れ
とろかす	とろかせ
取り計らえる	取り計らえろ
刺せる	刺せろ
聞きあわせる	聞きあわせろ
くずれおちる	くずれおちろ
はげむ	はげめ
ほうこうづける	ほうこうづけろ
語り掛ける	語り掛けろ
埋ける	埋けろ
這出る	這出ろ
跳あがる	跳あがれ
もげる	もげろ
アガる	アガれ
落ちつく	落ちつけ
しぼりあげる	しぼりあげろ
込む	込め
踏込む	踏込め
めくれる	めくれろ
飛付く	飛付け
引渡す	引渡せ
絞まる	絞まれ
寝転がる	寝転がれ
ぬけあがる	ぬけあがれ
示し合わせる	示し合わせろ
漬けこむ	漬けこめ
実る	実れ
いく	いけ
特徴付ける	特徴付けろ
送りだす	送りだせ
住める	住めろ
縮みあがる	縮みあがれ
よみこめる	よみこめろ
買い尽くす	買い尽くせ
衝ける	衝けろ
またがる	またがれ
はぜる	はぜろ
まなびとる	まなびとれ
乗り過ごす	乗り過ごせ
並ぶ	並べ
取り離せる	取り離せろ
孕む	孕め
いりこむ	いりこめ
いきごむ	いきごめ
よみあわせる	よみあわせろ
くらえる	くらえろ
吹き出す	吹き出せ
ひきずりこめる	ひきずりこめろ
おきだす	おきだせ
呈す	呈せ
起き上がる	起き上がれ
降り頻る	降り頻れ
さえぎれる	さえぎれろ
ためせる	ためせろ
委ねる	委ねろ
引き繕う	引き繕え
ひびく	ひびけ
殖やす	殖やせ
連れ添う	連れ添え
いばる	いばれ
もりあげる	もりあげろ
立て替える	立て替えろ
甘んじる	甘んじろ
掃ける	掃けろ
浮かれ出でる	浮かれ出でろ
底知る	底知れ
散りばめる	散りばめろ
乗切る	乗切れ
ぬいこめる	ぬいこめろ
いんする	いんしろ
鳴く	鳴け
通す	通せ
ひろいあげる	ひろいあげろ
稼げる	稼げろ
待ち望む	待ち望め
登る	登れ
超せる	超せろ
みむく	みむけ
寝つく	寝つけ
言合う	言合え
なずむ	なずめ
臨む	臨め
押し倒す	押し倒せ
飛歩く	飛歩け
駈ける	駈けろ
引き摺り込む	引き摺り込め
悄げる	悄げろ
でまわる	でまわれ
織り成す	織り成せ
つっつく	つっつけ
致す	致せ
根付く	根付け
きりかえる	きりかえろ
はぎあわす	はぎあわせ
言含める	言含めろ
うとむ	うとめ
寄すがる	寄すがれ
謗る	謗れ
閉こもる	閉こもれ
みあげる	みあげろ
追いたてる	追いたてろ
うかる	うかれ
攻立てる	攻立てろ
抱きすくめる	抱きすくめろ
間ぎる	間ぎれ
ながれだす	ながれだせ
払い出せる	払い出せろ
蒸し返す	蒸し返せ
回れる	回れろ
みなぎる	みなぎれ
曝せる	曝せろ
まぜる	まぜろ
こぼれ落ちる	こぼれ落ちろ
頼み込める	頼み込めろ
まちわびる	まちわびろ
引止める	引止めろ
寸たる	寸たれ
薦める	薦めろ
押す	押せ
合わさる	合わされ
歩む	歩め
如く	如け
鞘走る	鞘走れ
まんずる	鞘走れ
こごめる	こごめろ
ふらせる	ふらせろ
すわれる	すわれろ
連込む	連込め
在す	在せ
みだす	みだせ
こわれる	こわれろ
磨り潰す	磨り潰せ
あぶる	あぶれ
利かす	利かせ
売りとばす	売りとばせ
そんする	そんしろ
つみかさなる	つみかさなれ
仕える	仕えろ
拗る	拗れ
買受ける	買受けろ
透く	透け
怒鳴る	怒鳴れ
萎びる	萎びろ
扱う	扱え
ながれつく	ながれつけ
られる	られろ
切込む	切込め
差し置く	差し置け
見返る	見返れ
まさる	まされ
鎧う	鎧え
早まる	早まれ
隠せる	隠せろ
熟む	熟め
しがみつける	しがみつけろ
ついえる	ついえろ
かむる	かむれ
呵する	呵しろ
討ちとる	討ちとれ
しるせる	しるせろ
血塗る	血塗れ
降り敷く	降り敷け
書く	書け
嵩じる	嵩じろ
もちあがる	もちあがれ
吸う	吸え
もだえる	もだえろ
追い回せる	追い回せろ
食わす	食わせ
思す	思せ
書きいれる	書きいれろ
ふきとばす	ふきとばせ
感じ取れる	感じ取れろ
いいふらす	いいふらせ
散り敷く	散り敷け
奪う	奪え
ねぎらう	ねぎらえ
働く	働け
競える	競えろ
たかまる	たかまれ
捻れる	捻れろ
そだてあげる	そだてあげろ
縺れる	縺れろ
亙れる	亙れろ
よみとる	よみとれ
あかじみる	あかじみろ
はりたおす	はりたおせ
取揃える	取揃えろ
くくめる	くくめろ
差しかける	差しかけろ
とどろかす	とどろかせ
もやす	もやせ
伸す	伸せ
討ち果す	討ち果せ
むかえうつ	むかえうて
もつれこむ	もつれこめ
寄付く	寄付け
あげつらう	あげつらえ
しゃする	しゃしろ
偲べる	偲べろ
てらせる	てらせろ
移り住む	移り住め
延す	延せ
そらす	そらせ
惘れる	惘れろ
言い替える	言い替えろ
屈す	屈せ
寿ぐ	寿げ
際立つ	際立て
違える	違えろ
そそのかす	そそのかせ
来す	来せ
並べたてる	並べたてろ
相せっする	相せっしろ
盾突く	盾突け
くすべる	くすべろ
突っこむ	突っこめ
はれわたる	はれわたれ
あぶれる	あぶれろ
組みいれる	組みいれろ
つどう	つどえ
めばえる	めばえろ
蓄える	蓄えろ
いつく	いつけ
見渡す	見渡せ
たとえる	たとえろ
とけこむ	とけこめ
赤茶ける	赤茶けろ
背負い込める	背負い込めろ
切掛ける	切掛けろ
おびく	おびけ
漲る	漲れ
背負い込む	背負い込め
落ち合える	落ち合えろ
かりたおす	かりたおせ
ふりまける	ふりまけろ
とける	とけろ
差出る	差出ろ
おいこめる	おいこめろ
なめる	なめろ
たくれる	たくれろ
騒ぎ立てる	騒ぎ立てろ
繋ぐ	繋げ
にこめる	にこめろ
おもいおこせる	おもいおこせろ
遂せる	遂せろ
煮込む	煮込め
つっかえる	つっかえろ
横切る	横切れ
勘ぐる	勘ぐれ
遊び回る	遊び回れ
外れる	外れろ
切結ぶ	切結べ
かずく	かずけ
つけだす	つけだせ
あいつづく	あいつづけ
守立てる	守立てろ
のたまう	のたまえ
窮める	窮めろ
落とす	落とせ
うけとめる	うけとめろ
行き交う	行き交え
降る	降れ
買いかぶる	買いかぶれ
思い出す	思い出せ
受かる	受かれ
はりあわせる	はりあわせろ
くみあわせる	くみあわせろ
絶やす	絶やせ
齧り付く	齧り付け
おこないすます	おこないすませ
呑みこむ	呑みこめ
具わる	具われ
送り出せる	送り出せろ
いっする	いっしろ
塞く	塞け
仕る	仕れ
突っぷす	突っぷせ
もみけせる	もみけせろ
吸える	吸えろ
つきあう	つきあえ
きざむ	きざめ
敬する	敬しろ
しゃちこばる	しゃちこばれ
弾き出せる	弾き出せろ
宛てる	宛てろ
選りすぐる	選りすぐれ
思い止まる	思い止まれ
ふりあてる	ふりあてろ
打ち立てる	打ち立てろ
欲する	欲しろ
なめす	なめせ
食む	食め
即ける	即けろ
駆け抜ける	駆け抜けろ
染み着く	染み着け
増す	増せ
沸き立つ	沸き立て
駆ける	駆けろ
すう	すえ
受け取る	受け取れ
たくる	たくれ
蒸す	蒸せ
透通る	透通れ
老け込む	老け込め
見倣う	見倣え
持出す	持出せ
限る	限れ
しにわかれる	しにわかれろ
つっころばす	つっころばせ
図る	図れ
手なれる	手なれろ
あるきつめる	あるきつめれ
忘れ去る	忘れ去れ
忍べる	忍べろ
交わせる	交わせろ
取払う	取払え
くゆらす	くゆらせ
打ち消す	打ち消せ
厭きる	厭きろ
行きかかる	行きかかれ
覆う	覆え
読み比べる	読み比べろ
役に立つ	役に立て
滑り降ちる	滑り降ちろ
おがみたおす	おがみたおせ
盛り合わせる	盛り合わせろ
なぐれる	なぐれろ
突き戻す	突き戻せ
あり	あれ
追抜く	追抜け
ひやす	ひやせ
ひきつづく	ひきつづけ
響かす	響かせ
駆り催す	駆り催せ
送り付ける	送り付けろ
仕組む	仕組め
磨きあげる	磨きあげろ
湿る	湿れ
ぱらつく	ぱらつけ
攫む	攫め
先立つ	先立て
分かる	分かれ
股がる	股がれ
倒れ込む	倒れ込め
ひるがえる	ひるがえれ
見つける	見つけろ
褒めちぎる	褒めちぎれ
取り払う	取り払え
駆出す	駆出せ
取り押さえる	取り押さえろ
釣り込む	釣り込め
けしとめる	けしとめろ
上廻る	上廻れ
転がれる	転がれろ
とりのぞく	とりのぞけ
打勝つ	打勝て
寄りかかる	寄りかかれ
溶けだす	溶けだせ
せいだす	せいだせ
さそいだす	さそいだせ
かきさす	かきさせ
飲みこむ	飲みこめ
蘇る	蘇れ
掛け合う	掛け合え
かいだす	かいだせ
打ち落す	打ち落せ
穫る	穫れ
妻せる	妻せろ
じらす	じらせ
あふる	あふれ
ムキになる	ムキになれ
食入る	食入れ
言い聞かす	言い聞かせ
聞き咎める	聞き咎めろ
よみきる	よみきれ
取らせる	取らせろ
ねむりこける	ねむりこけろ
名乗る	名乗れ
過ぎる	過ぎれ
とりはなす	とりはなせ
いいそびれる	いいそびれろ
ぎんじる	ぎんじろ
絞り出す	絞り出せ
乗り越す	乗り越せ
おしたおせる	おしたおせろ
かどだてる	かどだてろ
染直す	染直せ
こしかける	こしかけろ
にげこめる	にげこめろ
ぬりつぶせる	ぬりつぶせろ
よごれる	よごれろ
ゆるむ	ゆるめ
突き上げる	突き上げろ
ふれこめる	ふれこめろ
据え置く	据え置け
灯す	灯せ
入り替る	入り替れ
投げ入れる	投げ入れろ
居こぼれる	居こぼれろ
外らす	外らせ
もりこむ	もりこめ
腫らす	腫らせ
繰りかえす	繰りかえせ
誉めそやす	誉めそやせ
ききとどける	ききとどけろ
すっぱぬける	すっぱぬけろ
ぼやく	ぼやけ
掻き合せる	掻き合せろ
そがれる	そがれろ
食い足りる	食い足りろ
荒し回る	荒し回れ
解く	解け
ぶれる	ぶれろ
つめこむ	つめこめ
ちかよる	ちかよれ
仕付ける	仕付けろ
拘る	拘れ
投げ掛ける	投げ掛けろ
遣り過す	遣り過せ
揺る	揺れ
薙ぎ倒す	薙ぎ倒せ
かき曇る	かき曇れ
うそぶく	うそぶけ
せきとめる	せきとめろ
浮きでる	浮きでろ
ひかる	ひかれ
突きつける	突きつけろ
掛かれる	掛かれろ
ふり合う	ふり合え
みつ	みて
換える	換えろ
とりなす	とりなせ
張切る	張切れ
渋る	渋れ
啓する	啓しろ
蠢かす	蠢かせ
おしかえせる	おしかえせろ
堪える	堪えろ
遣える	遣えろ
すみこめる	すみこめろ
貸せる	貸せろ
飛びのれる	飛びのれろ
仰せ付ける	仰せ付けろ
毳立つ	毳立て
よぎる	よぎれ
黙りこくる	黙りこくれ
る	ろ
沸き返る	沸き返れ
往ける	往けろ
張り合わせる	張り合わせろ
ぶらさがる	ぶらさがれ
すくう	すくえ
狩り出す	狩り出せ
取り掛る	取り掛れ
申渡す	申渡せ
称える	称えろ
入り込む	入り込め
すりへる	すりへれ
装う	装え
立てる	立てろ
おもいあまる	おもいあまれ
もやう	もやえ
もちよれる	もちよれろ
いいかえせる	いいかえせろ
とじ込む	とじ込め
入り切る	入り切れ
陰る	陰れ
塞き止める	塞き止めろ
はずむ	はずめ
染め付ける	染め付けろ
ねりなおす	ねりなおせ
取かかる	取かかれ
ぐらつく	ぐらつけ
押分ける	押分けろ
なごむ	なごめ
いのこれる	いのこれろ
劣る	劣れ
吹出す	吹出せ
とぼける	とぼけろ
とびつける	とびつけろ
酌み交わす	酌み交わせ
掻ける	掻けろ
立返る	立返れ
違う	違え
ムシる	ムシれ
する	すれ
おもいつめる	おもいつめろ
解き放す	解き放せ
言い切る	言い切れ
参る	参れ
要す	要せ
病ほうける	病ほうけろ
かみしずまる	かみしずまれ
すわる	すわれ
微笑む	微笑め
刷込む	刷込め
延ばせる	延ばせろ
在り合わせる	在り合わせろ
組みあわせる	組みあわせろ
挿す	挿せ
探し当てる	探し当てろ
絶える	絶えろ
つぶやく	つぶやけ
練り合わす	練り合わせ
おぢゃる	おぢゃれ
ゆめみる	ゆめみろ
みそこなう	みそこなえ
まぜっ返す	まぜっ返せ
つみこむ	つみこめ
誦する	誦しろ
截つ	截て
うめあわせる	うめあわせろ
しこなす	しこなせ
織り込む	織り込め
押え込む	押え込め
ささやく	ささやけ
うつむく	うつむけ
積み立てる	積み立てろ
差繰る	差繰れ
たちよれる	たちよれろ
死に別れる	死に別れろ
掘り起こす	掘り起こせ
とざす	とざせ
あまる	あまれ
合せる	合せろ
組敷く	組敷け
接ぎ合わす	接ぎ合わせ
哭する	哭しろ
待ちわびる	待ちわびろ
とびおりる	とびおりろ
斎く	斎け
彫りつける	彫りつけろ
なる	なれ
とくせいづける	とくせいづけろ
張り出せる	張り出せろ
課する	課しろ
持ち替える	持ち替えろ
むし返す	むし返せ
背負える	背負えろ
下り立つ	下り立て
みがきこむ	みがきこめ
ひっぱたく	ひっぱたけ
かり出す	かり出せ
もえでる	もえでろ
潜り込む	潜り込め
いれちがう	いれちがえ
浮かされる	浮かされろ
べんする	べんしろ
摺る	摺れ
見送る	見送れ
いいわたす	いいわたせ
尖る	尖れ
おとなう	おとなえ
でっぱる	でっぱれ
いけどる	いけどれ
打殺す	打殺せ
うつぶせる	うつぶせろ
きせる	きせろ
昇る	昇れ
突き抜く	突き抜け
たたる	たたれ
追い廻す	追い廻せ
黒める	黒めろ
かじる	かじれ
きりたてる	きりたてろ
蒔ける	蒔けろ
しめ殺す	しめ殺せ
読みとる	読みとれ
定める	定めろ
抜け出せる	抜け出せろ
焚き付ける	焚き付けろ
うやまえる	うやまえろ
といかける	といかけろ
切りあげる	切りあげろ
準ずる	切りあげろ
守れる	守れろ
処する	処しろ
差し控える	差し控えろ
いやしめる	いやしめろ
うばいとれる	うばいとれろ
きりかえす	きりかえせ
懐かしむ	懐かしめ
凪ぐ	凪げ
得	凪げ
撰べる	撰べろ
発つ	発て
晦ます	晦ませ
繰りあわせる	繰りあわせろ
熬る	熬れ
掴む	掴め
うしなう	うしなえ
もらう	もらえ
恥じ入る	恥じ入れ
のりいれる	のりいれろ
きらわれる	きらわれろ
ふかまる	ふかまれ
恕する	恕しろ
悪びれる	悪びれろ
聞きかじる	聞きかじれ
咲き残る	咲き残れ
言ひ現す	言ひ現せ
そばめる	そばめろ
絡みつく	絡みつけ
包み込む	包み込め
うかされる	うかされろ
ひっこむ	ひっこめ
魅する	魅しろ
引っ括る	引っ括れ
飛びつける	飛びつけろ
差し翳す	差し翳せ
とりむすぶ	とりむすべ
朽果てる	朽果てろ
温まる	温まれ
振り出せる	振り出せろ
のしあがれる	のしあがれろ
たちこめる	たちこめろ
掻きむしる	掻きむしれ
引継ぐ	引継げ
こんがらかる	こんがらかれ
堪忍ぶ	堪忍べ
建て替える	建て替えろ
抱着く	抱着け
ぶらつく	ぶらつけ
申し渡す	申し渡せ
よろける	よろけろ
たたく	たたけ
映せる	映せろ
まかりまちがう	まかりまちがえ
かせぐ	かせげ
冷え込む	冷え込め
せる	せろ
きりだせる	きりだせろ
植え付ける	植え付けろ
舞う	舞え
染分ける	染分けろ
分つ	分て
行詰る	行詰れ
嗄らす	嗄らせ
越す	越せ
丸まる	丸まれ
書付ける	書付けろ
いく	いけ
請合う	請合え
ひろえる	ひろえろ
脱げる	脱げろ
討果す	討果せ
つかいふるす	つかいふるせ
扱き使う	扱き使え
入浸る	入浸れ
焦らす	焦らせ
覚る	覚れ
ぬる	ぬれ
すみつく	すみつけ
繰替える	繰替えろ
きりはずす	きりはずせ
建て込む	建て込め
騒ぐ	騒げ
おしだす	おしだせ
おしつまる	おしつまれ
まいおりる	まいおりろ
ガンバる	ガンバれ
おどる	おどれ
向う	向え
付けかえる	付けかえろ
慶する	慶しろ
見計らえる	見計らえろ
視る	視ろ
引っこめる	引っこめろ
こころする	こころしろ
語りこむ	語りこめ
否める	否めろ
おとなびる	おとなびろ
ひっ込む	ひっ込め
くばる	くばれ
のりすてる	のりすてろ
でむける	でむけろ
攻め寄せる	攻め寄せろ
はめ込む	はめ込め
聞きそこなう	聞きそこなえ
貪る	貪れ
みこせる	みこせろ
許す	許せ
薄める	薄めろ
抜け落ちる	抜け落ちろ
届く	届け
狭める	狭めろ
出掛ける	出掛けろ
ことよせる	ことよせろ
ほっぽらかす	ほっぽらかせ
併せ持つ	併せ持て
投げつける	投げつけろ
落籍す	落籍せ
ぱくる	ぱくれ
踏み均す	踏み均せ
たぐう	たぐえ
ざわつく	ざわつけ
突きあわす	突きあわせ
構う	構え
ねじあげる	ねじあげろ
終わる	終われ
育くむ	育くめ
さぐれる	さぐれろ
繕える	繕えろ
諾う	諾え
切り下げる	切り下げろ
みおくれる	みおくれろ
生まれる	生まれろ
しゃしゃりでる	しゃしゃりでろ
見守れる	見守れろ
ひきたてる	ひきたてろ
祝う	祝え
打ち砕ける	打ち砕けろ
問う	問え
くみふせる	くみふせろ
かいもとめる	かいもとめろ
ひしゃげる	ひしゃげろ
ふきとぶ	ふきとべ
濡らす	濡らせ
踏みならす	踏みならせ
位置づける	位置づけろ
ああなる	ああなれ
静まりかえる	静まりかえれ
迫れる	迫れろ
吸い上げる	吸い上げろ
呼び出す	呼び出せ
落ち込む	落ち込め
しゅくする	しゅくしろ
食延す	食延せ
仕切る	仕切れ
宣う	宣え
ふりまわす	ふりまわせ
置きかわる	置きかわれ
代わる	代われ
すなどる	すなどれ
問い合せる	問い合せろ
いいおとす	いいおとせ
つっぱしれる	つっぱしれろ
ほうりこむ	ほうりこめ
参する	参しろ
労う	労え
とらえる	とらえろ
泡立つ	泡立て
とおのける	とおのけろ
まがえる	まがえろ
こうじる	こうじろ
かき落とす	かき落とせ
やり返す	やり返せ
にたてる	にたてろ
くすねる	くすねろ
ないまぜる	ないまぜろ
織りあげる	織りあげろ
さそえる	さそえろ
塗りつける	塗りつけろ
弄する	弄しろ
揮う	揮え
下げ渡す	下げ渡せ
怒る	怒れ
逃げ惑う	逃げ惑え
飼える	飼えろ
騒げる	騒げろ
だぶる	だぶれ
あたためる	あたためろ
ものがたる	ものがたれ
たのめる	たのめろ
伴える	伴えろ
追い出す	追い出せ
きれこむ	きれこめ
ひっこめる	ひっこめろ
めいする	めいしろ
入込む	入込め
檄する	檄しろ
貯える	貯えろ
聞ほれる	聞ほれろ
与太る	与太れ
隣る	隣れ
いぶす	いぶせ
ゆずりわたせる	ゆずりわたせろ
かみあう	かみあえ
為し遂げる	為し遂げろ
突き落とす	突き落とせ
駆る	駆れ
歌いまくる	歌いまくれ
積み重なる	積み重なれ
うちはらう	うちはらえ
餓える	餓えろ
染め分ける	染め分けろ
囲める	囲めろ
食い切る	食い切れ
気取る	気取れ
わずらわす	わずらわせ
生茂る	生茂れ
有りあわせる	有りあわせろ
しいれる	しいれろ
とりこわせる	とりこわせろ
ながびく	ながびけ
こみ上げる	こみ上げろ
閉じこもる	閉じこもれ
きめる	きめろ
おしつぶす	おしつぶせ
刺通す	刺通せ
うばう	うばえ
気ばる	気ばれ
勇む	勇め
謹む	謹め
でおくれる	でおくれろ
まとう	まとえ
ちる	ちれ
煩わせる	煩わせろ
よみかえる	よみかえろ
かきこめる	かきこめろ
たきあげる	たきあげろ
通り過ぎる	通り過ぎろ
なりかわる	なりかわれ
偏る	偏れ
振る	振れ
なで上げる	なで上げろ
相手取る	相手取れ
まかす	まかせ
裏切れる	裏切れろ
刻む	刻め
梱る	梱れ
こぞる	こぞれ
さかだてる	さかだてろ
見交す	見交せ
降りる	降りろ
遂げる	遂げろ
書き抜ける	書き抜けろ
鳴かす	鳴かせ
かこめる	かこめろ
仕うまつる	仕うまつれ
やどす	やどせ
揺らぐ	揺らげ
鳴り出す	鳴り出せ
かりもよおす	かりもよおせ
縫い上げる	縫い上げろ
さきこぼれる	さきこぼれろ
よこぎれる	よこぎれろ
向き合う	向き合え
導き出せる	導き出せろ
届け出る	届け出ろ
となえる	となえろ
成り代る	成り代れ
削れる	削れろ
乾びる	乾びろ
叫べる	叫べろ
なさる	なされ
気張れる	気張れろ
べた付く	べた付け
ちぎる	ちぎれ
やり過ごす	やり過ごせ
すわりこむ	すわりこめ
はこびだす	はこびだせ
叩きつける	叩きつけろ
ほろぼせる	ほろぼせろ
宣る	宣れ
甲ばしる	甲ばしれ
便する	便しろ
通ぶる	通ぶれ
眠らせる	眠らせろ
くり広げる	くり広げろ
醸し出す	醸し出せ
話し合える	話し合えろ
まかり出る	まかり出ろ
脅しつける	脅しつけろ
解す	解せ
いらだつ	いらだて
呼び掛ける	呼び掛けろ
いいつたえる	いいつたえろ
訊ねる	訊ねろ
聞き澄ます	聞き澄ませ
差し替える	差し替えろ
窄まる	窄まれ
更かす	更かせ
言募る	言募れ
輝かす	輝かせ
いすくまる	いすくまれ
生まれつく	生まれつけ
威ばる	威ばれ
まきかえす	まきかえせ
失せる	失せろ
追い越す	追い越せ
染抜く	染抜け
打ち払える	打ち払えろ
はぎ取れる	はぎ取れろ
示せる	示せろ
抱取る	抱取れ
ほねおる	ほねおれ
当て込む	当て込め
待ち兼ねる	待ち兼ねろ
つづれる	つづれろ
うちくだく	うちくだけ
出直せる	出直せろ
取り持てる	取り持てろ
つられる	つられろ
曝す	曝せ
有余る	有余れ
ふけこむ	ふけこめ
染め抜く	染め抜け
譲り受ける	譲り受けろ
罰する	罰しろ
じぶくる	じぶくれ
あらだてる	あらだてろ
戻す	戻せ
建て直せる	建て直せろ
沸あがる	沸あがれ
言消す	言消せ
順序付ける	順序付けろ
凍える	凍えろ
活気づく	活気づけ
ぎする	ぎしろ
えらぶ	えらべ
謝する	謝しろ
押し進める	押し進めろ
しずまりかえる	しずまりかえれ
はじき飛ばす	はじき飛ばせ
荷なう	荷なえ
感じ入る	感じ入れ
そぼ濡れる	そぼ濡れろ
掻き回す	掻き回せ
こまりきる	こまりきれ
だましとる	だましとれ
はらいきよめる	はらいきよめろ
取すます	取すませ
だきあげる	だきあげろ
なぎたおす	なぎたおせ
殴りつける	殴りつけろ
備えつける	備えつけろ
酔う	酔え
感じとる	感じとれ
とりすてる	とりすてろ
抽んでる	抽んでろ
震いつく	震いつけ
乗付ける	乗付けろ
奮い起こす	奮い起こせ
逃げ込む	逃げ込め
しめる	しめろ
おっかける	おっかけろ
乗りこむ	乗りこめ
評す	評せ
馴染む	馴染め
まばたく	まばたけ
つかまえる	つかまえろ
おくらせる	おくらせろ
ではらう	ではらえ
垂んとする	垂んとしろ
そそぎ込む	そそぎ込め
叢る	叢れ
取りはからう	取りはからえ
深まる	深まれ
よみながせる	よみながせろ
くださる	くだされ
あける	あけろ
ねぶる	ねぶれ
力つきる	力つきろ
貶める	貶めろ
つづり合す	つづり合せ
散ずる	つづり合せ
かきおこす	かきおこせ
まつる	まつれ
煎じ詰める	煎じ詰めろ
差上げる	差上げろ
取り締る	取り締れ
あんじる	あんじろ
ちぢれる	ちぢれろ
急げる	急げろ
慣わす	慣わせ
任せる	任せろ
めだつ	めだて
たっとべる	たっとべろ
たてなおせる	たてなおせろ
盛れる	盛れろ
さわぎだす	さわぎだせ
ゆさぶれる	ゆさぶれろ
書き落す	書き落せ
謹しむ	謹しめ
架る	架れ
吸込む	吸込め
見飽きる	見飽きろ
捜しあてる	捜しあてろ
にらみつける	にらみつけろ
伸ばせる	伸ばせろ
ききいれる	ききいれろ
駆ける	駆けれ
揉みほぐす	揉みほぐせ
かかずらう	かかずらえ
逃げのびる	逃げのびろ
練りあわせる	練りあわせろ
つらぬきとおす	つらぬきとおせ
続ける	続けろ
飛びかかれる	飛びかかれろ
匿う	匿え
つきはなす	つきはなせ
わらう	わらえ
渇く	渇け
才ばしる	才ばしれ
とおざける	とおざけろ
立行く	立行け
ゆらめく	ゆらめけ
ぶっとばす	ぶっとばせ
頬張る	頬張れ
衒う	衒え
薙ぐ	薙げ
念ずる	薙げ
勘繰る	勘繰れ
逃げ込める	逃げ込めろ
気づかう	気づかえ
すき返す	すき返せ
ひっ掴む	ひっ掴め
なみする	なみしろ
買い切れる	買い切れろ
さされる	さされろ
結びつける	結びつけろ
つっ返す	つっ返せ
火照る	火照れ
沮む	沮め
解る	解れ
見逸れる	見逸れろ
芽吹く	芽吹け
こじ開ける	こじ開けろ
捏ねくる	捏ねくれ
かいあたえる	かいあたえろ
乾上がる	乾上がれ
もぎ取る	もぎ取れ
描き出せる	描き出せろ
詠込む	詠込め
成り立つ	成り立て
嗣ぐ	嗣げ
みあわせる	みあわせろ
にげる	にげろ
治せる	治せろ
乗っかる	乗っかれ
ほくそ笑む	ほくそ笑め
煎り付ける	煎り付けろ
ものいう	ものいえ
出くわす	出くわせ
あらいながせる	あらいながせろ
引っかく	引っかけ
ふくまる	ふくまれ
たちわれる	たちわれろ
いいなおす	いいなおせ
思い過ごす	思い過ごせ
つるしあげる	つるしあげろ
切り放せる	切り放せろ
おもいつく	おもいつけ
ゑむ	ゑめ
おもむく	おもむけ
目だつ	目だて
通り越す	通り越せ
染付く	染付け
とる	とれ
打ちだす	打ちだせ
だんじこめる	だんじこめろ
けっていづける	けっていづけろ
とかす	とかせ
うちすてる	うちすてろ
折り返す	折り返せ
話し合う	話し合え
老いぼれる	老いぼれろ
責めたてる	責めたてろ
序する	序しろ
彫りこむ	彫りこめ
麾く	麾け
拓く	拓け
書き写す	書き写せ
取抑える	取抑えろ
貸す	貸せ
切り落す	切り落せ
耳立つ	耳立て
取扱う	取扱え
関す	関せ
ひっかける	ひっかけろ
とうとぶ	とうとべ
平らげる	平らげろ
振りわける	振りわけろ
打ち続く	打ち続け
侘びる	侘びろ
副える	副えろ
付け回す	付け回せ
なきじゃくる	なきじゃくれ
すさぶ	すさべ
いからす	いからせ
切り倒す	切り倒せ
もくろむ	もくろめ
くりかえせる	くりかえせろ
はなつ	はなて
仕立てる	仕立てろ
手放す	手放せ
糾す	糾せ
もみ合う	もみ合え
初める	初めろ
立通す	立通せ
毀つ	毀て
がっつく	がっつけ
みちびける	みちびけろ
うけおう	うけおえ
遣る	遣れ
えぐる	えぐれ
早める	早めろ
隣り合わせる	隣り合わせろ
差し招く	差し招け
はねかえせる	はねかえせろ
遣わす	遣わせ
そげる	そげろ
ひん曲げる	ひん曲げろ
綴りあわせる	綴りあわせろ
取囲む	取囲め
泳ぎ着ける	泳ぎ着けろ
撃ち止める	撃ち止めろ
折り込む	折り込め
むかいあえる	むかいあえろ
かきよせる	かきよせろ
噛み殺す	噛み殺せ
取り返せる	取り返せろ
睨みあわせる	睨みあわせろ
すずむ	すずめ
あたいする	あたいしろ
ほりだせる	ほりだせろ
しらげる	しらげろ
思い直す	思い直せ
きこなせる	きこなせろ
うらむ	うらめ
揉み消す	揉み消せ
基く	基け
いいまくる	いいまくれ
あとずさる	あとずされ
映ずる	あとずされ
のる	のれ
かぞえる	かぞえろ
放り出す	放り出せ
のばせる	のばせろ
釣りあう	釣りあえ
ねかせる	ねかせろ
売れる	売れろ
灯る	灯れ
眠れる	眠れろ
なやませる	なやませろ
かかる	かかれ
使う	使え
のりこす	のりこせ
干涸らびる	干涸らびろ
抜きん出る	抜きん出ろ
踏み入れる	踏み入れろ
たてこもる	たてこもれ
渇れる	渇れろ
訴える	訴えろ
喜ばす	喜ばせ
突き詰める	突き詰めろ
いのれる	いのれろ
つき抜ける	つき抜けろ
耕す	耕せ
こじらせる	こじらせろ
あざわらう	あざわらえ
ぞくす	ぞくせ
かげる	かげろ
響かせる	響かせろ
いきのこれる	いきのこれろ
まきおこす	まきおこせ
おもえる	おもえろ
運び出せる	運び出せろ
詠う	詠え
俯せる	俯せろ
染透る	染透れ
見交わす	見交わせ
汗じみる	汗じみろ
蒙る	蒙れ
おいたつ	おいたて
持ち出せる	持ち出せろ
にえくりかえる	にえくりかえれ
湧かす	湧かせ
取り止める	取り止めろ
叩ける	叩けろ
接す	接せ
おぶう	おぶえ
被う	被え
絡む	絡め
ふう	ふえ
すえおく	すえおけ
跳ねる	跳ねろ
引っ付く	引っ付け
襲う	襲え
纏わる	纏われ
にらむ	にらめ
おぼえる	おぼえろ
打ちかえす	打ちかえせ
れっする	れっしろ
推量る	推量れ
ゆれる	ゆれろ
なげこむ	なげこめ
濯ぐ	濯げ
ひきずりこむ	ひきずりこめ
なみはずれる	なみはずれろ
負う	負え
もぎ取れる	もぎ取れろ
聞き合わす	聞き合わせ
吸い付ける	吸い付けろ
感ずる	吸い付けろ
搾り取る	搾り取れ
おちぶれる	おちぶれろ
轟く	轟け
不貞腐る	不貞腐れ
保する	保しろ
鋏める	鋏めろ
名づける	名づけろ
逸する	逸しろ
置ける	置けろ
のりあわせる	のりあわせろ
尽きる	尽きろ
えんづける	えんづけろ
差し延べる	差し延べろ
かえる	かえれ
なす	なせ
うちはらえる	うちはらえろ
舞い込む	舞い込め
おもんぱかる	おもんぱかれ
ぬぐいされる	ぬぐいされろ
行い澄ます	行い澄ませ
うち捨てる	うち捨てろ
おいまくる	おいまくれ
見すえる	見すえろ
極まる	極まれ
切る	切れ
はねかえす	はねかえせ
すっとぼける	すっとぼけろ
きえいる	きえいれ
取りかたづける	取りかたづけろ
駆けだす	駆けだせ
擬す	擬せ
踏外す	踏外せ
争う	争え
散敷く	散敷け
付出す	付出せ
込める	込めろ
立て通す	立て通せ
加われる	加われろ
引き当てる	引き当てろ
足掻く	足掻け
纏まる	纏まれ
ふれあう	ふれあえ
愛し合う	愛し合え
ゆえる	ゆえろ
形作れる	形作れろ
鎖す	鎖せ
盛り返せる	盛り返せろ
兼ね備える	兼ね備えろ
ふりしく	ふりしけ
うりきれる	うりきれろ
跳ね返せる	跳ね返せろ
せり上げる	せり上げろ
うちおとせる	うちおとせろ
まう	まえ
よそおえる	よそおえろ
飼い慣らす	飼い慣らせ
しゅくす	しゅくせ
とくちょうづける	とくちょうづけろ
遡る	遡れ
みきれる	みきれろ
とりいれる	とりいれろ
寄かかる	寄かかれ
あつかふ	あつかへ
跡付ける	跡付けろ
不貞腐れる	不貞腐れろ
遣れる	遣れろ
睨める	睨めろ
だくする	だくしろ
並居る	並居ろ
こときれる	こときれろ
とりかわす	とりかわせ
いいきかす	いいきかせ
ねじれる	ねじれろ
怯える	怯えろ
見比べる	見比べろ
おしとおせる	おしとおせろ
みまわせる	みまわせろ
ちぢまる	ちぢまれ
いさみたてる	いさみたてろ
聞過す	聞過せ
鏤める	鏤めろ
浮き出す	浮き出せ
うち連れる	うち連れろ
納まる	納まれ
聞きとがめる	聞きとがめろ
言い出す	言い出せ
狎れる	狎れろ
詠ずる	狎れろ
飲みつぶれる	飲みつぶれろ
引き付ける	引き付けろ
ひきはなせる	ひきはなせろ
落っこちる	落っこちろ
戻せる	戻せろ
保ち合う	保ち合え
つみわける	つみわけろ
頷く	頷け
捩じ合う	捩じ合え
積み出す	積み出せ
ちぢくれる	ちぢくれろ
押入る	押入れ
つきぬける	つきぬけろ
言い聞かせる	言い聞かせろ
つみだす	つみだせ
うまれでる	うまれでろ
売り出せる	売り出せろ
しこる	しこれ
めいずる	しこれ
かいこめる	かいこめろ
つみする	つみしろ
とりつくろう	とりつくろえ
諦める	諦めろ
みがまえる	みがまえろ
勇み立てる	勇み立てろ
釈く	釈け
死ぬ	死ね
かる	かれ
廻る	廻れ
繕う	繕え
祝す	祝せ
つれだつ	つれだて
染め直せる	染め直せろ
散り急ぐ	散り急げ
干あがる	干あがれ
擁する	擁しろ
はかりこむ	はかりこめ
取りしまる	取りしまれ
説き伏せる	説き伏せろ
みつもれる	みつもれろ
かけ隔たる	かけ隔たれ
よびつける	よびつけろ
突ぱしる	突ぱしれ
降り積もる	降り積もれ
拭う	拭え
たたき起す	たたき起せ
若やぐ	若やげ
溶かす	溶かせ
まよう	まよえ
とびわたる	とびわたれ
うけおえる	うけおえろ
芽立つ	芽立て
催す	催せ
降ろす	降ろせ
泣濡れる	泣濡れろ
讀める	讀めろ
たちきれる	たちきれろ
失くなる	失くなれ
いろあせる	いろあせろ
くるむ	くるめ
撮る	撮れ
出逢う	出逢え
恤む	恤め
吹おろす	吹おろせ
抜きんでる	抜きんでろ
防ぐ	防げ
下さる	下され
おぼしめす	おぼしめせ
かすめとる	かすめとれ
くみあげる	くみあげろ
むしり取る	むしり取れ
さしまねく	さしまねけ
洗い落とす	洗い落とせ
かけまわれる	かけまわれろ
誑かす	誑かせ
つれさる	つれされ
食合う	食合え
打ちみる	打ちみろ
すませる	すませろ
踏ん張る	踏ん張れ
燃えつく	燃えつけ
もみけす	もみけせ
やりこめる	やりこめろ
申す	申せ
しする	ししろ
りかいしあう	りかいしあえ
ほころびる	ほころびろ
くだる	くだれ
読み合わす	読み合わせ
丸めこむ	丸めこめ
言い消す	言い消せ
こき使う	こき使え
突通る	突通れ
押し詰る	押し詰れ
せおえる	せおえろ
うく	うけ
献ずる	うけ
劈く	劈け
敵する	敵しろ
始まる	始まれ
ひねくる	ひねくれ
撫で付ける	撫で付けろ
洩らす	洩らせ
愛す	愛せ
ひっ被る	ひっ被れ
いらせられる	いらせられろ
取り巻ける	取り巻けろ
照れる	照れろ
指し示す	指し示せ
下立つ	下立て
かさねあわす	かさねあわせ
引きちぎれる	引きちぎれろ
取り消せる	取り消せろ
きれる	きれろ
おもいみだれる	おもいみだれろ
笑い飛ばせる	笑い飛ばせろ
かけ離れる	かけ離れろ
さしかける	さしかけろ
みみだつ	みみだて
奉ずる	みみだて
択ぶ	択べ
こぼす	こぼせ
わかがえる	わかがえれ
ふくめる	ふくめろ
生け捕る	生け捕れ
署する	署しろ
組み立る	組み立ろ
ぬくまる	ぬくまれ
おろす	おろせ
立入る	立入れ
ひっくり返れる	ひっくり返れろ
もりわける	もりわけろ
置き換える	置き換えろ
投げ勝つ	投げ勝て
みづく	みづけ
えりすぐる	えりすぐれ
威張れる	威張れろ
聴こえる	聴こえろ
産める	産めろ
むかう	むかえ
かれる	かれろ
ねらいうつ	ねらいうて
ふりかざす	ふりかざせ
酌める	酌めろ
弾ける	弾けろ
もよおす	もよおせ
食う	食え
ブッ殺す	ブッ殺せ
いやがる	いやがれ
僭する	僭しろ
撒く	撒け
持ち帰る	持ち帰れ
きざす	きざせ
おしよせる	おしよせろ
おくらす	おくらせ
歩ます	歩ませ
ふうきる	ふうきれ
転げる	転げろ
かきだす	かきだせ
しょげこむ	しょげこめ
突き当たる	突き当たれ
ほきだす	ほきだせ
かりあげる	かりあげろ
すごせる	すごせろ
こねる	こねろ
差し出る	差し出ろ
狙い打つ	狙い打て
得る	得ろ
粒だつ	粒だて
きりひらく	きりひらけ
揺ぎ出でる	揺ぎ出でろ
遺る	遺れ
やりなおす	やりなおせ
めんする	めんしろ
真似る	真似ろ
ちりしく	ちりしけ
出盛る	出盛れ
減り込む	減り込め
いやせる	いやせろ
役する	役しろ
なける	なけろ
立ち尽くす	立ち尽くせ
舞い戻る	舞い戻れ
強いる	強いろ
ぬりつける	ぬりつけろ
ひそめる	ひそめろ
おもいしる	おもいしれ
乗っける	乗っけろ
結えつける	結えつけろ
おどり出る	おどり出ろ
もうしこむ	もうしこめ
惚れこむ	惚れこめ
うずまく	うずまけ
いのこる	いのこれ
異なる	異なれ
詣れる	詣れろ
積上げる	積上げろ
撓る	撓れ
すぼめる	すぼめろ
ことほぐ	ことほげ
経あがる	経あがれ
煮詰める	煮詰めろ
ひやせる	ひやせろ
打沈む	打沈め
しゃくう	しゃくえ
拡げる	拡げろ
撫ぜる	撫ぜろ
かたげる	かたげろ
轢き殺す	轢き殺せ
だく	だけ
差延べる	差延べろ
令する	令しろ
身篭る	身篭れ
あらがう	あらがえ
罷りでる	罷りでろ
こまぬく	こまぬけ
ぬれる	ぬれろ
堪り兼ねる	堪り兼ねろ
釣れる	釣れろ
差し障る	差し障れ
すれちがう	すれちがえ
はせ回る	はせ回れ
飛びまわる	飛びまわれ
煙る	煙れ
満たす	満たせ
騙る	騙れ
反れる	反れろ
呼ばれる	呼ばれろ
でなおせる	でなおせろ
つけたせる	つけたせろ
登り詰める	登り詰めろ
寝込む	寝込め
坐する	坐しろ
とりあわす	とりあわせ
耐え忍ぶ	耐え忍べ
捻じる	捻じれ
駆け回れる	駆け回れろ
攻上る	攻上れ
打かさなる	打かさなれ
いきちがう	いきちがえ
対応付ける	対応付けろ
踏み分ける	踏み分けろ
掘出す	掘出せ
止める	止めろ
断切る	断切れ
在り合せる	在り合せろ
盛りかえす	盛りかえせ
たおる	たおれ
ひにくる	ひにくれ
摩する	摩しろ
かたりつぐ	かたりつげ
おりかさなる	おりかさなれ
かいかぶる	かいかぶれ
むきかわる	むきかわれ
醒ます	醒ませ
打つ	打て
あやめる	あやめろ
執る	執れ
つっぱる	つっぱれ
組みこめる	組みこめろ
とんがる	とんがれ
埋まる	埋まれ
活きる	活きろ
ぶちのめす	ぶちのめせ
へきする	へきしろ
つめかける	つめかけろ
言い含める	言い含めろ
敲く	敲け
ただよう	ただよえ
掛け持つ	掛け持て
いりみだれる	いりみだれろ
きたる	きたれ
押え付ける	押え付けろ
賜る	賜れ
並べ換える	並べ換えろ
ひえる	ひえろ
取り次げる	取り次げろ
撮み出す	撮み出せ
のめりこむ	のめりこめ
あいしあえる	あいしあえろ
じみる	じみろ
しずまる	しずまれ
あやなす	あやなせ
笑いとばす	笑いとばせ
取り合う	取り合え
なきすがる	なきすがれ
ひとはだぬぐ	ひとはだぬげ
取って返す	取って返せ
取入れる	取入れろ
乳繰る	乳繰れ
煮染める	煮染めろ
なぎはらう	なぎはらえ
たく	たけ
ふうする	ふうしろ
果たせる	果たせろ
刈入れる	刈入れろ
まかる	まかれ
突っぱなす	突っぱなせ
全うする	全うしろ
書きぬく	書きぬけ
起きあがる	起きあがれ
書き添える	書き添えろ
ふるわす	ふるわせ
であるける	であるけろ
飛び付く	飛び付け
さしはさむ	さしはさめ
撞く	撞け
掛離れる	掛離れろ
とびこえる	とびこえろ
達する	達しろ
みる	みろ
謀る	謀れ
食詰める	食詰めろ
探し回る	探し回れ
かわいがれる	かわいがれろ
とまれる	とまれろ
立ち入る	立ち入れ
転ける	転けろ
当てこする	当てこすれ
こする	こすれ
抜き出せる	抜き出せろ
とびあがれる	とびあがれろ
そそける	そそけろ
頂く	頂け
おちあえる	おちあえろ
おちこぼれる	おちこぼれろ
皮肉る	皮肉れ
言いきる	言いきれ
乗り換える	乗り換えろ
さしもどす	さしもどせ
つくりなす	つくりなせ
搾り上げる	搾り上げろ
急ぐ	急げ
立ち尽す	立ち尽せ
住み込める	住み込めろ
おろせる	おろせろ
震える	震えろ
ぞくする	ぞくしろ
飛びこむ	飛びこめ
見いだせる	見いだせろ
蔓延る	蔓延れ
かき出す	かき出せ
すごす	すごせ
わずらう	わずらえ
合わせる	合わせろ
踏切る	踏切れ
かわかす	かわかせ
背負う	背負え
拭ける	拭けろ
手向かえる	手向かえろ
付廻す	付廻せ
くちはてる	くちはてろ
果せる	果せろ
あおざめる	あおざめろ
遅なわる	遅なわれ
ごてつく	ごてつけ
だきしめる	だきしめろ
詠む	詠め
あめる	あめろ
罷り出でる	罷り出でろ
相つぐ	相つげ
ねらえる	ねらえろ
かりいれる	かりいれろ
そねむ	そねめ
きりひらける	きりひらけろ
触る	触れ
つのる	つのれ
まきこめる	まきこめろ
つれこむ	つれこめ
寝転ぶ	寝転べ
亡くなる	亡くなれ
ばら蒔く	ばら蒔け
あかしくらす	あかしくらせ
もえさかる	もえさかれ
くわえる	くわえろ
借り出す	借り出せ
くちすすぐ	くちすすげ
もたつく	もたつけ
でんぐりがえる	でんぐりがえれ
弄る	弄れ
もちきる	もちきれ
額づく	額づけ
盛込む	盛込め
巻上げる	巻上げろ
殴り付ける	殴り付けろ
若返る	若返れ
行き渡る	行き渡れ
搾る	搾れ
ほりおこせる	ほりおこせろ
魅入る	魅入れ
売り込める	売り込めろ
秘める	秘めろ
潜り込める	潜り込めろ
引き下ろす	引き下ろせ
よりぬく	よりぬけ
ひき込む	ひき込め
たじろぐ	たじろげ
弾き出す	弾き出せ
映す	映せ
さだめる	さだめろ
せかす	せかせ
よごす	よごせ
わびいる	わびいれ
くえる	くえろ
いなかびる	いなかびろ
見廻る	見廻れ
いかれる	いかれろ
敗れる	敗れろ
苔むす	苔むせ
ぬけだせる	ぬけだせろ
いいまるめる	いいまるめろ
なびく	なびけ
落着き払う	落着き払え
とばす	とばせ
議する	議しろ
靡かす	靡かせ
たためる	たためろ
振り切る	振り切れ
積む	積め
いえる	いえろ
みはるかす	みはるかせ
のし歩く	のし歩け
刃向かう	刃向かえ
薄まる	薄まれ
薄れる	薄れろ
引留める	引留めろ
暴き出す	暴き出せ
抱え込む	抱え込め
わななく	わななけ
改む	わななけ
すてる	すてろ
なげだす	なげだせ
踏付ける	踏付けろ
設える	設えろ
看做す	看做せ
ひきこむ	ひきこめ
くりぬく	くりぬけ
売込む	売込め
つうじる	つうじろ
ふるびる	ふるびろ
ぬりつぶす	ぬりつぶせ
踏み込める	踏み込めろ
ばれる	ばれろ
もりつぶす	もりつぶせ
のみほせる	のみほせろ
反り返る	反り返れ
毛羽立つ	毛羽立て
どくする	どくしろ
あふれでる	あふれでろ
反す	反せ
やりすごせる	やりすごせろ
游ぐ	游げ
うちたてる	うちたてろ
遭う	遭え
どよもす	どよもせ
塞ぐ	塞げ
引き合える	引き合えろ
貫き通す	貫き通せ
かしきる	かしきれ
打消す	打消せ
ねぎる	ねぎれ
ふりかぶる	ふりかぶれ
いきがる	いきがれ
更す	更せ
呼戻す	呼戻せ
教える	教えろ
ほりかえせる	ほりかえせろ
映る	映れ
疲らせる	疲らせろ
さかえる	さかえろ
貫ける	貫けろ
流れ落ちる	流れ落ちろ
呼び覚ます	呼び覚ませ
揺ぐ	揺げ
張りとばす	張りとばせ
ふみこむ	ふみこめ
咲かす	咲かせ
とむらう	とむらえ
刺立つ	刺立て
聞こえる	聞こえろ
とまる	とまれ
変じる	変じろ
罰す	罰せ
降り出す	降り出せ
磨りつぶす	磨りつぶせ
掻い繰る	掻い繰れ
そなわる	そなわれ
泣く	泣け
浸る	浸れ
交ぜかえす	交ぜかえせ
留まる	留まれ
暴れまくる	暴れまくれ
まちのぞむ	まちのぞめ
引入れる	引入れろ
誓う	誓え
取り零す	取り零せ
こがれる	こがれろ
組める	組めろ
たけりたつ	たけりたて
まぎらせる	まぎらせろ
そめぬく	そめぬけ
愛でる	愛でろ
さとす	さとせ
侵す	侵せ
濁らせる	濁らせろ
吸い出す	吸い出せ
擦る	擦れ
歌える	歌えろ
張上げる	張上げろ
掛け合わす	掛け合わせ
書記す	書記せ
ぶら下がれる	ぶら下がれろ
入まじる	入まじれ
止す	止せ
引き払う	引き払え
回る	回れ
探り出せる	探り出せろ
振りかける	振りかけろ
磨れる	磨れろ
かんずる	磨れろ
立並ぶ	立並べ
朽ち果てる	朽ち果てろ
こやす	こやせ
卜する	卜しろ
寄り添う	寄り添え
誘い出せる	誘い出せろ
あやまれる	あやまれろ
ひっ括る	ひっ括れ
掻き込む	掻き込め
受持つ	受持て
落ちる	落ちろ
移る	移れ
ハリたおす	ハリたおせ
奮い起つ	奮い起て
ほす	ほせ
茂り合う	茂り合え
転げ込む	転げ込め
体する	体しろ
晴らす	晴らせ
心付く	心付け
革める	革めろ
むせぶ	むせべ
窘める	窘めろ
はらいだす	はらいだせ
いい表す	いい表せ
殴りとばす	殴りとばせ
よびさけぶ	よびさけべ
澄切る	澄切れ
立後れる	立後れろ
とりしきれる	とりしきれろ
かたまりあう	かたまりあえ
係る	係れ
おとし入れる	おとし入れろ
立こもる	立こもれ
かよわす	かよわせ
あわさる	あわされ
飛ばす	飛ばせ
ふしくれだつ	ふしくれだて
刷り上がる	刷り上がれ
ひしめき合う	ひしめき合え
かんがえだせる	かんがえだせろ
立退く	立退け
善がる	善がれ
はじき出せる	はじき出せろ
働かせる	働かせろ
すみつける	すみつけろ
れる	れろ
あう	あえ
にぎりつぶす	にぎりつぶせ
待ち構える	待ち構えろ
忍び寄る	忍び寄れ
かなしむ	かなしめ
振り立てる	振り立てろ
もうしたてる	もうしたてろ
言付ける	言付けろ
打ち砕く	打ち砕け
みかける	みかけろ
うつ	うて
買い叩く	買い叩け
刺し殺せる	刺し殺せろ
さぐりだす	さぐりだせ
敬う	敬え
うわずる	うわずれ
摺り抜ける	摺り抜けろ
繰寄せる	繰寄せろ
結わえ付ける	結わえ付けろ
彫り上げる	彫り上げろ
とらわれる	とらわれろ
さわる	さわれ
歓ぶ	歓べ
みつもる	みつもれ
つづける	つづけろ
すれ違う	すれ違え
なすりつける	なすりつけろ
吃る	吃れ
追詰める	追詰めろ
出来る	出来ろ
振るう	振るえ
しこむ	しこめ
うめたてる	うめたてろ
やらす	やらせ
立ちすくむ	立ちすくめ
かたす	かたせ
とりつける	とりつけろ
ほほ笑む	ほほ笑め
魘される	魘されろ
打ちまくる	打ちまくれ
書きさす	書きさせ
しまる	しまれ
塗立てる	塗立てろ
みずぎわだつ	みずぎわだて
受け取れる	受け取れろ
そこねる	そこねろ
放下す	放下せ
ぶす	ぶせ
こうむる	こうむれ
じょうじる	じょうじろ
けみする	けみしろ
込合う	込合え
通じる	通じろ
病める	病めろ
ひきとめる	ひきとめろ
和らぐ	和らげ
くみほす	くみほせ
あんずる	くみほせ
たちむかえる	たちむかえろ
かさ張る	かさ張れ
あづかる	あづかれ
ふみとどまれる	ふみとどまれろ
ひきいれる	ひきいれろ
照らす	照らせ
いぶる	いぶれ
しさる	しされ
捩れる	捩れろ
出揃う	出揃え
とびちる	とびちれ
くいあらためる	くいあらためろ
こむ	こめ
のりこせる	のりこせろ
はげます	はげませ
絞り込む	絞り込め
決す	決せ
捨置く	捨置け
逸る	逸れ
ひかされる	ひかされろ
盛り込む	盛り込め
抜けあがる	抜けあがれ
詰め掛ける	詰め掛けろ
結える	結えろ
戯ける	戯けろ
恋する	恋しろ
ふるう	ふるえ
割引く	割引け
挾む	挾め
おれあえる	おれあえろ
踏みとどまれる	踏みとどまれろ
着く	着け
かまう	かまえ
泊る	泊れ
捨て置く	捨て置け
ぬすみだす	ぬすみだせ
戸惑う	戸惑え
はぐらかす	はぐらかせ
踏み切る	踏み切れ
釣込む	釣込め
奮たつ	奮たて
凌げる	凌げろ
目立つ	目立て
曇らせる	曇らせろ
わりもどせる	わりもどせろ
黒ずむ	黒ずめ
する	しろ
掛り合う	掛り合え
言返す	言返せ
きりあう	きりあえ
ゆき帰る	ゆき帰れ
取り交す	取り交せ
保ち合える	保ち合えろ
出過ぎる	出過ぎろ
仮す	仮せ
張り裂ける	張り裂けろ
すみあらす	すみあらせ
いいなす	いいなせ
もりこめる	もりこめろ
たびかさなる	たびかさなれ
ききとる	ききとれ
増さる	増され
媚びる	媚びろ
あたたまる	あたたまれ
卑しめる	卑しめろ
寝違える	寝違えろ
なぐる	なぐれ
うちけせる	うちけせろ
問いかける	問いかけろ
うちころせる	うちころせろ
向かう	向かえ
運ぶ	運べ
復する	復しろ
つけねらう	つけねらえ
体裁振る	体裁振れ
騒ぎだす	騒ぎだせ
かきあわせる	かきあわせろ
竦み上がる	竦み上がれ
はりだせる	はりだせろ
焚く	焚け
刷れる	刷れろ
躍り掛る	躍り掛れ
してやる	してやれ
精出す	精出せ
到れる	到れろ
看る	看ろ
くりあわせる	くりあわせろ
売り飛ばせる	売り飛ばせろ
降しきる	降しきれ
引締める	引締めろ
おいだせる	おいだせろ
とびのる	とびのれ
垂れ下がる	垂れ下がれ
うえる	うえろ
解かす	解かせ
ふてくさる	ふてくされ
そいとげる	そいとげろ
いわえる	いわえろ
おきかえる	おきかえろ
はぎ取る	はぎ取れ
わきでる	わきでろ
拡がる	拡がれ
着込む	着込め
掘り出せる	掘り出せろ
錆びつく	錆びつけ
うきでる	うきでろ
ふれこむ	ふれこめ
変りはてる	変りはてろ
のりかける	のりかけろ
凝らす	凝らせ
こねくる	こねくれ
とけ込める	とけ込めろ
吹き込む	吹き込め
ばたつく	ばたつけ
立ち働く	立ち働け
庶幾う	庶幾え
きりわすれる	きりわすれろ
はじきだす	はじきだせ
草する	草しろ
凍む	凍め
はいまつわる	はいまつわれ
掻き暗す	掻き暗せ
與える	與えろ
うつしとれる	うつしとれろ
かんじとれる	かんじとれろ
化ける	化けろ
掘りさげる	掘りさげろ
ふんぞりかえる	ふんぞりかえれ
切り倒せる	切り倒せろ
締め付ける	締め付けろ
こね返す	こね返せ
北叟笑む	北叟笑め
食下がる	食下がれ
引きさく	引きさけ
算する	算しろ
言いつのる	言いつのれ
ひっこ抜く	ひっこ抜け
触れ込める	触れ込めろ
言い尽す	言い尽せ
あからむ	あからめ
説伏せる	説伏せろ
擽る	擽れ
掛かり合う	掛かり合え
たぐまる	たぐまれ
指さす	指させ
追い込める	追い込めろ
浮あがる	浮あがれ
うらづける	うらづけろ
食い下がる	食い下がれ
のりだせる	のりだせろ
ふためく	ふためけ
詠める	詠めろ
ひるがえす	ひるがえせ
手つだう	手つだえ
芽ぐむ	芽ぐめ
補える	補えろ
取り越す	取り越せ
滅びる	滅びろ
絡ます	絡ませ
損じる	損じろ
きんずる	損じろ
つきだせる	つきだせろ
なくなす	なくなせ
請けあう	請けあえ
取り交わす	取り交わせ
張りつける	張りつけろ
読み流せる	読み流せろ
かもし出す	かもし出せ
ちからづける	ちからづけろ
あずける	あずけろ
払い出す	払い出せ
象る	象れ
そなえつける	そなえつけろ
溜る	溜れ
入れ直す	入れ直せ
かかる	かかれ
引っ繰り返る	引っ繰り返れ
しめす	しめせ
うろつく	うろつけ
もす	もせ
たける	たけろ
くばりあるける	くばりあるけろ
折重ねる	折重ねろ
とりのぞける	とりのぞけろ
吹分ける	吹分けろ
やける	やけろ
たびだてる	たびだてろ
騙しこむ	騙しこめ
踏みにじる	踏みにじれ
かたどる	かたどれ
しょぼくれる	しょぼくれろ
挿せる	挿せろ
たきつける	たきつけろ
こぼつ	こぼて
織る	織れ
切崩す	切崩せ
起き出せる	起き出せろ
探せる	探せろ
掘下げる	掘下げろ
引き下げる	引き下げろ
持切る	持切れ
食べる	食べろ
おちこむ	おちこめ
湿気る	湿気ろ
煩わす	煩わせ
かっする	かっしろ
ながれおちる	ながれおちろ
振り放け見みる	振り放け見みろ
持ち越す	持ち越せ
割り切る	割り切れ
食らいつく	食らいつけ
牽ける	牽けろ
天下る	天下れ
買込む	買込め
あいまつ	あいまて
えりぬく	えりぬけ
塗りつぶせる	塗りつぶせろ
放く	放け
推す	推せ
とく	とけ
馬鹿げる	馬鹿げろ
興る	興れ
おもいすごす	おもいすごせ
ひびきわたる	ひびきわたれ
あこがれる	あこがれろ
おじけだつ	おじけだて
憎める	憎めろ
書きなぐる	書きなぐれ
従える	従えろ
決る	決れ
漕ぎ着ける	漕ぎ着けろ
つむる	つむれ
襲われる	襲われろ
棹さす	棹させ
泣すがる	泣すがれ
打取る	打取れ
引き伸ばす	引き伸ばせ
きばむ	きばめ
突き飛ばせる	突き飛ばせろ
ことづける	ことづけろ
ずっこける	ずっこけろ
使い分ける	使い分けろ
あぶりだす	あぶりだせ
はらいもどせる	はらいもどせろ
払いもどす	払いもどせ
あぶらじみる	あぶらじみろ
明け渡る	明け渡れ
伏せる	伏せろ
もえ出る	もえ出ろ
育てあげる	育てあげろ
曵く	曵け
煮込める	煮込めろ
気圧される	気圧されろ
あそぶ	あそべ
よせかける	よせかけろ
ぬかせる	ぬかせろ
受け合う	受け合え
やり遂げる	やり遂げろ
おそいかかる	おそいかかれ
畏れる	畏れろ
よばなれる	よばなれろ
うろぬく	うろぬけ
かちこす	かちこせ
みたす	みたせ
痩せこける	痩せこけろ
巡れる	巡れろ
とりひろげる	とりひろげろ
ふうじる	ふうじろ
引っ返す	引っ返せ
とがめる	とがめろ
老い耄れる	老い耄れろ
追いこす	追いこせ
踏み入る	踏み入れ
書流す	書流せ
わき起こる	わき起これ
あおる	あおれ
くいいる	くいいれ
囚われる	囚われろ
なごめる	なごめろ
飲回す	飲回せ
歯する	歯しろ
うちだす	うちだせ
速まる	速まれ
化かせる	化かせろ
たどりつける	たどりつけろ
聞き入れる	聞き入れろ
つとめる	つとめろ
飛ぶ	飛べ
担える	担えろ
このむ	このめ
おどしつける	おどしつけろ
ふくらませる	ふくらませろ
立寄る	立寄れ
みおくる	みおくれ
ふみわける	ふみわけろ
憂う	憂え
託ける	託けろ
うせる	うせろ
掻払う	掻払え
しっする	しっしろ
出払う	出払え
きこむ	きこめ
じす	じせ
追い回す	追い回せ
繰りまわす	繰りまわせ
繰り越す	繰り越せ
よみやぶる	よみやぶれ
切組む	切組め
悪たれる	悪たれろ
撃ち殺せる	撃ち殺せろ
しきる	しきれ
執成す	執成せ
もぎれる	もぎれろ
ほしころす	ほしころせ
いでたつ	いでたて
たゆむ	たゆめ
傷つく	傷つけ
突き刺す	突き刺せ
さしさわる	さしさわれ
報いる	報いろ
なおす	なおせ
とどける	とどけろ
使い果たす	使い果たせ
てりかえす	てりかえせ
ふっきれる	ふっきれろ
送り出す	送り出せ
きづく	きづけ
過ごす	過ごせ
かきあげる	かきあげろ
飛び回れる	飛び回れろ
焦げつく	焦げつけ
あおげる	あおげろ
画す	画せ
しめる	しめろ
くい込む	くい込め
いならぶ	いならべ
漬け込む	漬け込め
這い出でる	這い出でろ
聞澄ます	聞澄ませ
ねそべる	ねそべれ
現れる	現れろ
親しめる	親しめろ
はいいる	はいいれ
進み出す	進み出せ
貸し越す	貸し越せ
はじいる	はじいれ
封じ込む	封じ込め
炒る	炒れ
取りもてる	取りもてろ
かなぐり捨てる	かなぐり捨てろ
盛る	盛れ
とばしる	とばしれ
ふきおろす	ふきおろせ
ふれあえる	ふれあえろ
申し越す	申し越せ
残す	残せ
きわ立つ	きわ立て
あしらう	あしらえ
鬱する	鬱しろ
かたまれる	かたまれろ
引っ込める	引っ込めろ
かんがえだす	かんがえだせ
囲む	囲め
繰りあげる	繰りあげろ
思い当たる	思い当たれ
事切れる	事切れろ
切り回せる	切り回せろ
げびる	げびろ
縋れる	縋れろ
でかす	でかせ
やくする	やくしろ
むす	むせ
つっぱなす	つっぱなせ
まどろむ	まどろめ
動かす	動かせ
いづ	動かせ
取組む	取組め
しおおせる	しおおせろ
めくるめく	めくるめけ
預け入れる	預け入れろ
引き攣れる	引き攣れろ
聞き合せる	聞き合せろ
はれあがる	はれあがれ
振り回せる	振り回せろ
似通う	似通え
せんじつめる	せんじつめろ
高まる	高まれ
彫り込める	彫り込めろ
乗り上げる	乗り上げろ
取り合える	取り合えろ
まいこむ	まいこめ
たちのける	たちのけろ
ほとばしる	ほとばしれ
ひかれる	ひかれろ
世づく	世づけ
やぶれる	やぶれろ
書き送る	書き送れ
やってくる	書き送れ
送る	送れ
打直せる	打直せろ
いきる	いきろ
かしだす	かしだせ
ふらす	ふらせ
旅だつ	旅だて
上がる	上がれ
煮詰る	煮詰れ
かわいがる	かわいがれ
つぼめる	つぼめろ
ふりわける	ふりわけろ
つきやぶれる	つきやぶれろ
かけつける	かけつけろ
あきれる	あきれろ
取りあげる	取りあげろ
いのる	いのれ
うまれあわす	うまれあわせ
折かさなる	折かさなれ
のっかる	のっかれ
食い止める	食い止めろ
なでおろす	なでおろせ
ほりかえす	ほりかえせ
うりあげる	うりあげろ
ひきあげる	ひきあげろ
わける	わけろ
着こなす	着こなせ
取り運べる	取り運べろ
湯引く	湯引け
たまりかねる	たまりかねろ
たちはたらく	たちはたらけ
見立てる	見立てろ
てづまる	てづまれ
生まれ合わす	生まれ合わせ
押しかぶさる	押しかぶされ
犯す	犯せ
いいあやまる	いいあやまれ
くらいする	くらいしろ
振出す	振出せ
出そろう	出そろえ
すくみ上がる	すくみ上がれ
高じる	高じろ
惟みる	惟みろ
績む	績め
渡りあう	渡りあえ
くどける	くどけろ
ひきつぐ	ひきつげ
芽差す	芽差せ
からます	からませ
祓う	祓え
付き合える	付き合えろ
仰る	仰れ
省く	省け
追い求める	追い求めろ
せめよせる	せめよせろ
放れる	放れろ
うちこわす	うちこわせ
生れ落ちる	生れ落ちろ
慎む	慎め
打ちくだく	打ちくだけ
なげかつ	なげかて
沸き起る	沸き起れ
腐らす	腐らせ
枕する	枕しろ
せっつく	せっつけ
伺える	伺えろ
挺する	挺しろ
絶てる	絶てろ
つかまつる	つかまつれ
くみつく	くみつけ
せおいこめる	せおいこめろ
あけはなれる	あけはなれろ
取結ぶ	取結べ
ちぢこまる	ちぢこまれ
みぬける	みぬけろ
濡れる	濡れろ
泣ける	泣けろ
励ませる	励ませろ
入れ替える	入れ替えろ
ほおける	ほおけろ
嫁ぐ	嫁げ
照らせる	照らせろ
ひきさく	ひきさけ
ふむ	ふめ
発く	発け
駆け込む	駆け込め
さがしだす	さがしだせ
ねじ向ける	ねじ向けろ
えらびだせる	えらびだせろ
借倒す	借倒せ
とびかける	とびかけれ
悔改める	悔改めろ
準える	準えろ
さえ渡る	さえ渡れ
息せききる	息せききれ
逃げ回る	逃げ回れ
いいなおせる	いいなおせろ
呑み込める	呑み込めろ
有り合せる	有り合せろ
さとれる	さとれろ
たばねる	たばねろ
入組む	入組め
打込む	打込め
突止める	突止めろ
焼け落ちる	焼け落ちろ
取る	取れ
齎す	齎せ
敷き詰める	敷き詰めろ
よじ登る	よじ登れ
色褪せる	色褪せろ
なのる	なのれ
うちとける	うちとけろ
古る	古れ
喩える	喩えろ
しゃがみこむ	しゃがみこめ
吠える	吠えろ
明らめる	明らめろ
にくむ	にくめ
打ち切れる	打ち切れろ
調える	調えろ
編める	編めろ
しりぬく	しりぬけ
しょぼ濡れる	しょぼ濡れろ
居竦まる	居竦まれ
たがやす	たがやせ
へめぐる	へめぐれ
写し出す	写し出せ
つめる	つめれ
捜し当てる	捜し当てろ
ひきさる	ひきされ
爪弾く	爪弾け
あざむける	あざむけろ
数え切れる	数え切れろ
降り込む	降り込め
はなやぐ	はなやげ
抛つつ	抛つて
紛れ込める	紛れ込めろ
闘える	闘えろ
方向付ける	方向付けろ
略す	略せ
跪く	跪け
刻み付ける	刻み付けろ
言い渡せる	言い渡せろ
潰す	潰せ
開け放す	開け放せ
捲し上げる	捲し上げろ
はみ出す	はみ出せ
いきながらえる	いきながらえろ
あきめく	あきめけ
適える	適えろ
賭する	賭しろ
とおりすぎる	とおりすぎろ
取り締まれる	取り締まれろ
さぼる	さぼれ
付する	付しろ
踏み越す	踏み越せ
乗越える	乗越えろ
勢いづく	勢いづけ
入り乱れる	入り乱れろ
組伏せる	組伏せろ
うちきれる	うちきれろ
ききだせる	ききだせろ
破く	破け
さそう	さそえ
食する	食しろ
よろこびあえる	よろこびあえろ
積重ねる	積重ねろ
捩る	捩れ
しわがれる	しわがれろ
しょくする	しょくしろ
はきだせる	はきだせろ
練り直す	練り直せ
下種張る	下種張れ
みはからえる	みはからえろ
使い果す	使い果せ
捲る	捲れ
記せる	記せろ
つれもどす	つれもどせ
おっしゃる	おっしゃれ
振り払える	振り払えろ
かりこむ	かりこめ
差うつむく	差うつむけ
乾かす	乾かせ
恐れ入る	恐れ入れ
なきくらす	なきくらせ
ばくする	ばくしろ
詠じる	詠じろ
抓る	抓れ
ちかづく	ちかづけ
誤らす	誤らせ
たかなる	たかなれ
横たえる	横たえろ
はりまわす	はりまわせ
拝む	拝め
ゆるがす	ゆるがせ
ひきずりまわせる	ひきずりまわせろ
はらいもどす	はらいもどせ
ゆびく	ゆびけ
斬る	斬れ
もつれあう	もつれあえ
せめおとす	せめおとせ
うちはたす	うちはたせ
どよむ	どよめ
ついていける	ついていけろ
交じる	交じれ
脅える	脅えろ
うちけす	うちけせ
轢く	轢け
うけながせる	うけながせろ
降やむ	降やめ
うなる	うなれ
さしつかえる	さしつかえろ
見あたる	見あたれ
取り扱う	取り扱え
脱する	脱しろ
でむかえる	でむかえろ
けばだつ	けばだて
生みだす	生みだせ
踏抜く	踏抜け
飲む	飲め
立ち込める	立ち込めろ
肯んずる	立ち込めろ
割出す	割出せ
かきなおす	かきなおせ
組み上げる	組み上げろ
けせる	けせろ
弁ずる	けせろ
乗あわせる	乗あわせろ
統べ括る	統べ括れ
泣き明かす	泣き明かせ
産み付ける	産み付けろ
釣り合う	釣り合え
枝垂れる	枝垂れろ
なかせる	なかせろ
めしよせる	めしよせろ
宣する	宣しろ
とびかかる	とびかかれ
奮い起す	奮い起せ
思い上がる	思い上がれ
さずかる	さずかれ
いれなおす	いれなおせ
やぶく	やぶけ
さがす	さがせ
つみかさねる	つみかさねろ
おもいなおす	おもいなおせ
慣す	慣せ
澄ます	澄ませ
占う	占え
心得える	心得えろ
きばる	きばれ
ぬいあわす	ぬいあわせ
飛び出す	飛び出せ
絵取る	絵取れ
打ち勝つ	打ち勝て
節榑立つ	節榑立て
私する	私しろ
取り違える	取り違えろ
おひゃらかす	おひゃらかせ
むちうつ	むちうて
落延びる	落延びろ
枯れる	枯れろ
つまだてる	つまだてろ
おちょくる	おちょくれ
取りこぼす	取りこぼせ
揺らす	揺らせ
払いこむ	払いこめ
取り極める	取り極めろ
吹き上げる	吹き上げろ
凋む	凋め
清まる	清まれ
近寄る	近寄れ
いとなむ	いとなめ
かかわれる	かかわれろ
たくしあげる	たくしあげろ
たてつく	たてつけ
怖気付く	怖気付け
繰り返す	繰り返せ
そよふく	そよふけ
壊れる	壊れろ
恐がる	恐がれ
壊せる	壊せろ
通り抜ける	通り抜けろ
ひきだせる	ひきだせろ
泳ぐ	泳げ
冴える	冴えろ
握りつぶす	握りつぶせ
手がける	手がけろ
やきつける	やきつけろ
顧みる	顧みろ
しあげる	しあげろ
たたきつぶす	たたきつぶせ
敵す	敵せ
わかつ	わかて
つからす	つからせ
書き記す	書き記せ
吹きだす	吹きだせ
混ぜっかえす	混ぜっかえせ
せりだす	せりだせ
折り返せる	折り返せろ
ゆるめる	ゆるめろ
引き裂ける	引き裂けろ
えがく	えがけ
振りかざす	振りかざせ
入り交じる	入り交じれ
たいらぐ	たいらげ
わきおこせる	わきおこせろ
撫でつける	撫でつけろ
嫌がる	嫌がれ
打ち込める	打ち込めろ
こかす	こかせ
変ずる	こかせ
托する	托しろ
もちかえる	もちかえれ
跨げる	跨げろ
点る	点れ
切り離す	切り離せ
かさなりあう	かさなりあえ
切れる	切れろ
わかす	わかせ
打ちあう	打ちあえ
かもせる	かもせろ
けんじる	けんじろ
辷らす	辷らせ
還る	還れ
待ち設ける	待ち設けろ
住みつべる	住みつべろ
こねかえす	こねかえせ
さしむける	さしむけろ
弁える	弁えろ
かち合う	かち合え
つくせる	つくせろ
すりつける	すりつけろ
取すがる	取すがれ
貸し出す	貸し出せ
組みなおす	組みなおせ
はやす	はやせ
死に絶える	死に絶えろ
あがく	あがけ
じれこむ	じれこめ
ぬかずく	ぬかずけ
切り忘れる	切り忘れろ
乗りまわす	乗りまわせ
疲れる	疲れろ
いいあらそえる	いいあらそえろ
引き落とせる	引き落とせろ
突合す	突合せ
弾ずる	突合せ
かればむ	かればめ
抱えこむ	抱えこめ
とりまわす	とりまわせ
便る	便れ
あけわたす	あけわたせ
しょいこむ	しょいこめ
あぐねる	あぐねろ
投げこむ	投げこめ
ふるいおとせる	ふるいおとせろ
たべる	たべろ
読み返せる	読み返せろ
流れ歩く	流れ歩け
拗ねる	拗ねろ
こく	こけ
生きかえる	生きかえれ
書分ける	書分けろ
さししめせる	さししめせろ
気づく	気づけ
でき上がる	でき上がれ
照りつける	照りつけろ
なくなる	なくなれ
ゆだねる	ゆだねろ
ずれこめる	ずれこめろ
はせ参じる	はせ参じろ
浮立つ	浮立て
眠りこける	眠りこけろ
はいつくばう	はいつくばえ
封じ込める	封じ込めろ
ゆでる	ゆでろ
蒸ける	蒸けろ
探る	探れ
耐え抜く	耐え抜け
いぬ	いね
うめあわす	うめあわせ
つめよる	つめよれ
はつる	はつれ
来る	はつれ
切り替える	切り替えろ
しょぼつく	しょぼつけ
むずかる	むずかれ
差置く	差置け
奪い合える	奪い合えろ
くもらせる	くもらせろ
見まがう	見まがえ
言い付かる	言い付かれ
いいもらす	いいもらせ
みまもる	みまもれ
かかりあう	かかりあえ
のみこむ	のみこめ
突きあたる	突きあたれ
持つ	持て
とりまとめる	とりまとめろ
もちこめる	もちこめろ
供する	供しろ
ふるいわける	ふるいわけろ
落す	落せ
ひろげる	ひろげろ
載せる	載せろ
動ずる	載せろ
組みあう	組みあえ
こすれる	こすれろ
縋る	縋れ
祓い清める	祓い清めろ
とけあえる	とけあえろ
ほくそえむ	ほくそえめ
向かいあう	向かいあえ
引張る	引張れ
繰り回す	繰り回せ
おどかす	おどかせ
いかける	いかけろ
擦切る	擦切れ
窮まる	窮まれ
消せる	消せろ
打ち出せる	打ち出せろ
退ける	退けろ
しつくす	しつくせ
架ける	架けろ
持ち帰れる	持ち帰れろ
はかす	はかせ
聞き惚れる	聞き惚れろ
あばれまくる	あばれまくれ
かっ込む	かっ込め
とりつく	とりつけ
下回る	下回れ
いらだてる	いらだてろ
吊せる	吊せろ
がんばる	がんばれ
肯く	肯け
さやばしる	さやばしれ
戦ぐ	戦げ
いとう	いとえ
はりかえる	はりかえろ
きりさげる	きりさげろ
買わす	買わせ
服せる	服せろ
寄る	寄れ
崩す	崩せ
ききおく	ききおけ
釣合う	釣合え
浮び上る	浮び上れ
澄渡る	澄渡れ
舞いこむ	舞いこめ
言祝ぐ	言祝げ
差越える	差越えろ
走り抜ける	走り抜けろ
蹴立てる	蹴立てろ
老ぼれる	老ぼれろ
繰り返せる	繰り返せろ
問い掛ける	問い掛けろ
奪い取れる	奪い取れろ
わき返る	わき返れ
貰う	貰え
繰る	繰れ
駆け寄る	駆け寄れ
抜き取る	抜き取れ
すりこむ	すりこめ
しけこむ	しけこめ
逝く	逝け
かけだす	かけだせ
競り合う	競り合え
ねっする	ねっしろ
突出す	突出せ
ふんばる	ふんばれ
乾反る	乾反れ
回り込める	回り込めろ
うまる	うまれ
しける	しけろ
言い淀む	言い淀め
はやしたてる	はやしたてろ
見計らう	見計らえ
奉じる	奉じろ
末枯れる	末枯れろ
はせ戻る	はせ戻れ
波だつ	波だて
聞ける	聞けろ
きりいる	きりいれ
取集める	取集めろ
祭る	祭れ
悔いる	悔いろ
恥入る	恥入れ
はいだす	はいだせ
誑し込む	誑し込め
とれる	とれろ
がいする	がいしろ
噎ぶ	噎べ
就く	就け
踏ん切れる	踏ん切れろ
言い渡す	言い渡せ
抜ける	抜けろ
あきる	あきろ
成し遂げる	成し遂げろ
呼びつける	呼びつけろ
たす	たせ
もりかえす	もりかえせ
がえんずる	もりかえせ
こぐ	こげ
おもいまどえる	おもいまどえろ
掻き口説く	掻き口説け
鼓する	鼓しろ
窶れる	窶れろ
被る	被れ
撥ねる	撥ねろ
操れる	操れろ
興じる	興じろ
掘り返す	掘り返せ
ひきずりまわす	ひきずりまわせ
色あせる	色あせろ
去る	去れ
生える	生えろ
ほめちぎる	ほめちぎれ
守り立てる	守り立てろ
かこつ	かこて
さしかためる	さしかためろ
慣わせる	慣わせろ
落ち合う	落ち合え
差し繰る	差し繰れ
はねかかる	はねかかれ
訓ずる	はねかかれ
並べる	並べろ
蹴飛ばす	蹴飛ばせ
添わる	添われ
ふるいおこせる	ふるいおこせろ
もれ聞く	もれ聞け
つり上がる	つり上がれ
うなされる	うなされろ
割る	割れ
すける	すけろ
ついばめる	ついばめろ
ほうり込む	ほうり込め
掻き鳴す	掻き鳴せ
蒔き直せる	蒔き直せろ
みなおせる	みなおせろ
やけおちる	やけおちろ
治す	治せ
侍する	侍しろ
馴す	馴せ
立かかる	立かかれ
ゆずりうける	ゆずりうけろ
召し具す	召し具せ
そびえ立つ	そびえ立て
立ち戻る	立ち戻れ
練歩く	練歩け
およぐ	およげ
あざ笑う	あざ笑え
かちとる	かちとれ
寄りすがる	寄りすがれ
かぎれる	かぎれろ
まちかねる	まちかねろ
狼狽える	狼狽えろ
掘れる	掘れろ
さしひく	さしひけ
秘する	秘しろ
猛り立つ	猛り立て
とりはからう	とりはからえ
幽する	幽しろ
ろうする	ろうしろ
咲そろう	咲そろえ
きしめく	きしめけ
げんずる	きしめけ
みすかす	みすかせ
うちはなす	うちはなせ
とっつかまる	とっつかまれ
身罷る	身罷れ
煉り合せる	煉り合せろ
触れ込む	触れ込め
喰う	喰え
ほめあげる	ほめあげろ
連れ戻す	連れ戻せ
増やす	増やせ
仕上げる	仕上げろ
昏れる	昏れろ
老い込む	老い込め
間に合う	間に合え
さする	さすれ
吹っとぶ	吹っとべ
ひっかく	ひっかけ
だきあう	だきあえ
居着く	居着け
牽く	牽け
伸ばす	伸ばせ
のりすすめる	のりすすめろ
はいりこめる	はいりこめろ
草臥れる	草臥れろ
縁づく	縁づけ
這える	這えろ
追い掛ける	追い掛けろ
ふきあげる	ふきあげろ
つつみこめる	つつみこめろ
食い込める	食い込めろ
打ち解ける	打ち解けろ
黙す	黙せ
言損なう	言損なえ
いいあわせる	いいあわせろ
聳やかす	聳やかせ
うべなう	うべなえ
差押える	差押えろ
せり落す	せり落せ
いとめる	いとめろ
手向かう	手向かえ
あてこむ	あてこめ
細める	細めろ
きぐす	きぐせ
ぼやける	ぼやけろ
企てる	企てろ
測れる	測れろ
振る舞える	振る舞えろ
翔ける	翔けろ
分ける	分けろ
佩く	佩け
躍り込む	躍り込め
まなびとれる	まなびとれろ
服する	服しろ
打ち直せる	打ち直せろ
いけどれる	いけどれろ
冒せる	冒せろ
かけよれる	かけよれろ
開け放せる	開け放せろ
冴え返る	冴え返れ
かつぎ上げる	かつぎ上げろ
打って出る	打って出ろ
きりくずせる	きりくずせろ
ふくす	ふくせ
ツクる	ツクれ
見回せる	見回せろ
すすみだす	すすみだせ
のたくる	のたくれ
遊べる	遊べろ
興がる	興がれ
ねばりぬける	ねばりぬけろ
押し通す	押し通せ
付け込む	付け込め
詠える	詠えろ
呼び立てる	呼び立てろ
負ける	負けろ
たちすくむ	たちすくめ
担ぎ出す	担ぎ出せ
出向く	出向け
いわす	いわせ
くみなおす	くみなおせ
聳える	聳えろ
ひける	ひけろ
ゆさぶる	ゆさぶれ
さしのぼる	さしのぼれ
劃する	劃しろ
殺げる	殺げろ
染め出す	染め出せ
勇気づける	勇気づけろ
覗く	覗け
ほうり出す	ほうり出せ
折りかさなる	折りかさなれ
潜める	潜めろ
見透せる	見透せろ
さし迫る	さし迫れ
炊き込む	炊き込め
ほりだす	ほりだせ
せめこむ	せめこめ
うみだす	うみだせ
まきなおせる	まきなおせろ
割りほぐす	割りほぐせ
あばける	あばけろ
言いそびれる	言いそびれろ
かみさびる	かみさびろ
積もる	積もれ
放せる	放せろ
追いつめる	追いつめろ
迎え入れる	迎え入れろ
折りかさねる	折りかさねろ
引き継げる	引き継げろ
作り成す	作り成せ
みぬく	みぬけ
持ち合わす	持ち合わせ
言いつかる	言いつかれ
選りわける	選りわけろ
うちくつろぐ	うちくつろげ
儚む	儚め
語り合える	語り合えろ
飛び上がれる	飛び上がれろ
かき集める	かき集めろ
うちほろぼす	うちほろぼせ
ふうずる	うちほろぼせ
酔っぱらう	酔っぱらえ
ふりくらす	ふりくらせ
引っくくる	引っくくれ
ずれ込める	ずれ込めろ
ゆずりあう	ゆずりあえ
もちあわす	もちあわせ
おもいおこす	おもいおこせ
挟める	挟めろ
さきばしる	さきばしれ
褒める	褒めろ
買える	買えろ
うりつける	うりつけろ
噛み合わす	噛み合わせ
すだつ	すだて
そんじる	そんじろ
めかしこむ	めかしこめ
たすけだす	たすけだせ
走り抜く	走り抜け
てれる	てれろ
関する	関しろ
巣立つ	巣立て
らっする	らっしろ
つくり出す	つくり出せ
救う	救え
溜めこむ	溜めこめ
振放す	振放せ
叱る	叱れ
しげる	しげれ
帰せる	帰せろ
屠る	屠れ
言いまくる	言いまくれ
頼る	頼れ
乗り切る	乗り切れ
にかよう	にかよえ
さがせる	さがせろ
書き損じる	書き損じろ
囁やく	囁やけ
立て篭る	立て篭れ
ふみならす	ふみならせ
願い下げる	願い下げろ
吹きでる	吹きでろ
反りくり返る	反りくり返れ
こらす	こらせ
払わす	払わせ
生きぬく	生きぬけ
いすわる	いすわれ
猛る	猛れ
差し出せる	差し出せろ
眠りこむ	眠りこめ
兼ねる	兼ねろ
明かす	明かせ
有難がる	有難がれ
折り重ねる	折り重ねろ
落ち着き払う	落ち着き払え
補する	補しろ
じゅんじょづける	じゅんじょづけろ
そこねる	そこねろ
育める	育めろ
摘める	摘めろ
まちがふ	まちがへ
思いなおす	思いなおせ
噛み合う	噛み合え
つきあえる	つきあえろ
取合せる	取合せろ
射つ	射て
しめころす	しめころせ
覗ける	覗けろ
踏破る	踏破れ
寄こす	寄こせ
きえはてる	きえはてろ
ききもらす	ききもらせ
まちつける	まちつけろ
近づく	近づけ
まがる	まがれ
たちはだかる	たちはだかれ
繰合せる	繰合せろ
借り上げる	借り上げろ
たたき上げる	たたき上げろ
売付ける	売付けろ
やり直す	やり直せ
考え込む	考え込め
卷ける	卷けろ
読み直す	読み直せ
聾する	聾しろ
握りつぶせる	握りつぶせろ
よびだす	よびだせ
はめ込める	はめ込めろ
手渡す	手渡せ
めあわす	めあわせ
押しのける	押しのけろ
みあわす	みあわせ
どうじる	どうじろ
取り入る	取り入れ
読み替える	読み替えろ
うみおとせる	うみおとせろ
問う	問え
押し込める	押し込めろ
とちる	とちれ
なつめく	なつめけ
しのびこめる	しのびこめろ
彫れる	彫れろ
にぎれる	にぎれろ
飛び散る	飛び散れ
払込む	払込め
くみ上げる	くみ上げろ
ふりかかる	ふりかかれ
降り篭める	降り篭めろ
こうる	こうれ
ねむらす	ねむらせ
呼びかける	呼びかけろ
くみこむ	くみこめ
買い控える	買い控えろ
したたる	したたれ
おびえる	おびえろ
いいつくす	いいつくせ
吸い込める	吸い込めろ
差招く	差招け
ふみとどまる	ふみとどまれ
焼き払う	焼き払え
見逃せる	見逃せろ
集まる	集まれ
撥ね付ける	撥ね付けろ
掠める	掠めろ
切り廻す	切り廻せ
引き入れる	引き入れろ
禿びる	禿びろ
まかせる	まかせろ
切捨てる	切捨てろ
いれかわれる	いれかわれろ
まぜかえせる	まぜかえせろ
うきたつ	うきたて
なきはらす	なきはらせ
ためこむ	ためこめ
すぎる	すぎろ
うちつづく	うちつづけ
払い除ける	払い除けろ
かきなぐる	かきなぐれ
さかせる	さかせろ
掘り起こせる	掘り起こせろ
ねちがえる	ねちがえろ
寄せかける	寄せかけろ
ひらく	ひらけ
付け狙う	付け狙え
くだされる	くだされろ
観する	観しろ
錬る	錬れ
ねばつく	ねばつけ
とぶ	とべ
引っつかむ	引っつかめ
かき鳴す	かき鳴せ
ころばす	ころばせ
いきたつ	いきたて
差しだす	差しだせ
世帯染みる	世帯染みろ
積立てる	積立てろ
ふせげる	ふせげろ
詠み込む	詠み込め
捕まえる	捕まえろ
打ち倒せる	打ち倒せろ
あい変わる	あい変われ
なめずる	なめずれ
連れこむ	連れこめ
聞きわける	聞きわけろ
思い及ぶ	思い及べ
すり減らす	すり減らせ
揺れ動く	揺れ動け
崩れる	崩れろ
凝る	凝れ
警める	警めろ
にしめる	にしめろ
受け継げる	受け継げろ
聞きとどける	聞きとどけろ
思い直せる	思い直せろ
触れあう	触れあえ
けむにまく	けむにまけ
飛び立つ	飛び立て
解け合える	解け合えろ
できあがる	できあがれ
しなる	しなれ
そびれる	そびれろ
おいたてる	おいたてろ
踏みとどまる	踏みとどまれ
凹む	凹め
たちならぶ	たちならべ
ねんずる	たちならべ
喜べる	喜べろ
停る	停れ
しいたげる	しいたげろ
しかくばる	しかくばれ
およろこびもうしあげる	およろこびもうしあげろ
きりはなす	きりはなせ
たきこむ	たきこめ
にげかえる	にげかえれ
踏みしだく	踏みしだけ
乗っ取れる	乗っ取れろ
盛り上げる	盛り上げろ
そわつく	そわつけ
とけあう	とけあえ
じだいがかる	じだいがかれ
決まる	決まれ
割り振れる	割り振れろ
みわける	みわけろ
議す	議せ
取交す	取交せ
滅入る	滅入れ
ふきかける	ふきかけろ
埋め合わす	埋め合わせ
見定める	見定めろ
かけずる	かけずれ
恙む	恙め
燻ぼる	燻ぼれ
通り掛る	通り掛れ
消し止める	消し止めろ
しゃくる	しゃくれ
飛び立てる	飛び立てろ
掃き出す	掃き出せ
かしだせる	かしだせろ
みくびる	みくびれ
願出る	願出ろ
来はじめる	来はじめろ
つなぎ止める	つなぎ止めろ
決め込む	決め込め
さっする	さっしろ
しわむ	しわめ
つり上げる	つり上げろ
揚がる	揚がれ
徴する	徴しろ
ちまう	ちまえ
もの申す	もの申せ
ねころがる	ねころがれ
おぼめかす	おぼめかせ
はがれる	はがれろ
やどる	やどれ
割りきれる	割りきれろ
読める	読めろ
とりしずめる	とりしずめろ
濁す	濁せ
謝る	謝れ
燻す	燻せ
因われる	因われろ
配す	配せ
おとずれる	おとずれろ
こそげる	こそげろ
変わり果てる	変わり果てろ
言い丸める	言い丸めろ
切り込む	切り込め
まじえる	まじえろ
きょうがる	きょうがれ
つねる	つねれ
拝する	拝しろ
縫い合わせる	縫い合わせろ
探し出す	探し出せ
当てはまる	当てはまれ
縫上げる	縫上げろ
うちぬく	うちぬけ
まき散らす	まき散らせ
引き攣る	引き攣れ
ふるい分ける	ふるい分けろ
祈る	祈れ
群れる	群れろ
帰れる	帰れろ
叩く	叩け
突っ張れる	突っ張れろ
結び付ける	結び付けろ
唱う	唱え
はげませる	はげませろ
盛返す	盛返せ
ふうじこめる	ふうじこめろ
かしこす	かしこせ
にぎわせる	にぎわせろ
買い求める	買い求めろ
つのだつ	つのだて
もくする	もくしろ
さくする	さくしろ
祭れる	祭れろ
身構える	身構えろ
そらとぼける	そらとぼけろ
巻き返す	巻き返せ
譲れる	譲れろ
飛び起きる	飛び起きろ
乗り外す	乗り外せ
向かい合える	向かい合えろ
とめる	とめろ
ひらきなおる	ひらきなおれ
絶入る	絶入れ
聞き及ぶ	聞き及べ
腹立つ	腹立て
賊する	賊しろ
すがり付く	すがり付け
渇かす	渇かせ
減せる	減せろ
気色ばむ	気色ばめ
振り放す	振り放せ
はだかる	はだかれ
みわたせる	みわたせろ
へぐ	へげ
問いあわせる	問いあわせろ
すりよる	すりよれ
ききただせる	ききただせろ
のりきる	のりきれ
伝う	伝え
ねる	ねろ
限れる	限れろ
いきづまる	いきづまれ
こせつく	こせつけ
泣きわめく	泣きわめけ
学べる	学べろ
取り寄せる	取り寄せろ
緩まる	緩まれ
粘る	粘れ
手控える	手控えろ
まじなう	まじなえ
張り回す	張り回せ
和解し合える	和解し合えろ
突っ込む	突っ込め
行合う	行合え
おおえる	おおえろ
よびさます	よびさませ
許せる	許せろ
治まる	治まれ
括る	括れ
はじきかえせる	はじきかえせろ
困り抜く	困り抜け
継げる	継げろ
しめくくる	しめくくれ
戦う	戦え
かえりざける	かえりざけろ
ひっぱがす	ひっぱがせ
ひらきなおれる	ひらきなおれろ
飛違う	飛違え
いたみいる	いたみいれ
きずける	きずけろ
解き放つ	解き放て
凍てつく	凍てつけ
つきつめる	つきつめろ
いれあげる	いれあげろ
すりへらす	すりへらせ
おこる	おこれ
すり潰す	すり潰せ
責め苛む	責め苛め
ひきはらう	ひきはらえ
荒だつ	荒だて
言い習わす	言い習わせ
おう	おえ
くりこむ	くりこめ
あいいれる	あいいれろ
ふくらむ	ふくらめ
入る	入れ
ゆだる	ゆだれ
つまぐる	つまぐれ
臭わせる	臭わせろ
寝入る	寝入れ
召し抱える	召し抱えろ
茂る	茂れ
いじくる	いじくれ
見張れる	見張れろ
ねじこめる	ねじこめろ
聞き返す	聞き返せ
咲きほこる	咲きほこれ
買う	買え
いいのがれる	いいのがれろ
磨ける	磨けろ
のこす	のこせ
滅ぼせる	滅ぼせろ
騙す	騙せ
こみあう	こみあえ
逸す	逸せ
滑り込む	滑り込め
答える	答えろ
ひきしまる	ひきしまれ
座り込む	座り込め
ひきたつ	ひきたて
低める	低めろ
つまみ出す	つまみ出せ
盛り付ける	盛り付けろ
くい止める	くい止めろ
はらう	はらえ
なりすます	なりすませ
おきかわる	おきかわれ
埋める	埋めろ
怖じる	怖じろ
きそくだつ	きそくだて
溜める	溜めろ
締めくくる	締めくくれ
居溢れる	居溢れろ
なう	なえ
もたす	もたせ
消え果てる	消え果てろ
行きあう	行きあえ
おしいる	おしいれ
打合せる	打合せろ
滑り落ちる	滑り落ちろ
年取る	年取れ
めぶく	めぶけ
うちなおせる	うちなおせろ
おどろきいる	おどろきいれ
いがむ	いがめ
物申す	物申せ
はらばう	はらばえ
売りきれる	売りきれろ
平める	平めろ
射す	射せ
抱き合わせる	抱き合わせろ
すべりだせる	すべりだせろ
ことたりる	ことたりろ
てきす	てきせ
たたずむ	たたずめ
せりおとす	せりおとせ
追いつく	追いつけ
飲み干す	飲み干せ
こける	こけろ
しとめる	しとめろ
やけつく	やけつけ
呑み潰す	呑み潰せ
たれ込む	たれ込め
たちまよう	たちまよえ
もえたつ	もえたて
行過ぎる	行過ぎろ
滑り降りる	滑り降りろ
明く	明け
禁じる	禁じろ
出来す	出来せ
上擦る	上擦れ
跳ねかす	跳ねかせ
責め落とせる	責め落とせろ
洗い上げる	洗い上げろ
つつみかくす	つつみかくせ
生き返れる	生き返れろ
押し倒せる	押し倒せろ
追い返せる	追い返せろ
追出す	追出せ
うち群れる	うち群れろ
組付ける	組付けろ
消し飛ぶ	消し飛べ
こばめる	こばめろ
遊ばす	遊ばせ
間違える	間違えろ
粘着く	粘着け
思いわずらう	思いわずらえ
おしせまる	おしせまれ
逸らせる	逸らせろ
揺らめく	揺らめけ
使いこむ	使いこめ
免れる	免れろ
やせる	やせろ
はやらせる	はやらせろ
ざす	ざせ
もうしきける	もうしきけろ
一旗揚げる	一旗揚げろ
ちょうずる	一旗揚げろ
逃延びる	逃延びろ
おい付く	おい付け
選り抜く	選り抜け
酌む	酌め
終わる	終われ
にげだせる	にげだせろ
うらなえる	うらなえろ
住まわせる	住まわせろ
はじく	はじけ
吊りあげる	吊りあげろ
申し合わせる	申し合わせろ
ます	ませ
睨みあう	睨みあえ
てんじる	てんじろ
噛み締める	噛み締めろ
切りかえる	切りかえろ
取りこめる	取りこめろ
はりめぐらす	はりめぐらせ
酔つぶれる	酔つぶれろ
つけかえる	つけかえろ
騙し込む	騙し込め
降り立つ	降り立て
攻め寄る	攻め寄れ
和める	和めろ
にぎる	にぎれ
とどめる	とどめろ
はらいさげる	はらいさげろ
組みあわす	組みあわせ
拗らす	拗らせ
読流す	読流せ
おしまくる	おしまくれ
積み分ける	積み分けろ
薙ぎ伏せる	薙ぎ伏せろ
たやせる	たやせろ
けずりたおせる	けずりたおせろ
分け合う	分け合え
むせ返る	むせ返れ
たどりつく	たどりつけ
従う	従え
釣出す	釣出せ
焼き上げる	焼き上げろ
巻き起こせる	巻き起こせろ
固まり合う	固まり合え
ゆびさす	ゆびさせ
駆り立てる	駆り立てろ
列ぶ	列べ
奮う	奮え
付加える	付加えろ
照り付ける	照り付けろ
争える	争えろ
追い払える	追い払えろ
ならびたつ	ならびたて
うちかつ	うちかて
いいはる	いいはれ
のがせる	のがせろ
打切る	打切れ
あじる	あじれ
染込む	染込め
閉める	閉めろ
あおぐ	あおげ
離す	離せ
あやまる	あやまれ
えみわれる	えみわれろ
つけ加わる	つけ加われ
言い暮す	言い暮せ
目掛ける	目掛けろ
染め上がる	染め上がれ
食込む	食込め
繰り込む	繰り込め
つく	つけ
負わす	負わせ
望む	望め
慣れ親しむ	慣れ親しめ
組上げる	組上げろ
障む	障め
きざめる	きざめろ
ゆわえる	ゆわえろ
漏る	漏れ
うつ伏せる	うつ伏せろ
約する	約しろ
ひるがえせる	ひるがえせろ
割り出す	割り出せ
代える	代えろ
こごえる	こごえろ
持ち上がる	持ち上がれ
節する	節しろ
抱きこむ	抱きこめ
回る	回れ
かきおとす	かきおとせ
息詰る	息詰れ
まてる	まてろ
むつむ	むつめ
洗い出す	洗い出せ
滑る	滑れ
ゆるせる	ゆるせろ
倒れる	倒れろ
ふりこめる	ふりこめろ
別れる	別れろ
てこずる	てこずれ
あいかわる	あいかわれ
打破る	打破れ
申しあわせる	申しあわせろ
のりこむ	のりこめ
なりだす	なりだせ
生きのびる	生きのびろ
おいだす	おいだせ
うすらぐ	うすらげ
組入れる	組入れろ
すまわす	すまわせ
ゆいあげる	ゆいあげろ
飲み潰れる	飲み潰れろ
よりたおす	よりたおせ
付込む	付込め
こと足る	こと足れ
埋かる	埋かれ
つかいはたす	つかいはたせ
熟れる	熟れろ
乗出す	乗出せ
濯げる	濯げろ
ほうむれる	ほうむれろ
孵る	孵れ
なで下ろす	なで下ろせ
附す	附せ
廻れる	廻れろ
読み上げる	読み上げろ
追ひ廻す	追ひ廻せ
射通す	射通せ
濾す	濾せ
行渡る	行渡れ
聞き届ける	聞き届けろ
えがきだす	えがきだせ
込む	込め
えり抜く	えり抜け
打直す	打直せ
困る	困れ
花開く	花開け
諾する	諾しろ
かねそなえる	かねそなえろ
ねらわれる	ねらわれろ
手が込む	手が込め
ぬぐえる	ぬぐえろ
乗りだす	乗りだせ
ききそこなう	ききそこなえ
すりかえる	すりかえろ
きりあげる	きりあげろ
怖じ気付く	怖じ気付け
照らし合せる	照らし合せろ
割れる	割れろ
てらしあわせる	てらしあわせろ
もやせる	もやせろ
えばる	えばれ
おじる	おじろ
煩いつく	煩いつけ
慣らす	慣らせ
あせる	あせれ
うらぎれる	うらぎれろ
切立つ	切立て
わずらわせる	わずらわせろ
吹っきれる	吹っきれろ
つくりだす	つくりだせ
応じる	応じろ
けずりとれる	けずりとれろ
たのむ	たのめ
そめあげる	そめあげろ
はたらく	はたらけ
説きつける	説きつけろ
おしこめる	おしこめろ
張りめぐらせる	張りめぐらせろ
みえすく	みえすけ
飛出す	飛出せ
ていさいぶる	ていさいぶれ
ふれまわる	ふれまわれ
護る	護れ
いっす	いっせ
離せる	離せろ
掘りおこす	掘りおこせ
思い合わせる	思い合わせろ
描き出す	描き出せ
集まれる	集まれろ
たたみこめる	たたみこめろ
まくしあげる	まくしあげろ
ほぐれる	ほぐれろ
打ち破る	打ち破れ
いいよれる	いいよれろ
繰返す	繰返せ
にぎわす	にぎわせ
読み返す	読み返せ
はたらかせる	はたらかせろ
低まる	低まれ
降敷く	降敷け
取り合わせる	取り合わせろ
選び取れる	選び取れろ
賎しめる	賎しめろ
ぶちまける	ぶちまけろ
おもいきる	おもいきれ
わきおこる	わきおこれ
引返す	引返せ
そうろう	そうろえ
編みだす	編みだせ
語る	語れ
追掛ける	追掛けろ
しぼめる	しぼめろ
みすかせる	みすかせろ
むせび泣く	むせび泣け
うちあける	うちあけろ
まいらせる	まいらせろ
詰寄る	詰寄れ
やりあう	やりあえ
やわらぐ	やわらげ
打ちあげる	打ちあげろ
ふるまえる	ふるまえろ
ろうたける	ろうたけろ
滑り出せる	滑り出せろ
染上げる	染上げろ
寄れる	寄れろ
洗う	洗え
聞きもらす	聞きもらせ
蝕する	蝕しろ
およぎつける	およぎつけろ
澄む	澄め
つれかえる	つれかえれ
乗換える	乗換えろ
当てこむ	当てこめ
飲下す	飲下せ
降り懸かる	降り懸かれ
訪う	訪え
剥せる	剥せろ
ちぢめる	ちぢめろ
酔っぱらえる	酔っぱらえろ
辿る	辿れ
闘う	闘え
震わせる	震わせろ
つまだつ	つまだて
綴る	綴れ
見開く	見開け
踊る	踊れ
話し掛ける	話し掛けろ
取り下げる	取り下げろ
履ける	履けろ
果たす	果たせ
こばむ	こばめ
摩る	摩れ
閃く	閃け
進める	進めろ
うずもれる	うずもれろ
とりわける	とりわけろ
吹き替える	吹き替えろ
立たす	立たせ
強まる	強まれ
かたぶける	かたぶけろ
つける	つけろ
取り換える	取り換えろ
重ね合わす	重ね合わせ
取捨てる	取捨てろ
書きとめる	書きとめろ
謡える	謡えろ
つなげる	つなげろ
跳ね返す	跳ね返せ
ききすごす	ききすごせ
走れる	走れろ
ある	あれ
付け替える	付け替えろ
吹っかける	吹っかけろ
ハネ出す	ハネ出せ
点す	点せ
引っかける	引っかけろ
若く	若け
挽く	挽け
話しかける	話しかけろ
切り込める	切り込めろ
抱き留める	抱き留めろ
助かる	助かれ
飛びかかる	飛びかかれ
立ち行く	立ち行け
刈り取れる	刈り取れろ
結く	結け
恋い慕う	恋い慕え
はがす	はがせ
惚気ける	惚気けろ
勝越す	勝越せ
銘じる	銘じろ
たらしこむ	たらしこめ
取り篭める	取り篭めろ
打ち殺す	打ち殺せ
言う	言え
さげすむ	さげすめ
割く	割け
出す	出せ
すがる	すがれ
ぬく	ぬけ
申し込む	申し込め
発する	発しろ
みする	みしろ
押さえ付ける	押さえ付けろ
打ち合わせる	打ち合わせろ
負け越す	負け越せ
げきする	げきしろ
主立つ	主立て
しはらう	しはらえ
うちなおす	うちなおせ
うちかえせる	うちかえせろ
だきとめる	だきとめろ
横切れる	横切れろ
言いよどむ	言いよどめ
きりくずす	きりくずせ
へる	へれ
へらす	へらせ
手向ける	手向けろ
ひっつかむ	ひっつかめ
見舞う	見舞え
はめる	はめろ
飛立つ	飛立て
撃ち破る	撃ち破れ
にじりよる	にじりよれ
つけくわえる	つけくわえろ
落ちこぼれる	落ちこぼれろ
あくたれる	あくたれろ
こんぐらかる	こんぐらかれ
経巡る	経巡れ
窄める	窄めろ
食いしばる	食いしばれ
よいつぶれる	よいつぶれろ
みあたる	みあたれ
ちぢかむ	ちぢかめ
皺める	皺めろ
聞き込める	聞き込めろ
いがみ合う	いがみ合え
勝てる	勝てろ
あけはらう	あけはらえ
唸る	唸れ
盛り合わす	盛り合わせ
まねぶ	まねべ
絞める	絞めろ
むきあう	むきあえ
よそえる	よそえろ
うすまる	うすまれ
立遅れる	立遅れろ
なざす	なざせ
どける	どけろ
上り詰める	上り詰めろ
たたきあげる	たたきあげろ
うけだす	うけだせ
炙る	炙れ
つぐなえる	つぐなえろ
引き上げる	引き上げろ
むかえる	むかえろ
堪え忍べる	堪え忍べろ
ひからびる	ひからびろ
はれる	はれろ
据え付ける	据え付けろ
つきでる	つきでろ
はしりこむ	はしりこめ
縮まる	縮まれ
談じ込める	談じ込めろ
付す	付せ
さきそろう	さきそろえ
突っかえす	突っかえせ
もちはこぶ	もちはこべ
スる	スれ
言寄る	言寄れ
蔑する	蔑しろ
あゆみはじめる	あゆみはじめろ
つかさどる	つかさどれ
諳んずる	つかさどれ
吹っ掛ける	吹っ掛けろ
たてなおす	たてなおせ
冷かす	冷かせ
おもいとどまれる	おもいとどまれろ
切りはずす	切りはずせ
にふくめる	にふくめろ
引きずり出せる	引きずり出せろ
織成す	織成せ
梳る	梳れ
うちかえす	うちかえせ
めなれる	めなれろ
突き出せる	突き出せろ
ふりむく	ふりむけ
掘り進む	掘り進め
買い占める	買い占めろ
いぶく	いぶけ
もぎる	もぎれ
充てがう	充てがえ
いやす	いやせ
跨ぐ	跨げ
纏める	纏めろ
うかがう	うかがえ
差し止める	差し止めろ
型どれる	型どれろ
おとしいれる	おとしいれろ
ベタつく	ベタつけ
よべる	よべろ
掴み合う	掴み合え
ずりおちる	ずりおちろ
貯め込む	貯め込め
のみまわす	のみまわせ
喘ぐ	喘げ
裏返す	裏返せ
引きしめる	引きしめろ
ほじる	ほじれ
おおう	おおえ
見て取れる	見て取れろ
相続く	相続け
ねりあわせる	ねりあわせろ
取り掛かる	取り掛かれ
過ぎる	過ぎろ
阿る	阿れ
降こめる	降こめろ
にじみ出る	にじみ出ろ
准ずる	にじみ出ろ
巻き上げる	巻き上げろ
継ぎ足す	継ぎ足せ
生まれ変われる	生まれ変われろ
おこなえる	おこなえろ
取り交わせる	取り交わせろ
たもてる	たもてろ
繋る	繋れ
かみしめる	かみしめろ
ずれこむ	ずれこめ
たつ	たて
嘯く	嘯け
壊す	壊せ
よみくらべる	よみくらべろ
救える	救えろ
はせさんじる	はせさんじろ
脹らます	脹らませ
咳く	咳け
泳がせる	泳がせろ
のりはずす	のりはずせ
泣きつく	泣きつけ
かえれる	かえれろ
言い回す	言い回せ
蕩ける	蕩けろ
乗り出せる	乗り出せろ
調う	調え
こなす	こなせ
ふみだせる	ふみだせろ
霞む	霞め
換わる	換われ
没す	没せ
浴びる	浴びろ
食らわす	食らわせ
臨める	臨めろ
くりひろげる	くりひろげろ
かんばしる	かんばしれ
施す	施せ
あらいだす	あらいだせ
りかいしあえる	りかいしあえろ
およる	およれ
かざす	かざせ
おさまる	おさまれ
削り取る	削り取れ
屈する	屈しろ
併せる	併せろ
しのぐ	しのげ
ねづく	ねづけ
く	け
入れ替わる	入れ替われ
見すかす	見すかせ
言い做す	言い做せ
ちりばめる	ちりばめろ
問いただせる	問いただせろ
降りしきる	降りしきれ
打ち上げる	打ち上げろ
おりかえせる	おりかえせろ
頌する	頌しろ
読ふける	読ふけれ
迎え撃つ	迎え撃て
まがう	まがえ
付き纏う	付き纏え
縮める	縮めろ
ころせる	ころせろ
おもいまどう	おもいまどえ
浚える	浚えろ
狂れる	狂れろ
婀娜めく	婀娜めけ
突っ掛る	突っ掛れ
もとむ	もとめ
真面目くさる	真面目くされ
売りつける	売りつけろ
はかる	はかれ
したおす	したおせ
におう	におえ
たらす	たらせ
推し量れる	推し量れろ
おしやる	おしやれ
もうしいれる	もうしいれろ
暴れ出す	暴れ出せ
憤る	憤れ
責付ける	責付けろ
飲ます	飲ませ
按ずる	飲ませ
持ち上げる	持ち上げろ
ひきさける	ひきさけろ
しばる	しばれ
駆け寄れる	駆け寄れろ
端折れる	端折れろ
佇む	佇め
怯む	怯め
ほごす	ほごせ
つくろえる	つくろえろ
打ち沈む	打ち沈め
構える	構えろ
撲りとばす	撲りとばせ
座り込める	座り込めろ
きよまる	きよまれ
たちさる	たちされ
取合う	取合え
かき込む	かき込め
備える	備えろ
ふとれる	ふとれろ
じゃう	じゃえ
折れる	折れろ
いきかう	いきかえ
解きあかす	解きあかせ
付き随う	付き随え
おもだつ	おもだて
人なれる	人なれろ
めぐりあえる	めぐりあえろ
せき上げる	せき上げろ
合える	合えろ
のみ込む	のみ込め
量る	量れ
切り出す	切り出せ
しつらえる	しつらえろ
おっこちる	おっこちろ
まきつける	まきつけろ
つよめる	つよめろ
ことかく	ことかけ
もぐ	もげ
握りしめる	握りしめろ
固める	固めろ
食い込む	食い込め
いたわりあう	いたわりあえ
触合う	触合え
差出す	差出せ
そしる	そしれ
おしあげる	おしあげろ
よろう	よろえ
抜あがる	抜あがれ
さしうつむく	さしうつむけ
漂う	漂え
のりこなせる	のりこなせろ
宥める	宥めろ
打あぐむ	打あぐめ
おこす	おこせ
取り鎮める	取り鎮めろ
傷める	傷めろ
ひきおろせる	ひきおろせろ
ふん縛る	ふん縛れ
ひきおとす	ひきおとせ
おそなわる	おそなわれ
受け出せる	受け出せろ
聴ける	聴けろ
うきたてる	うきたてろ
おちいる	おちいれ
のりあげる	のりあげろ
突きのめす	突きのめせ
馴染める	馴染めろ
もうしのべる	もうしのべろ
煮やす	煮やせ
歩みよる	歩みよれ
沸おこる	沸おこれ
はからう	はからえ
集う	集え
いろづく	いろづけ
組み合わす	組み合わせ
かいつける	かいつけろ
勝抜く	勝抜け
揉む	揉め
しきつめる	しきつめろ
外らせる	外らせろ
怠ける	怠けろ
なげうつ	なげうて
追い出せる	追い出せろ
かいあがる	かいあがれ
会える	会えろ
申し合わす	申し合わせ
すまわせる	すまわせろ
澄み切る	澄み切れ
きわまる	きわまれ
よろこべる	よろこべろ
もらす	もらせ
上向く	上向け
思いがける	思いがけろ
のびなやむ	のびなやめ
てりかがやく	てりかがやけ
挟み切る	挟み切れ
ぼっする	ぼっしろ
擦り切れる	擦り切れろ
黴びる	黴びろ
もちあわせる	もちあわせろ
ふるぼける	ふるぼけろ
蠕く	蠕け
打ちこむ	打ちこめ
おもいだす	おもいだせ
つっぱれる	つっぱれろ
きりたおす	きりたおせ
やわらげる	やわらげろ
差し戻す	差し戻せ
届けでる	届けでろ
群がる	群がれ
振り込む	振り込め
わかれる	わかれろ
しのびよる	しのびよれ
惑わす	惑わせ
居合わせる	居合わせろ
つまさきだつ	つまさきだて
せしめる	せしめろ
宿れる	宿れろ
成れる	成れろ
盈ちる	盈ちろ
通ずる	盈ちろ
かいとれる	かいとれろ
はるめく	はるめけ
切り取れる	切り取れろ
聞きただす	聞きただせ
遡れる	遡れろ
耽る	耽れ
ちなむ	ちなめ
さずける	さずけろ
とう	とえ
とびだす	とびだせ
跳ね出す	跳ね出せ
盛上がる	盛上がれ
学び取る	学び取れ
こじつける	こじつけろ
くわえもつ	くわえもて
あいなかばする	あいなかばしろ
よりあつまる	よりあつまれ
雪ぐ	雪げ
見合わせる	見合わせろ
たのしめる	たのしめろ
およぼせる	およぼせろ
けとばす	けとばせ
ぬきつらねる	ぬきつらねろ
くみとる	くみとれ
かんけいづける	かんけいづけろ
噴き出す	噴き出せ
ひきちぎる	ひきちぎれ
買いしめる	買いしめろ
さす	させ
赤らめる	赤らめろ
打ち抜く	打ち抜け
付あがる	付あがれ
ねじくれる	ねじくれろ
ふきとばせる	ふきとばせろ
だす	だせ
かきいれる	かきいれろ
みつけだせる	みつけだせろ
当はまる	当はまれ
くぼまる	くぼまれ
ぬぎすてる	ぬぎすてろ
取りくむ	取りくめ
言立てる	言立てろ
掬する	掬しろ
焼かす	焼かせ
おいぬく	おいぬけ
ひきあえる	ひきあえろ
呑明かす	呑明かせ
洗い流せる	洗い流せろ
甲走る	甲走れ
差支える	差支えろ
割る	割ろ
生じる	生じろ
呼込む	呼込め
止まれる	止まれろ
紛らわせる	紛らわせろ
切換える	切換えろ
しみったれる	しみったれろ
ふすぶる	ふすぶれ
立て込む	立て込め
居残れる	居残れろ
掻き鳴らす	掻き鳴らせ
のろう	のろえ
まじろぐ	まじろげ
じらせる	じらせろ
痛みいる	痛みいれ
乾し殺す	乾し殺せ
勝つ	勝て
飽きる	飽きろ
契る	契れ
磨き込む	磨き込め
設ける	設けろ
秘す	秘せ
言い捨てる	言い捨てろ
差し出でる	差し出でろ
仕入れる	仕入れろ
取っ組む	取っ組め
従く	従け
数え立てる	数え立てろ
ひっ提げる	ひっ提げろ
おくりとどける	おくりとどけろ
遅らせる	遅らせろ
だます	だませ
比べる	比べろ
僻む	僻め
引きずり出す	引きずり出せ
罷り間違う	罷り間違え
たおれる	たおれろ
つけあがる	つけあがれ
滴る	滴れ
見向く	見向け
絞め殺す	絞め殺せ
懲りる	懲りろ
知恵づく	知恵づけ
遣り合う	遣り合え
搾り取れる	搾り取れろ
量りこむ	量りこめ
煮えたぎる	煮えたぎれ
言いふらす	言いふらせ
見顕す	見顕せ
名付ける	名付けろ
ちらばる	ちらばれ
承ける	承けろ
かいならす	かいならせ
楽しむ	楽しめ
切れ上がる	切れ上がれ
勘づく	勘づけ
見なせる	見なせろ
判ずる	見なせろ
書送る	書送れ
のぼせ上がる	のぼせ上がれ
もみ消せる	もみ消せろ
おかけいたす	おかけいたせ
引き込める	引き込めろ
あやつれる	あやつれろ
這いつくばう	這いつくばえ
ぶちこむ	ぶちこめ
案じる	案じろ
語り継ぐ	語り継げ
落着ける	落着けろ
くぐりぬける	くぐりぬけろ
造り上げる	造り上げろ
引き分ける	引き分けろ
精げる	精げろ
朽ちる	朽ちろ
つまみあげる	つまみあげろ
しばりあげる	しばりあげろ
問返す	問返せ
おしきれる	おしきれろ
なする	なすれ
なおせる	なおせろ
撰ぶ	撰べ
つかす	つかせ
ふるい落とす	ふるい落とせ
ぶん投げる	ぶん投げろ
関連づける	関連づけろ
ひどる	ひどれ
すくいあげる	すくいあげろ
とりのこす	とりのこせ
つきそう	つきそえ
おびきだせる	おびきだせろ
拉する	拉しろ
とびあるく	とびあるけ
みまがう	みまがえ
つぎ込める	つぎ込めろ
浴びせかける	浴びせかけろ
静まり返る	静まり返れ
悩み抜く	悩み抜け
空かす	空かせ
ふるいつく	ふるいつけ
くぐもる	くぐもれ
おりこめる	おりこめろ
萌える	萌えろ
そぐ	そげ
禦ぐ	禦げ
見逃す	見逃せ
繁る	繁れ
下せる	下せろ
めりこむ	めりこめ
つよまる	つよまれ
めいうつ	めいうて
言い兼ねる	言い兼ねろ
取り上せる	取り上せろ
借り受ける	借り受けろ
差響く	差響け
やくせる	やくせろ
飛び出る	飛び出ろ
しめしあわす	しめしあわせ
あせじみる	あせじみろ
おいつかう	おいつかえ
すりきる	すりきれ
斥ける	斥けろ
できる	できろ
うすめる	うすめろ
ひんまげる	ひんまげろ
隙取る	隙取れ
のめり込む	のめり込め
頂く	頂け
塗れる	塗れろ
気付かす	気付かせ
まっとうする	まっとうしろ
殺す	殺せ
ぶっ続ける	ぶっ続けろ
はこびこめる	はこびこめろ
とびたつ	とびたて
避ける	避けろ
としよる	としよれ
合う	合え
泊める	泊めろ
渡り合える	渡り合えろ
釣り上がる	釣り上がれ
期する	期しろ
いばれる	いばれろ
切廻す	切廻せ
よっぱらう	よっぱらえ
さぐる	さぐれ
誘きよせる	誘きよせろ
犒う	犒え
打ち出す	打ち出せ
すさる	すされ
冷ます	冷ませ
注げる	注げろ
まちこがれる	まちこがれろ
つっぱねる	つっぱねろ
割り戻す	割り戻せ
ねじあう	ねじあえ
震えあがる	震えあがれ
漏れ聞く	漏れ聞け
しめ切る	しめ切れ
ひきころす	ひきころせ
よわまる	よわまれ
どもる	どもれ
ひする	ひしろ
はする	はしろ
しまう	しまえ
交う	交え
シャレる	シャレろ
ふりだせる	ふりだせろ
息せき切る	息せき切れ
栄える	栄えろ
ひりだす	ひりだせ
おる	おれ
かさばる	かさばれ
突っ突く	突っ突け
冴えわたる	冴えわたれ
打ちはらう	打ちはらえ
まいもどれる	まいもどれろ
掃く	掃け
たよる	たよれ
見過ごせる	見過ごせろ
出あう	出あえ
なきあかす	なきあかせ
四角張る	四角張れ
からかう	からかえ
荒ぶ	荒べ
にくまれる	にくまれろ
倒す	倒せ
どなる	どなれ
踏分ける	踏分けろ
勢い込む	勢い込め
よみかえせる	よみかえせろ
口ずさむ	口ずさめ
尽す	尽せ
討ち滅ぼす	討ち滅ぼせ
嗅ぐ	嗅げ
探り当てる	探り当てろ
息衝く	息衝け
上る	上れ
買いこむ	買いこめ
買戻す	買戻せ
ぬくめる	ぬくめろ
接げる	接げろ
連れ戻せる	連れ戻せろ
やくだてる	やくだてろ
懸け隔てる	懸け隔てろ
たちつくす	たちつくせ
しょうずる	たちつくせ
奮い立つ	奮い立て
ろんじる	ろんじろ
掴まえる	掴まえろ
あがめる	あがめろ
興醒める	興醒めろ
巡り合う	巡り合え
そそぐ	そそげ
萎える	萎えろ
かこむ	かこめ
朝する	朝しろ
もたれ掛かる	もたれ掛かれ
着付ける	着付けろ
よどむ	よどめ
そる	それ
こぎる	こぎれ
量れる	量れろ
うりいそぐ	うりいそげ
なぞらえる	なぞらえろ
灼く	灼け
せつく	せつけ
煎りつける	煎りつけろ
おりまげる	おりまげろ
よびいれる	よびいれろ
差し向ける	差し向けろ
当てつける	当てつけろ
好きこのむ	好きこのめ
頌える	頌えろ
むくいる	むくいろ
かきとる	かきとれ
遊び歩く	遊び歩け
付け合わせる	付け合わせろ
かきくらす	かきくらせ
のむ	のめ
持ちかえる	持ちかえれ
育つ	育て
あいうつ	あいうて
炊あがる	炊あがれ
没する	没しろ
のめる	のめれ
はこべる	はこべろ
解れる	解れろ
すげる	すげろ
落つ	落て
綻ぶ	綻べ
刻みつける	刻みつけろ
迫る	迫れ
赤らむ	赤らめ
見限る	見限れ
巣篭る	巣篭れ
ぬかるむ	ぬかるめ
読みこなす	読みこなせ
ひきこめる	ひきこめろ
くらべる	くらべろ
食いつく	食いつけ
衝く	衝け
かざりつける	かざりつけろ
あだめく	あだめけ
言逃れる	言逃れろ
責めつける	責めつけろ
投げる	投げろ
持ち歩ける	持ち歩けろ
煩う	煩え
学ぶ	学べ
もちはこべる	もちはこべろ
ほれこむ	ほれこめ
買い戻す	買い戻せ
かけあわせる	かけあわせろ
点じる	点じろ
間にあう	間にあえ
蒔き直す	蒔き直せ
おいまわせる	おいまわせろ
かえせる	かえせろ
閉込める	閉込めろ
買い戻せる	買い戻せろ
拭き取れる	拭き取れろ
黙り込む	黙り込め
点頭く	点頭け
ひきおこす	ひきおこせ
見込む	見込め
巡り会える	巡り会えろ
行き暮れる	行き暮れろ
かぶれる	かぶれろ
こきおろす	こきおろせ
じょする	じょしろ
抜き放つ	抜き放て
ねわすれる	ねわすれろ
聞置く	聞置け
剥す	剥せ
疎む	疎め
偽る	偽れ
垂さがる	垂さがれ
ころべる	ころべろ
のぞきこむ	のぞきこめ
想う	想え
奢る	奢れ
引っ掻く	引っ掻け
死す	死せ
もりころす	もりころせ
死に後れる	死に後れろ
寄り切る	寄り切れ
ざする	ざしろ
ぱちつかせる	ぱちつかせろ
突っかかる	突っかかれ
つらなる	つらなれ
包める	包めろ
にがす	にがせ
せんする	せんしろ
みわたす	みわたせ
沸かす	沸かせ
むさぼる	むさぼれ
励ます	励ませ
助け出せる	助け出せろ
かみ殺せる	かみ殺せろ
きりこまざく	きりこまざけ
しごく	しごけ
抜き合せる	抜き合せろ
突き返す	突き返せ
すりあげる	すりあげろ
付随う	付随え
ゆわく	ゆわけ
遇する	遇しろ
当て込める	当て込めろ
見上げる	見上げろ
賑わう	賑わえ
費やす	費やせ
掃出す	掃出せ
差立てる	差立てろ
つまめる	つまめろ
思い込む	思い込め
増える	増えろ
擂り潰す	擂り潰せ
がする	がしろ
よみわける	よみわけろ
信じ込める	信じ込めろ
せきあげる	せきあげろ
現ずる	せきあげろ
なぜる	なぜろ
ひっくりかえれる	ひっくりかえれろ
たるむ	たるめ
誑す	誑せ
あまがける	あまがけれ
はたらける	はたらけろ
悄気返る	悄気返れ
切羽詰まる	切羽詰まれ
求む	求め
だきあえる	だきあえろ
食切る	食切れ
産み落とす	産み落とせ
留置く	留置け
給う	給え
廃れる	廃れろ
のしあがる	のしあがれ
見とがめる	見とがめろ
叶う	叶え
吊るす	吊るせ
注す	注せ
つたわる	つたわれ
あやどる	あやどれ
抱きとめる	抱きとめろ
なくする	なくしろ
なでる	なでろ
読みさす	読みさせ
ころがれる	ころがれろ
憂える	憂えろ
追い返す	追い返せ
過ごせる	過ごせろ
みがく	みがけ
さしせまる	さしせまれ
寄り切れる	寄り切れろ
追い使う	追い使え
流行る	流行れ
働きかける	働きかけろ
信じ合える	信じ合えろ
まくらする	まくらしろ
とりいる	とりいれ
切り掛ける	切り掛けろ
そなえる	そなえろ
呆れる	呆れろ
浸かる	浸かれ
はげ落ちる	はげ落ちろ
きずつく	きずつけ
おくまる	おくまれ
とりそろう	とりそろえ
突き通せる	突き通せろ
きょうじる	きょうじろ
駆付ける	駆付けろ
結わえる	結わえろ
蟠る	蟠れ
泣き濡れる	泣き濡れろ
見透す	見透せ
盗める	盗めろ
引っ込む	引っ込め
峙つ	峙て
ながれこむ	ながれこめ
どんする	どんしろ
流行らす	流行らせ
みなおす	みなおせ
忘する	忘しろ
詰める	詰めろ
引き裂く	引き裂け
興す	興せ
いぶかる	いぶかれ
映し出す	映し出せ
しぼる	しぼれ
ふみこす	ふみこせ
計れる	計れろ
ひくめる	ひくめろ
仕向ける	仕向けろ
抱く	抱け
立ち寄る	立ち寄れ
ぱくつく	ぱくつけ
似る	似ろ
忍び込む	忍び込め
塗りたくる	塗りたくれ
練り上げる	練り上げろ
やむをえる	やむをえろ
投げ出す	投げ出せ
入れ替る	入れ替れ
粘り抜ける	粘り抜けろ
ほれる	ほれろ
引きかえす	引きかえせ
売る	売れ
悼む	悼め
叩き上げる	叩き上げろ
乗り掛かる	乗り掛かれ
ゆずりわたす	ゆずりわたせ
すげ替える	すげ替えろ
たくわえる	たくわえろ
売切れる	売切れろ
雇える	雇えろ
かきかえる	かきかえろ
羞じらう	羞じらえ
泣付く	泣付け
みあう	みあえ
出張る	出張れ
寝かす	寝かせ
くいつぶす	くいつぶせ
かきまわす	かきまわせ
畳み掛ける	畳み掛けろ
すまう	すまえ
干枯らびる	干枯らびろ
取りまく	取りまけ
はてる	はてろ
撃ち落とせる	撃ち落とせろ
沸き上がる	沸き上がれ
飲みつぶす	飲みつぶせ
いいあらわせる	いいあらわせろ
歩き回る	歩き回れ
だける	だけろ
決する	決しろ
ぬぐう	ぬぐえ
もうしあわす	もうしあわせ
血走る	血走れ
顕す	顕せ
煉る	煉れ
ぐうする	ぐうしろ
書残す	書残せ
取りだす	取りだせ
目盛る	目盛れ
敗ける	敗けろ
洗い立てる	洗い立てろ
しのぶ	しのべ
書き換える	書き換えろ
死にそこなう	死にそこなえ
やる	やれ
おもいなやむ	おもいなやめ
飛び掛る	飛び掛れ
変り果てる	変り果てろ
でくわす	でくわせ
いいあらそう	いいあらそえ
たよれる	たよれろ
ふぶく	ふぶけ
越せる	越せろ
すべくくる	すべくくれ
掴みあう	掴みあえ
持ち崩す	持ち崩せ
ふみつぶす	ふみつぶせ
堪る	堪れ
呆れ返る	呆れ返れ
片す	片せ
はりあえる	はりあえろ
なりたつ	なりたて
走り込める	走り込めろ
しゃしゃり出る	しゃしゃり出ろ
醒ませる	醒ませろ
ゆく	ゆけ
縛れる	縛れろ
ねりあげる	ねりあげろ
存する	存しろ
かしずく	かしずけ
覆える	覆えろ
くいあらす	くいあらせ
起き直れる	起き直れろ
思いあたる	思いあたれ
あやつる	あやつれ
責め合う	責め合え
おわらす	おわらせ
通せる	通せろ
とりひしぐ	とりひしげ
ひきぬく	ひきぬけ
せめさいなむ	せめさいなめ
あからめる	あからめろ
差し越える	差し越えろ
進ずる	差し越えろ
巡り会う	巡り会え
げんじる	げんじろ
覚ませる	覚ませろ
ひっかぶる	ひっかぶれ
かなでる	かなでろ
そりおとせる	そりおとせろ
いためつける	いためつけろ
害す	害せ
聞す	聞せ
よなげる	よなげろ
すいする	すいしろ
見下せる	見下せろ
手放せる	手放せろ
ゆうきづく	ゆうきづけ
やられる	やられろ
そむける	そむけろ
疑う	疑え
唄う	唄え
掴まる	掴まれ
なりあがる	なりあがれ
そそげる	そそげろ
弱まる	弱まれ
取り縋る	取り縋れ
持ち越せる	持ち越せろ
取り除く	取り除け
収まる	収まれ
ひとはたあげる	ひとはたあげろ
切り分ける	切り分けろ
亙る	亙れ
すべる	すべれ
がなる	がなれ
見遣る	見遣れ
かけめぐる	かけめぐれ
滑らす	滑らせ
産み落とせる	産み落とせろ
作りかえる	作りかえろ
さきはじめる	さきはじめろ
つっかかる	つっかかれ
捩じこむ	捩じこめ
まきなおす	まきなおせ
負ぶさる	負ぶされ
はさめる	はさめろ
つのぐむ	つのぐめ
聞き取る	聞き取れ
表立つ	表立て
見張る	見張れ
差昇る	差昇れ
およぼす	およぼせ
尊ぶ	尊べ
考える	考えろ
賀する	賀しろ
鎮める	鎮めろ
あだする	あだしろ
切り払える	切り払えろ
盗み出す	盗み出せ
ききこめる	ききこめろ
追返す	追返せ
窪む	窪め
言切る	言切れ
出で立つ	出で立て
ぶつかる	ぶつかれ
笑いころげる	笑いころげろ
取り入れる	取り入れろ
うかびあがれる	うかびあがれろ
切らす	切らせ
反返る	反返れ
ふせる	ふせれ
逆らう	逆らえ
閉め切る	閉め切れ
夢みる	夢みろ
ゆき届く	ゆき届け
はく	はけ
逃す	逃せ
患う	患え
義務付ける	義務付けろ
漁る	漁れ
いらう	いらえ
嗜む	嗜め
まぎらわせる	まぎらわせろ
梳かす	梳かせ
書き直す	書き直せ
立ち上がれる	立ち上がれろ
あるく	あるけ
押える	押えろ
のりこめる	のりこめろ
こむ	こめ
買い入れる	買い入れろ
通りかかる	通りかかれ
気にいる	気にいれ
送り返す	送り返せ
取替える	取替えろ
もうしこす	もうしこせ
ふみならせる	ふみならせろ
おくりかえせる	おくりかえせろ
臭わす	臭わせ
しなう	しなえ
取り廻す	取り廻せ
とりそろえる	とりそろえろ
おいつける	おいつけろ
申し合せる	申し合せろ
とびぬける	とびぬけろ
興ざめる	興ざめろ
語り込める	語り込めろ
押さえる	押さえろ
現われる	現われろ
くずせる	くずせろ
おどれる	おどれろ
押つまる	押つまれ
先がける	先がけろ
さいばしる	さいばしれ
振放つ	振放て
ねつける	ねつけろ
深める	深めろ
こじあける	こじあけろ
請出す	請出せ
鄙びる	鄙びろ
散らす	散らせ
払い戻す	払い戻せ
揺すぶる	揺すぶれ
すさむ	すさめ
たちかわれる	たちかわれろ
かよう	かよえ
附ける	附けろ
あせばむ	あせばめ
あまてらす	あまてらせ
造りだす	造りだせ
うけもつ	うけもて
渡る	渡れ
かいつまむ	かいつまめ
殖える	殖えろ
打寄せる	打寄せろ
ばかげる	ばかげろ
おちのびる	おちのびろ
はいりこむ	はいりこめ
敷く	敷け
さきほこる	さきほこれ
丸める	丸めろ
引き立つ	引き立て
妬ける	妬けろ
じゃくする	じゃくしろ
はねとばす	はねとばせ
煮え繰り返る	煮え繰り返れ
乗り回す	乗り回せ
きりはずせる	きりはずせろ
着こなせる	着こなせろ
召し捕る	召し捕れ
しぼれる	しぼれろ
けしきばむ	けしきばめ
くるしむ	くるしめ
号する	号しろ
噴き上げる	噴き上げろ
気おされる	気おされろ
くわだてる	くわだてろ
通る	通れ
狂う	狂え
決めこむ	決めこめ
図れる	図れろ
とりあげる	とりあげろ
住まう	住まえ
ひんす	ひんせ
ふれる	ふれろ
言わす	言わせ
行く	行け
及ぼす	及ぼせ
引払う	引払え
埋め込める	埋め込めろ
目くるめく	目くるめけ
抜く	抜け
ねり合せる	ねり合せろ
纏える	纏えろ
につめる	につめろ
返る	返れ
くりかえす	くりかえせ
はらいこめる	はらいこめろ
説付ける	説付けろ
選び出す	選び出せ
はやる	はやれ
聞きあきる	聞きあきろ
おいやれる	おいやれろ
切開く	切開け
踞る	踞れ
棄てる	棄てろ
撓む	撓め
染あがる	染あがれ
埋めたてる	埋めたてろ
同じる	同じろ
あばれだす	あばれだせ
なおす	なおせ
呼び起こす	呼び起こせ
連れる	連れろ
ふりおとせる	ふりおとせろ
みだれる	みだれろ
誘い合わす	誘い合わせ
たちもどる	たちもどれ
眇める	眇めろ
ねびる	ねびろ
漉き返す	漉き返せ
克つ	克て
極め付ける	極め付けろ
こそぎ落とす	こそぎ落とせ
まちくたびれる	まちくたびれろ
追廻す	追廻せ
願い出でる	願い出でろ
奏する	奏しろ
咳き入る	咳き入れ
取り続ける	取り続けろ
さます	さませ
いためる	いためろ
ふかす	ふかせ
断れる	断れろ
ひきとる	ひきとれ
突っ走れる	突っ走れろ
くみこめる	くみこめろ
うてる	うてろ
のがす	のがせ
磨く	磨け
いきぬける	いきぬけろ
盛りつける	盛りつけろ
継足す	継足せ
弾く	弾け
痴れる	痴れろ
くり上げる	くり上げろ
ふみだす	ふみだせ
たちこむ	たちこめ
綻びる	綻びろ
食倒す	食倒せ
炊ぐ	炊げ
咲きこぼれる	咲きこぼれろ
言い換える	言い換えろ
静まる	静まれ
悔い改める	悔い改めろ
隣合う	隣合え
居坐る	居坐れ
助ける	助けろ
奏でる	奏でろ
報う	報え
まもれる	まもれろ
はさみきる	はさみきれ
治る	治れ
のりとおす	のりとおせ
といただせる	といただせろ
そばだつ	そばだて
いろどれる	いろどれろ
きり組む	きり組め
産みおとす	産みおとせ
寄せる	寄せろ
埋め立てる	埋め立てろ
くわす	くわせ
紐解く	紐解け
さしいれる	さしいれろ
辷り込む	辷り込め
傾ぐ	傾げ
売り払える	売り払えろ
むく	むけ
うちこめる	うちこめろ
やせこける	やせこけろ
まつわる	まつわれ
煮え滾る	煮え滾れ
翳る	翳れ
一肌脱ぐ	一肌脱げ
くめる	くめろ
わかやぐ	わかやげ
つっぱしる	つっぱしれ
裁ける	裁けろ
はっする	はっしろ
述べる	述べろ
押返す	押返せ
まわりこめる	まわりこめろ
力付ける	力付けろ
切り立てる	切り立てろ
かどだつ	かどだて
せめかける	せめかけろ
きしる	きしれ
引き戻せる	引き戻せろ
うもれる	うもれろ
辞する	辞しろ
編む	編め
取広げる	取広げろ
止む	止め
有触れる	有触れろ
ねらい打てる	ねらい打てろ
立てこもる	立てこもれ
除く	除け
甜める	甜めろ
聞損なう	聞損なえ
聞き捨てる	聞き捨てろ
ふみしだく	ふみしだけ
読み耽る	読み耽れ
挟み込む	挟み込め
絡める	絡めろ
走り回れる	走り回れろ
ただれる	ただれろ
滾つ	滾て
なすり付ける	なすり付けろ
あつめる	あつめろ
カエる	カエれ
手伝える	手伝えろ
はりあわす	はりあわせ
熱る	熱れ
しょい込む	しょい込め
くみつける	くみつけろ
たずさわる	たずさわれ
練り直せる	練り直せろ
たたきおこす	たたきおこせ
とりざたす	とりざたせ
育む	育め
きなさる	きなされ
寝かせる	寝かせろ
なつく	なつけ
かぎ出せる	かぎ出せろ
飛び離れる	飛び離れろ
たれさがる	たれさがれ
とりちがえる	とりちがえろ
言い放す	言い放せ
配り歩ける	配り歩けろ
吹きまくる	吹きまくれ
へし折る	へし折れ
受止める	受止めろ
啜り泣く	啜り泣け
張り合う	張り合え
あか抜ける	あか抜けろ
知らせる	知らせろ
帯びる	帯びろ
むすぶ	むすべ
打ち見る	打ち見ろ
行届く	行届け
華やぐ	華やげ
おそれる	おそれろ
たずねる	たずねろ
あるける	あるけろ
突っ伏す	突っ伏せ
つちかえる	つちかえろ
住み替る	住み替れ
いや増す	いや増せ
ぶち当てる	ぶち当てろ
つきすすめる	つきすすめろ
おさえこむ	おさえこめ
舞戻る	舞戻れ
撮れる	撮れろ
あばく	あばけ
しれる	しれろ
整う	整え
かきくれる	かきくれろ
踏み付ける	踏み付けろ
呵る	呵れ
持込む	持込め
だまりこくる	だまりこくれ
ほてる	ほてれ
染みる	染みろ
連れ回す	連れ回せ
暗む	暗め
待ち付ける	待ち付けろ
買切る	買切れ
勝ち越せる	勝ち越せろ
着ぶくれる	着ぶくれろ
おどす	おどせ
間引ける	間引けろ
たやす	たやせ
うめこめる	うめこめろ
すめる	すめろ
見抜ける	見抜けろ
嫌われる	嫌われろ
盛あがる	盛あがれ
息む	息め
創り出す	創り出せ
ぶつ	ぶて
ふきあれる	ふきあれろ
振り払う	振り払え
みきる	みきれ
ごてる	ごてろ
しんじこむ	しんじこめ
差伸べる	差伸べろ
さしぐむ	さしぐめ
飛び廻る	飛び廻れ
取違える	取違えろ
かんじいる	かんじいれ
辞む	辞め
のりかかる	のりかかれ
とむ	とめ
ひる	ひろ
色づく	色づけ
とうじる	とうじろ
討止める	討止めろ
しもがかる	しもがかれ
落合う	落合え
ふみぬく	ふみぬけ
しみわたる	しみわたれ
捕る	捕れ
もえつく	もえつけ
並べ立てる	並べ立てろ
かたれる	かたれろ
撃てる	撃てろ
さまよう	さまよえ
ほえる	ほえろ
引つれる	引つれろ
思い悩む	思い悩め
組み直す	組み直せ
投出す	投出せ
血ばしる	血ばしれ
折れ込む	折れ込め
扱き下ろす	扱き下ろせ
まとえる	まとえろ
喫する	喫しろ
よこぎる	よこぎれ
乗り付ける	乗り付けろ
けんずる	乗り付けろ
刈り入れる	刈り入れろ
倒せる	倒せろ
さしかかる	さしかかれ
閉す	閉せ
かしこまる	かしこまれ
あららげる	あららげろ
擦れる	擦れろ
ありがたがる	ありがたがれ
抱きしめる	抱きしめろ
みちびきだせる	みちびきだせろ
ひっとらえる	ひっとらえろ
おしかける	おしかけろ
どなりこむ	どなりこめ
やらかす	やらかせ
くるう	くるえ
明け渡す	明け渡せ
渡り合う	渡り合え
手間取る	手間取れ
貸し出せる	貸し出せろ
相いれる	相いれろ
えどる	えどれ
掻き出す	掻き出せ
しいする	しいしろ
取乱す	取乱せ
なりわたる	なりわたれ
熟する	熟しろ
やきすてる	やきすてろ
張り巡らす	張り巡らせ
駆り集める	駆り集めろ
潮垂れる	潮垂れろ
冷やかす	冷やかせ
貯める	貯めろ
引き渡す	引き渡せ
たかめる	たかめろ
ちぢむ	ちぢめ
いらっしゃる	いらっしゃれ
塗付ける	塗付けろ
縢る	縢れ
詠み込める	詠み込めろ
伸びゆく	伸びゆけ
埋め合せる	埋め合せろ
はせさんずる	埋め合せろ
蔑む	蔑め
待てる	待てろ
鎮まる	鎮まれ
あそべる	あそべろ
たてる	たてろ
こしらえる	こしらえろ
うっちゃる	うっちゃれ
開ける	開けろ
谷まる	谷まれ
なベかえる	なベかえろ
あずけいれる	あずけいれろ
追いかける	追いかけろ
よみとおす	よみとおせ
行き詰まる	行き詰まれ
騒がす	騒がせ
見え透く	見え透け
おそわれる	おそわれろ
巣だつ	巣だて
落ち着く	落ち着け
追い縋る	追い縋れ
きえのこる	きえのこれ
おく	おけ
いける	いけろ
産む	産め
つたう	つたえ
ときつける	ときつけろ
歩き回れる	歩き回れろ
突あたる	突あたれ
約す	約せ
はいす	はいせ
うわつく	うわつけ
下ろす	下ろせ
すすみだせる	すすみだせろ
競る	競れ
こりかたまる	こりかたまれ
遣い込む	遣い込め
悖る	悖れ
踏みしめる	踏みしめろ
ほほえむ	ほほえめ
誘い掛ける	誘い掛けろ
読みつぐ	読みつげ
信ずる	読みつげ
ゆき悩む	ゆき悩め
薫る	薫れ
とりこむ	とりこめ
攫う	攫え
突っぱねる	突っぱねろ
かねあう	かねあえ
はまる	はまれ
揺さぶる	揺さぶれ
受けつける	受けつけろ
もどせる	もどせろ
繰り入れる	繰り入れろ
生まれ変わる	生まれ変われ
持たす	持たせ
降り続く	降り続け
縫いつける	縫いつけろ
とびはなれる	とびはなれろ
にぶる	にぶれ
浮つく	浮つけ
夾む	夾め
よわめる	よわめろ
変る	変れ
さけぶ	さけべ
くぼめる	くぼめろ
でそろう	でそろえ
散りはてる	散りはてろ
のりおくれる	のりおくれろ
つかうまつる	つかうまつれ
引っ捕える	引っ捕えろ
取戻す	取戻せ
うすれる	うすれろ
もりあがる	もりあがれ
称す	称せ
暴ける	暴けろ
ひきのける	ひきのけろ
しぼり上げる	しぼり上げろ
さがしだせる	さがしだせろ
いきり立つ	いきり立て
抜く	抜け
取りまとめる	取りまとめろ
ふっ切れる	ふっ切れろ
絶えはてる	絶えはてろ
えんじる	えんじろ
行く	行け
転がす	転がせ
うちやぶる	うちやぶれ
捜せる	捜せろ
引こもる	引こもれ
組み合す	組み合せ
思い起こせる	思い起こせろ
絞る	絞れ
なつかしむ	なつかしめ
ふきこめる	ふきこめろ
泳ぎ着く	泳ぎ着け
成り下がれる	成り下がれろ
たすける	たすけろ
そそり立てる	そそり立てろ
たたき出す	たたき出せ
取り消す	取り消せ
繰り出せる	繰り出せろ
染め返す	染め返せ
とびこむ	とびこめ
ひしげる	ひしげろ
吹き飛ぶ	吹き飛べ
盛り込める	盛り込めろ
手こずる	手こずれ
むかいあう	むかいあえ
掴める	掴めろ
引攣れる	引攣れろ
楯突く	楯突け
ひきさがる	ひきさがれ
肖る	肖れ
便ずる	肖れ
摘み取る	摘み取れ
せいだせる	せいだせろ
断てる	断てろ
りゃくす	りゃくせ
降りかかる	降りかかれ
うえこめる	うえこめろ
酔しれる	酔しれろ
はぐらかせる	はぐらかせろ
しあがる	しあがれ
取壊す	取壊せ
吹きすさぶ	吹きすさべ
ゆがめる	ゆがめろ
生かる	生かれ
とり殺す	とり殺せ
かきくもる	かきくもれ
乱れる	乱れろ
さがしまわる	さがしまわれ
庇う	庇え
ついてまわる	ついてまわれ
かいつくろう	かいつくろえ
ふける	ふけろ
飛びたつ	飛びたて
採り上げる	採り上げろ
くみす	くみせ
明け離れる	明け離れろ
取りつく	取りつけ
買い被る	買い被れ
むらだつ	むらだて
浮きたつ	浮きたて
持て扱う	持て扱え
おさえる	おさえろ
翻る	翻れ
飲み下す	飲み下せ
著す	著せ
わびる	わびろ
とげだつ	とげだて
賜う	賜え
いする	いしろ
のけぞる	のけぞれ
勇気づく	勇気づけ
勢いづける	勢いづけろ
突く	突け
ふんじばる	ふんじばれ
待ち伏せる	待ち伏せろ
さいなむ	さいなめ
たてとおす	たてとおせ
詣る	詣れ
うる	詣れ
謳う	謳え
すいあげる	すいあげろ
逃せる	逃せろ
まちもうける	まちもうけろ
当こする	当こすれ
行き合う	行き合え
折りたたむ	折りたため
うちあぐむ	うちあぐめ
下がかる	下がかれ
縮み上がる	縮み上がれ
飛び上がる	飛び上がれ
取り付ける	取り付けろ
ゆきあたる	ゆきあたれ
零落れる	零落れろ
かまける	かまけろ
蒸らす	蒸らせ
合う	合え
縮む	縮め
経上がる	経上がれ
立ち上がる	立ち上がれ
ぬきだせる	ぬきだせろ
告ぐ	告げ
だす	だせ
突き出す	突き出せ
取りやめる	取りやめろ
つきかえす	つきかえせ
ざんねんがる	ざんねんがれ
付け加える	付け加えろ
やりとげる	やりとげろ
ふりまく	ふりまけ
屯する	屯しろ
はりあう	はりあえ
召し上げる	召し上げろ
解けあう	解けあえ
切り開く	切り開け
見直す	見直せ
打ちあわす	打ちあわせ
窺う	窺え
貶む	貶め
捏ねかえす	捏ねかえせ
呼び叫ぶ	呼び叫べ
たちいたる	たちいたれ
たまげる	たまげろ
受継ぐ	受継げ
消え残る	消え残れ
さしひかえる	さしひかえろ
追い越せる	追い越せろ
じゅんずる	追い越せろ
建つ	建て
終わらせる	終わらせろ
もみあう	もみあえ
差し付ける	差し付けろ
むきあえる	むきあえろ
寝そびれる	寝そびれろ
立回る	立回れ
舞い戻れる	舞い戻れろ
言い当てる	言い当てろ
すっ飛ぶ	すっ飛べ
生れおちる	生れおちろ
乗り組める	乗り組めろ
いらっしゃる	いらっしゃれ
切上げる	切上げろ
貢ずる	切上げろ
さしだせる	さしだせろ
わたりあう	わたりあえ
守り抜く	守り抜け
うずもる	うずもれ
保てる	保てろ
みひらく	みひらけ
引き合わす	引き合わせ
過ぎ行く	過ぎ行け
因む	因め
いちゃつく	いちゃつけ
糶る	糶れ
捲き揚げる	捲き揚げろ
ひきずりだす	ひきずりだせ
取り壊せる	取り壊せろ
攻めたてる	攻めたてろ
為す	為せ
澄みわたる	澄みわたれ
填る	填れ
周章てる	周章てろ
感づく	感づけ
たちなおる	たちなおれ
跳ねあがる	跳ねあがれ
値する	値しろ
ぐずつく	ぐずつけ
かき寄せる	かき寄せろ
奨める	奨めろ
折畳む	折畳め
馴れ合う	馴れ合え
作り出せる	作り出せろ
守る	守れ
かりとれる	かりとれろ
思い知らす	思い知らせ
とおれる	とおれろ
巻きこむ	巻きこめ
並みいる	並みいろ
めんじる	めんじろ
陳べる	陳べろ
たちそう	たちそえ
さしとめる	さしとめろ
調べる	調べろ
惚ける	惚けろ
ゆるぎ出る	ゆるぎ出ろ
べと付く	べと付け
まちあわす	まちあわせ
煮含める	煮含めろ
べとつく	べとつけ
かりたてる	かりたてろ
かりきる	かりきれ
つからせる	つからせろ
捜し求める	捜し求めろ
撫す	撫せ
くみとれる	くみとれろ
かっ飛ばす	かっ飛ばせ
かき鳴らす	かき鳴らせ
ふるわせる	ふるわせろ
鋳潰す	鋳潰せ
食違う	食違え
打ち合せる	打ち合せろ
せせくる	せせくれ
気付く	気付け
触回る	触回れ
走り回る	走り回れ
とぐ	とげ
いいこめる	いいこめろ
かこつける	かこつけろ
振り当てる	振り当てろ
にぎわう	にぎわえ
こわばる	こわばれ
長引く	長引け
みきわめる	みきわめろ
押通す	押通せ
かたづく	かたづけ
すいとる	すいとれ
おきあがれる	おきあがれろ
航る	航れ
浮べる	浮べろ
引きたてる	引きたてろ
さしこす	さしこせ
掘り出す	掘り出せ
染めかえす	染めかえせ
泣込む	泣込め
とりまぎれる	とりまぎれろ
かけまわる	かけまわれ
見なれる	見なれろ
思い止る	思い止れ
老いる	老いろ
すすむ	すすめ
くりだす	くりだせ
廻す	廻せ
寝惚ける	寝惚けろ
凝り固まる	凝り固まれ
向き直る	向き直れ
塞がる	塞がれ
ふちどる	ふちどれ
脹らむ	脹らめ
たぶらかす	たぶらかせ
年老いる	年老いろ
買い込む	買い込め
征する	征しろ
届ける	届けろ
勝ち越す	勝ち越せ
にぎわわす	にぎわわせ
ゆける	ゆけろ
捌かす	捌かせ
縛り上げる	縛り上げろ
はしょれる	はしょれろ
だまくらかす	だまくらかせ
捺す	捺せ
問いただす	問いただせ
相伴う	相伴え
かがやかす	かがやかせ
売り払う	売り払え
のりする	のりしろ
滑り込める	滑り込めろ
吸い取る	吸い取れ
重んじる	重んじろ
もどる	もどれ
恨む	恨め
はやめる	はやめろ
錆び付く	錆び付け
つめきる	つめきれ
怒鳴り込む	怒鳴り込め
観ずる	怒鳴り込め
引当てる	引当てろ
押し薦める	押し薦めろ
あてがう	あてがえ
つやめく	つやめけ
取次ぐ	取次げ
捨て去る	捨て去れ
さぐりだせる	さぐりだせろ
仕上る	仕上れ
乗ずる	仕上れ
にえる	にえろ
留め置く	留め置け
敷きつめる	敷きつめろ
交ぜっかえす	交ぜっかえせ
かき消す	かき消せ
切り裂く	切り裂け
烟る	烟れ
ききつける	ききつけろ
煮る	煮ろ
みにつける	みにつけろ
ぐれる	ぐれろ
ねりあわす	ねりあわせ
つきとおす	つきとおせ
座りこむ	座りこめ
臥せる	臥せれ
立ち去る	立ち去れ
降す	降せ
おじける	おじけろ
かすむ	かすめ
ねらい打つ	ねらい打て
織れる	織れろ
はびこる	はびこれ
見直せる	見直せろ
仰向く	仰向け
満ち足りる	満ち足りろ
つぎたせる	つぎたせろ
乗りかける	乗りかけろ
さらけだす	さらけだせ
なげかてる	なげかてろ
則る	則れ
ころぶ	ころべ
しぶる	しぶれ
こびり着く	こびり着け
みみなれる	みみなれろ
拉ぐ	拉げ
憂ふ	拉げ
分け与える	分け与えろ
位置付ける	位置付けろ
おもいきれる	おもいきれろ
弄ぶ	弄べ
飛び乗れる	飛び乗れろ
売りさばく	売りさばけ
おもいこむ	おもいこめ
握る	握れ
考え出す	考え出せ
係わる	係われ
塗り替える	塗り替えろ
堪りかねる	堪りかねろ
きつける	きつけろ
しゃぶる	しゃぶれ
降かかる	降かかれ
吹き出る	吹き出ろ
叱り付ける	叱り付けろ
物言う	物言え
とびかう	とびかえ
適う	適え
弘める	弘めろ
服す	服せ
おしきる	おしきれ
乱す	乱せ
助け合う	助け合え
もめる	もめろ
追える	追えろ
寵する	寵しろ
繰り合せる	繰り合せろ
にごらす	にごらせ
改まる	改まれ
伐つ	伐て
ひれふす	ひれふせ
打取れる	打取れろ
しのべる	しのべろ
きえうせる	きえうせろ
かい摘む	かい摘め
為出かす	為出かせ
酔う	酔え
うけつける	うけつけろ
取り扱える	取り扱えろ
這い出す	這い出せ
入りまじる	入りまじれ
打壊す	打壊せ
見積る	見積れ
恥じる	恥じろ
襲かかる	襲かかれ
張飛ばす	張飛ばせ
亡くす	亡くせ
降らせる	降らせろ
培える	培えろ
宿す	宿せ
捻じくれる	捻じくれろ
かしつける	かしつけろ
言い寄る	言い寄れ
込上げる	込上げろ
こと足りる	こと足りろ
誂える	誂えろ
消え失せる	消え失せろ
使える	使えろ
さきわう	さきわえ
くたびれる	くたびれろ
張り詰める	張り詰めろ
張裂ける	張裂けろ
取り崩せる	取り崩せろ
逆巻く	逆巻け
切りかかる	切りかかれ
思いあわせる	思いあわせろ
つまびく	つまびけ
しばたたく	しばたたけ
あげつらる	あげつられ
付回す	付回せ
呑み明かす	呑み明かせ
おいかえす	おいかえせ
思い乱れる	思い乱れろ
呼び入れる	呼び入れろ
賑やかす	賑やかせ
骨ばる	骨ばれ
誘いまくる	誘いまくれ
割ける	割けろ
光り輝く	光り輝け
絶やせる	絶やせろ
容れる	容れろ
則する	則しろ
餌付く	餌付け
読み誤る	読み誤れ
ふきとる	ふきとれ
涸れる	涸れろ
おどける	おどけろ
ためらう	ためらえ
おもいわずらう	おもいわずらえ
埋め合わせる	埋め合わせろ
徹る	徹れ
へす	へせ
たたき込める	たたき込めろ
ととのえなおす	ととのえなおせ
しずめる	しずめろ
書き込める	書き込めろ
じゃらつく	じゃらつけ
笑む	笑め
たえる	たえろ
飽き飽きする	飽き飽きしろ
ゆるぎでる	ゆるぎでろ
かいくる	かいくれ
おぶる	おぶれ
買い与える	買い与えろ
こき下ろす	こき下ろせ
たちのぼる	たちのぼれ
刈り上げる	刈り上げろ
ちょんぎる	ちょんぎれ
いいはなす	いいはなせ
召しあげる	召しあげろ
きりつける	きりつけろ
いびり出す	いびり出せ
付け上がる	付け上がれ
形づくる	形づくれ
つうぶる	つうぶれ
うれえる	うれえろ
逆立てる	逆立てろ
舞い上がる	舞い上がれ
はこびだせる	はこびだせろ
覚える	覚えろ
晒せる	晒せろ
といあわす	といあわせ
きり入る	きり入れ
毒づく	毒づけ
急かせる	急かせろ
逝く	逝け
腰掛ける	腰掛けろ
いる	いろ
切りかける	切りかけろ
先走る	先走れ
ふきはらう	ふきはらえ
あかぬける	あかぬけろ
おうずる	あかぬけろ
起あがる	起あがれ
咲き誇る	咲き誇れ
めしあがれる	めしあがれろ
ふみにじる	ふみにじれ
かたりこむ	かたりこめ
震い付く	震い付け
削り取れる	削り取れろ
浮び上がる	浮び上がれ
娶す	娶せ
思いつめる	思いつめろ
つめかえる	つめかえろ
すべりおりる	すべりおりろ
かぐ	かげ
打倒せる	打倒せろ
より抜ける	より抜けろ
嗄れる	嗄れろ
渡す	渡せ
悟る	悟れ
ふれ合う	ふれ合え
引込む	引込め
赤める	赤めろ
差し押える	差し押えろ
こんじる	こんじろ
折りこむ	折りこめ
疲らす	疲らせ
いきかえる	いきかえれ
きる	きれ
刈込む	刈込め
片寄せる	片寄せろ
つくねる	つくねろ
振りはらう	振りはらえ
ひけらかす	ひけらかせ
せばまる	せばまれ
打ち落とせる	打ち落とせろ
しくじる	しくじれ
ねかす	ねかせ
にえたぎる	にえたぎれ
こうずる	にえたぎれ
おどりはじめる	おどりはじめろ
寫せる	寫せろ
勤しむ	勤しめ
永らえる	永らえろ
忘れる	忘れろ
ふてくされる	ふてくされろ
当たり散らす	当たり散らせ
論じる	論じろ
描ける	描けろ
めいる	めいれ
渦まく	渦まけ
照りはえる	照りはえろ
くすむ	くすめ
見きわめる	見きわめろ
牛耳る	牛耳れ
はい出る	はい出ろ
持ち運べる	持ち運べろ
きしむ	きしめ
振り込める	振り込めろ
聞きほれる	聞きほれろ
義務づける	義務づけろ
損ねる	損ねろ
おこせる	おこせろ
うけもてる	うけもてろ
くりまわす	くりまわせ
つきとばせる	つきとばせろ
貴ぶ	貴べ
おりたたむ	おりたため
割り出せる	割り出せろ
とどこおる	とどこおれ
さびつく	さびつけ
咲乱れる	咲乱れろ
存じる	存じろ
きえさる	きえされ
這入る	這入れ
思いたつ	思いたて
ひとかわむく	ひとかわむけ
ききおとす	ききおとせ
ただす	ただせ
たえはてる	たえはてろ
持て成す	持て成せ
現せる	現せろ
わらわれる	わらわれろ
おれこむ	おれこめ
頭抜ける	頭抜けろ
匂わす	匂わせ
関わる	関われ
ひきつける	ひきつけろ
鳴る	鳴れ
見のがす	見のがせ
印する	印しろ
慴れる	慴れろ
気が付く	気が付け
ふりむける	ふりむけろ
あるきまわる	あるきまわれ
乗り移る	乗り移れ
咲きでる	咲きでろ
こぼれる	こぼれろ
採り入れる	採り入れろ
着膨れる	着膨れろ
弛れる	弛れろ
手伝う	手伝え
せいす	せいせ
撲りつける	撲りつけろ
飛回る	飛回れ
くずれさる	くずれされ
有す	有せ
手繰る	手繰れ
彩る	彩れ
くいちがう	くいちがえ
放る	放れ
賑わせる	賑わせろ
遠退ける	遠退けろ
亡ぼす	亡ぼせ
廻せる	廻せろ
こもれる	こもれろ
乗せる	乗せろ
殺せる	殺せろ
擧げる	擧げろ
まよう	まよえ
まじわれる	まじわれろ
ぼける	ぼけろ
叩きあげる	叩きあげろ
はむ	はめ
ききわける	ききわけろ
組織だつ	組織だて
滑れる	滑れろ
居合せる	居合せろ
食止める	食止めろ
冴え渡る	冴え渡れ
あいつぐ	あいつげ
ちゃう	ちゃえ
あらそえる	あらそえろ
さしあたる	さしあたれ
酔える	酔えろ
まとまる	まとまれ
ひきこもる	ひきこもれ
くぎれる	くぎれろ
ちがう	ちがえ
辞める	辞めろ
追いやる	追いやれ
潰える	潰えろ
すずめる	すずめろ
くれる	くれろ
鍛える	鍛えろ
もちだす	もちだせ
引っ掴む	引っ掴め
稼ぐ	稼げ
対する	対しろ
列する	列しろ
はさみこめる	はさみこめろ
繁り合う	繁り合え
喫す	喫せ
処す	処せ
取り分ける	取り分けろ
つづりあわせる	つづりあわせろ
てらす	てらせ
つかむ	つかめ
てがこむ	てがこめ
組み立てる	組み立てろ
貶す	貶せ
ダブつく	ダブつけ
おぶさる	おぶされ
捌ける	捌けろ
印象づける	印象づけろ
詰込む	詰込め
たしなむ	たしなめ
看取れる	看取れろ
目する	目しろ
いいすてる	いいすてろ
ばいする	ばいしろ
降りそそぐ	降りそそげ
堰く	堰け
護れる	護れろ
くだく	くだけ
吊上がる	吊上がれ
肥す	肥せ
せせらわらえる	せせらわらえろ
和らげる	和らげろ
臭う	臭え
直す	直せ
照り輝く	照り輝け
かききえる	かききえろ
打ち取れる	打ち取れろ
煮えくりかえる	煮えくりかえれ
動かせる	動かせろ
へつらう	へつらえ
ひねる	ひねれ
ほりすすむ	ほりすすめ
あるきつづける	あるきつづけろ
曇る	曇れ
説く	説け
しのばす	しのばせ
ぶったぎる	ぶったぎれ
擂り込む	擂り込め
附く	附け
航れる	航れろ
付け加わる	付け加われ
傾ける	傾けろ
よみきれる	よみきれろ
切りこまざく	切りこまざけ
切り刻む	切り刻め
生け捕れる	生け捕れろ
てらう	てらえ
てばなす	てばなせ
まけこす	まけこせ
あげる	あげろ
さっぴく	さっぴけ
這い纏る	這い纏れ
とおのく	とおのけ
交ざる	交ざれ
売り渡す	売り渡せ
鳴きしきる	鳴きしきれ
うばいとる	うばいとれ
詠みこむ	詠みこめ
いいふるす	いいふるせ
つつむ	つつめ
捜す	捜せ
歎ずる	捜せ
埋もれる	埋もれろ
かくまう	かくまえ
でつくす	でつくせ
飛乗る	飛乗れ
腐す	腐せ
取り殺す	取り殺せ
ひきのばせる	ひきのばせろ
つまみだせる	つまみだせろ
きかかる	きかかれ
とく	とけ
こんがらがる	こんがらがれ
おりあえる	おりあえろ
こぼせる	こぼせろ
はりこむ	はりこめ
ふりはらえる	ふりはらえろ
出切る	出切れ
たたきこむ	たたきこめ
教わる	教われ
花やぐ	花やげ
責めさいなむ	責めさいなめ
噛みしめる	噛みしめろ
狂わす	狂わせ
装える	装えろ
さしのべる	さしのべろ
つきとおせる	つきとおせろ
さばく	さばけ
滞る	滞れ
ふりはなつ	ふりはなて
振りまく	振りまけ
特性づける	特性づけろ
問い返す	問い返せ
ねたむ	ねため
ねころべる	ねころべろ
待設ける	待設けろ
拾い上げる	拾い上げろ
舞込む	舞込め
飛び回る	飛び回れ
感じとれる	感じとれろ
走る	走れ
かむ	かめ
たたき起こす	たたき起こせ
突き刺せる	突き刺せろ
寄り掛かる	寄り掛かれ
ふやける	ふやけろ
よがる	よがれ
たたかえる	たたかえろ
乗り進める	乗り進めろ
しわぶく	しわぶけ
穢れる	穢れろ
さすらう	さすらえ
当り散らす	当り散らせ
ぼくする	ぼくしろ
掻い出す	掻い出せ
繰り延べる	繰り延べろ
たいする	たいしろ
いりくむ	いりくめ
対す	対せ
一花咲かせる	一花咲かせろ
振込む	振込め
ゆりおこす	ゆりおこせ
送り返せる	送り返せろ
よりわける	よりわけろ
近づける	近づけろ
くろずむ	くろずめ
踏み出す	踏み出せ
座りこめる	座りこめろ
きゅうする	きゅうしろ
若がえる	若がえれ
ひっかえす	ひっかえせ
言触らす	言触らせ
推し量る	推し量れ
知りぬく	知りぬけ
擁す	擁せ
見積もれる	見積もれろ
ひきもどす	ひきもどせ
填める	填めろ
つっ伏す	つっ伏せ
ためす	ためせ
広がる	広がれ
油染みる	油染みろ
まどわす	まどわせ
まとわりつく	まとわりつけ
聞き付ける	聞き付けろ
さかのぼれる	さかのぼれろ
手づまる	手づまれ
立ち向かう	立ち向かえ
ふりそそぐ	ふりそそげ
いいよどむ	いいよどめ
へしゃげる	へしゃげろ
かきぬく	かきぬけ
愛せる	愛せろ
焦れる	焦れろ
浸す	浸せ
嘲る	嘲れ
かっきる	かっきれ
謝れる	謝れろ
取り留める	取り留めろ
きざみこむ	きざみこめ
縫い込める	縫い込めろ
因る	因れ
おちゃらかす	おちゃらかせ
付け出す	付け出せ
ならべたてる	ならべたてろ
みてとれる	みてとれろ
膨らす	膨らせ
のりうつる	のりうつれ
言いすてる	言いすてろ
はたく	はたけ
あてつける	あてつけろ
手懐ける	手懐けろ
きこなす	きこなせ
流し込む	流し込め
くさむす	くさむせ
買い上がる	買い上がれ
重なり合う	重なり合え
ぬぐいとる	ぬぐいとれ
娶せる	娶せろ
しんずる	娶せろ
うとんずる	娶せろ
歯向かう	歯向かえ
撓う	撓え
立ち会う	立ち会え
とりあえる	とりあえろ
抜合せる	抜合せろ
替われる	替われろ
撃ち抜く	撃ち抜け
緩める	緩めろ
産まれる	産まれろ
さっ引く	さっ引け
めんくらう	めんくらえ
剃り落とす	剃り落とせ
飛出る	飛出ろ
うりとばせる	うりとばせろ
色付く	色付け
むしばむ	むしばめ
へんずる	むしばめ
みおろす	みおろせ
おもう	おもえ
戻れる	戻れろ
塗り立てる	塗り立てろ
続く	続け
脱がす	脱がせ
差しあげる	差しあげろ
志ざす	志ざせ
組み合わせる	組み合わせろ
跳ね上がる	跳ね上がれ
取り巻く	取り巻け
捩じ向ける	捩じ向けろ
高ぶる	高ぶれ
しらむ	しらめ
書き捨てる	書き捨てろ
列べる	列べろ
きそえる	きそえろ
問い合わす	問い合わせ
つづく	つづけ
攀じる	攀じろ
ぬすみだせる	ぬすみだせろ
つぶす	つぶせ
追っかける	追っかけろ
咳込む	咳込め
聞きかえす	聞きかえせ
とかせる	とかせろ
あらう	あらえ
みつげる	みつげろ
すりこめる	すりこめろ
かたりあかす	かたりあかせ
取りあう	取りあえ
とりおこなう	とりおこなえ
押せる	押せろ
絡み付く	絡み付け
取返す	取返せ
すじばる	すじばれ
ならべる	ならべろ
飾りたてる	飾りたてろ
あゆみよれる	あゆみよれろ
熱す	熱せ
かねる	かねろ
たちまわる	たちまわれ
アジる	アジれ
さびれる	さびれろ
ころがせる	ころがせろ
さび付く	さび付け
かき暗す	かき暗せ
さわぐ	さわげ
たたきこめる	たたきこめろ
とどろかせる	とどろかせろ
引きずりこむ	引きずりこめ
差し挟む	差し挟め
知ろしめす	知ろしめせ
てむかえる	てむかえろ
じまう	じまえ
投付ける	投付けろ
呑み込む	呑み込め
ぶる	ぶれ
わりびける	わりびけろ
ホレる	ホレろ
ねこむ	ねこめ
さしおさえる	さしおさえろ
なおる	なおれ
跳ね返る	跳ね返れ
もちくずす	もちくずせ
連なる	連なれ
見れる	見れろ
干る	干ろ
さしとおす	さしとおせ
たむろする	たむろしろ
みうしなう	みうしなえ
戴ける	戴けろ
言いこめる	言いこめろ
みなす	みなせ
おきる	おきろ
かたちづくる	かたちづくれ
茹だる	茹だれ
すわり込める	すわり込めろ
眠る	眠れ
はき違える	はき違えろ
乗取る	乗取れ
とだえる	とだえろ
面す	面せ
ささげる	ささげろ
まかれる	まかれろ
わたす	わたせ
傾げる	傾げろ
耐忍ぶ	耐忍べ
おちあう	おちあえ
ふりたてる	ふりたてろ
ふくする	ふくしろ
超える	超えろ
立ち代わる	立ち代われ
見そこなう	見そこなえ
かもしだす	かもしだせ
切りさいなむ	切りさいなめ
波打つ	波打て
とりかかる	とりかかれ
寂びる	寂びろ
戯れる	戯れろ
引き替える	引き替えろ
うわる	うわれ
着る	着ろ
あたる	あたれ
もちこむ	もちこめ
事寄せる	事寄せろ
おどろかす	おどろかせ
綾なす	綾なせ
はいでる	はいでろ
かいきる	かいきれ
附する	附しろ
でむく	でむけ
掻き暮れる	掻き暮れろ
ふくれる	ふくれろ
せき込む	せき込め
つづる	つづれ
シラケる	シラケろ
待ち合せる	待ち合せろ
さらけ出す	さらけ出せ
かかえこむ	かかえこめ
上がり込む	上がり込め
水際立つ	水際立て
ぬけでる	ぬけでろ
確かめる	確かめろ
裁つ	裁て
しみいる	しみいれ
立ち止まる	立ち止まれ
いいわたせる	いいわたせろ
思い当る	思い当れ
強請る	強請れ
しもがれる	しもがれろ
提げる	提げろ
連れ出せる	連れ出せろ
刷る	刷れ
つっ放す	つっ放せ
減す	減せ
すぐれる	すぐれろ
晴れる	晴れろ
あおむける	あおむけろ
もてあます	もてあませ
吹く	吹け
わたせる	わたせろ
聞付ける	聞付けろ
聞き損なう	聞き損なえ
はなじろむ	はなじろめ
恥じらう	恥じらえ
くいちらす	くいちらせ
見付かる	見付かれ
擢んでる	擢んでろ
恐れる	恐れろ
ちかう	ちかえ
あけはなつ	あけはなて
もうしあわせる	もうしあわせろ
下ろせる	下ろせろ
言いつくす	言いつくせ
祈ぐ	祈げ
据わる	据われ
あわだつ	あわだて
なじめる	なじめろ
寒気立つ	寒気立て
ぶちあてる	ぶちあてろ
買い切る	買い切れ
干せる	干せろ
兼ね合う	兼ね合え
ですぎる	ですぎろ
凭せかける	凭せかけろ
取殺す	取殺せ
立どまる	立どまれ
もぐりこむ	もぐりこめ
投げ棄てる	投げ棄てろ
挟み込める	挟み込めろ
思いだす	思いだせ
めざめる	めざめろ
にがみばしる	にがみばしれ
よぶ	よべ
むきだす	むきだせ
のれる	のれろ
住みつく	住みつけ
いろめく	いろめけ
くれる	くれろ
請け出す	請け出せ
逸れる	逸れろ
かくす	かくせ
ひきさげる	ひきさげろ
ウケる	ウケろ
えらべる	えらべろ
引合せる	引合せろ
笑いかける	笑いかけろ
篩う	篩え
ほぐす	ほぐせ
拗ける	拗けろ
下げ渋る	下げ渋れ
織込む	織込め
転げ落ちる	転げ落ちろ
過ぎ去る	過ぎ去れ
有り合わせる	有り合わせろ
ぞんじる	ぞんじろ
討てる	討てろ
いいよる	いいよれ
まつ	まて
売払う	売払え
からませる	からませろ
買い受ける	買い受けろ
憐れむ	憐れめ
おくりこむ	おくりこめ
触れ回る	触れ回れ
煉れる	煉れろ
晴れわたる	晴れわたれ
きえる	きえろ
召出す	召出せ
ひん曲がる	ひん曲がれ
くもる	くもれ
へだたる	へだたれ
まぎらわす	まぎらわせ
付添う	付添え
えぐれる	えぐれろ
打ち合す	打ち合せ
組みなおせる	組みなおせろ
うたぐる	うたぐれ
たばかる	たばかれ
妬く	妬け
借り集める	借り集めろ
くいしばる	くいしばれ
言い寄れる	言い寄れろ
嬲る	嬲れ
裏返る	裏返れ
染み付く	染み付け
切り組む	切り組め
おいはらう	おいはらえ
はいあがる	はいあがれ
になう	になえ
防げる	防げろ
砕ける	砕けろ
ふりだす	ふりだせ
うちはたせる	うちはたせろ
取り出せる	取り出せろ
こまる	こまれ
連だつ	連だて
修する	修しろ
組み替える	組み替えろ
すじる	すじれ
呼入れる	呼入れろ
つきもどせる	つきもどせろ
書き立てる	書き立てろ
曰う	曰え
付足す	付足せ
あわせる	あわせろ
立すくむ	立すくめ
釣りあげる	釣りあげろ
つけ回す	つけ回せ
書き残す	書き残せ
追い捲る	追い捲れ
鋤き返す	鋤き返せ
思い立つ	思い立て
締め殺す	締め殺せ
ほったらかす	ほったらかせ
映じる	映じろ
ふるふ	ふるへ
触れる	触れろ
退く	退け
といただす	といただせ
訣れる	訣れろ
さしこむ	さしこめ
死に変る	死に変れ
抗する	抗しろ
転ばす	転ばせ
申し出でる	申し出でろ
生やす	生やせ
こころみる	こころみろ
かいかえる	かいかえろ
搦める	搦めろ
ついやせる	ついやせろ
おちつける	おちつけろ
忘れかける	忘れかけろ
けずりとる	けずりとれ
よっぱらえる	よっぱらえろ
引ずる	引ずれ
免ずる	引ずれ
暈す	暈せ
申し聞ける	申し聞けろ
詣でる	詣でろ
くゆらせる	くゆらせろ
取外す	取外せ
混ぜ返せる	混ぜ返せろ
結べる	結べろ
突っ込める	突っ込めろ
贈れる	贈れろ
どうずる	贈れろ
みたせる	みたせろ
討つ	討て
振り放つ	振り放て
ざれる	ざれろ
吹き鳴らす	吹き鳴らせ
すぎさる	すぎされ
とりはこぶ	とりはこべ
刈りとる	刈りとれ
示しあわせる	示しあわせろ
弾む	弾め
つれこめる	つれこめろ
押し入れる	押し入れろ
割り当てる	割り当てろ
ねじ曲げる	ねじ曲げろ
さからう	さからえ
乗り込む	乗り込め
みこめる	みこめろ
乗移る	乗移れ
屈まる	屈まれ
肥れる	肥れろ
よそう	よそえ
むつかる	むつかれ
見縊る	見縊れ
置換える	置換えろ
躍りかかる	躍りかかれ
捗る	捗れ
弔する	弔しろ
とびのく	とびのけ
たちよる	たちよれ
呼べる	呼べろ
つれだせる	つれだせろ
流る	流ろ
ぬかづく	ぬかづけ
つきさす	つきさせ
ひがむ	ひがめ
冷えこむ	冷えこめ
通り掛かる	通り掛かれ
とっくむ	とっくめ
おしとおす	おしとおせ
抱き取る	抱き取れ
みかえす	みかえせ
亡びる	亡びろ
空く	空け
軋めく	軋めけ
呼ばわる	呼ばわれ
つぐむ	つぐめ
突き合わせる	突き合わせろ
あわす	あわせ
講ずる	あわせ
知り合える	知り合えろ
つきる	つきろ
振立てる	振立てろ
織り上げる	織り上げろ
聞し召す	聞し召せ
なれる	なれろ
せばめる	せばめろ
苛立てる	苛立てろ
こりる	こりろ
縒れる	縒れろ
ぬいつける	ぬいつけろ
へあがる	へあがれ
引き篭る	引き篭れ
くびれる	くびれろ
揺り動かせる	揺り動かせろ
畏まる	畏まれ
誘い合う	誘い合え
言い立てる	言い立てろ
こごる	こごれ
角目立つ	角目立て
あゆみよる	あゆみよれ
吹ける	吹けろ
役立つ	役立て
もうしあげる	もうしあげろ
訪れる	訪れろ
入れ替われる	入れ替われろ
塾す	塾せ
ひきつる	ひきつれ
そそぎこむ	そそぎこめ
憩う	憩え
迷う	迷え
よばわる	よばわれ
はべれる	はべれろ
滴らす	滴らせ
乗遅れる	乗遅れろ
割り込める	割り込めろ
入かわる	入かわれ
せびる	せびれ
取紛れる	取紛れろ
見破れる	見破れろ
とびのれる	とびのれろ
立ち並ぶ	立ち並べ
醒す	醒せ
つづける	つづけろ
閉じ篭る	閉じ篭れ
めげる	めげろ
吹き込める	吹き込めろ
向けなおす	向けなおせ
踏みはずす	踏みはずせ
しめしあわせる	しめしあわせろ
ねむれる	ねむれろ
ぬける	ぬけろ
打ち連れる	打ち連れろ
かくれる	かくれろ
組織立つ	組織立て
見せつける	見せつけろ
取りざたす	取りざたせ
ひむ	ひめ
読み込める	読み込めろ
すきとおる	すきとおれ
おめにかかる	おめにかかれ
介する	介しろ
競り勝つ	競り勝て
震う	震え
聞き齧る	聞き齧れ
苦り切る	苦り切れ
はる	はれ
住まわす	住まわせ
申越す	申越せ
きらめかす	きらめかせ
昇れる	昇れろ
つまみ出せる	つまみ出せろ
抛る	抛れ
塞ぎ込む	塞ぎ込め
あなどる	あなどれ
組みあげる	組みあげろ
度重なる	度重なれ
とりしらべる	とりしらべろ
弁じる	弁じろ
くるまる	くるまれ
きまる	きまれ
しょげる	しょげろ
差し引く	差し引け
立ちこむ	立ちこめ
もぎとる	もぎとれ
落魄れる	落魄れろ
助け出す	助け出せ
しゅうする	しゅうしろ
はせあつまる	はせあつまれ
おいそだつ	おいそだて
しらせる	しらせろ
見つけ出せる	見つけ出せろ
折りかえす	折りかえせ
聞き返せる	聞き返せろ
反する	反しろ
殺める	殺めろ
うちつける	うちつけろ
齧る	齧れ
物思う	物思え
あわてる	あわてろ
逆立つ	逆立て
断ち割る	断ち割れ
かめる	かめろ
ようだいぶる	ようだいぶれ
威す	威せ
ふるえる	ふるえろ
絞れる	絞れろ
汲む	汲め
引っ掛かる	引っ掛かれ
断つ	断て
起こす	起こせ
ぎょうずる	起こせ
もうしつたえる	もうしつたえろ
見受ける	見受けろ
はんずる	見受けろ
紛らせる	紛らせろ
ひっ担ぐ	ひっ担げ
数え上げる	数え上げろ
印せる	印せろ
勝ち抜く	勝ち抜け
いさむ	いさめ
篭る	篭れ
ふきまくる	ふきまくれ
思いまどえる	思いまどえろ
脱せる	脱せろ
かみころす	かみころせ
讃える	讃えろ
言い争う	言い争え
ならえる	ならえろ
有する	有しろ
ひとはなさかせる	ひとはなさかせろ
測る	測れ
拐う	拐え
破れる	破れろ
呼付ける	呼付けろ
すっとぶ	すっとべ
絡ませる	絡ませろ
折込む	折込め
もうかる	もうかれ
駆催す	駆催せ
やりかえす	やりかえせ
当て付ける	当て付けろ
余る	余れ
ふみきれる	ふみきれろ
見なす	見なせ
擦れ違う	擦れ違え
流れ込む	流れ込め
かりこす	かりこせ
蹴る	蹴れ
うず巻く	うず巻け
よびもどせる	よびもどせろ
ぶっつづける	ぶっつづけろ
ふくむ	ふくめ
まぎれ込む	まぎれ込め
生き抜ける	生き抜けろ
受合う	受合え
繰延べる	繰延べろ
さ迷う	さ迷え
つけ上がる	つけ上がれ
引しまる	引しまれ
さしあう	さしあえ
受取る	受取れ
引き具する	引き具しろ
せっぱつまる	せっぱつまれ
かいたたく	かいたたけ
揉み合う	揉み合え
魂消る	魂消ろ
取り運ぶ	取り運べ
すくい上げる	すくい上げろ
せせらわらう	せせらわらえ
枉げる	枉げろ
言いふくめる	言いふくめろ
落ちぶれる	落ちぶれろ
しはらえる	しはらえろ
なであげる	なであげろ
突き放せる	突き放せろ
添える	添えろ
せせら笑える	せせら笑えろ
とってかえす	とってかえせ
とむらえる	とむらえろ
さとる	さとれ
篭もる	篭もれ
按じる	按じろ
見晴らせる	見晴らせろ
とどけでる	とどけでろ
くすぐる	くすぐれ
ほうずる	くすぐれ
興ずる	くすぐれ
浮びあがる	浮びあがれ
織りこむ	織りこめ
出せる	出せろ
いきわたる	いきわたれ
うごめかす	うごめかせ
思いおこす	思いおこせ
はらす	はらせ
もぐり込める	もぐり込めろ
ごったがえす	ごったがえせ
思いとどまれる	思いとどまれろ
荒立つ	荒立て
湯掻く	湯掻け
殺ぐ	殺げ
煮つめる	煮つめろ
ひしめく	ひしめけ
吹き付ける	吹き付けろ
懐ける	懐けろ
なぶる	なぶれ
思い詰める	思い詰めろ
償う	償え
加える	加えろ
ききはずす	ききはずせ
道化ける	道化けろ
転べる	転べろ
かっこむ	かっこめ
躓く	躓け
立ち寄れる	立ち寄れろ
結う	結え
なく	なけ
言いそこなう	言いそこなえ
よじ登れる	よじ登れろ
滅する	滅しろ
空ける	空けろ
脅し付ける	脅し付けろ
映える	映えろ
選べる	選べろ
死なす	死なせ
告げる	告げろ
あやまつ	あやまて
きょうざめる	きょうざめろ
誘い込む	誘い込め
もちあるける	もちあるけろ
痛める	痛めろ
推移る	推移れ
売り出す	売り出せ
きくする	きくしろ
ひきあてる	ひきあてろ
打解ける	打解けろ
言い直せる	言い直せろ
退かす	退かせ
気遣う	気遣え
づける	づけろ
取っちめる	取っちめろ
デモる	デモれ
跳び越す	跳び越せ
甦る	甦れ
かわる	かわれ
差固める	差固めろ
矧ぐ	矧げ
まじめくさる	まじめくされ
踏み倒す	踏み倒せ
ひきはなす	ひきはなせ
さかす	さかせ
逆だつ	逆だて
はばめる	はばめろ
切詰める	切詰めろ
たぐえる	たぐえろ
射貫く	射貫け
けちる	けちれ
嘲笑う	嘲笑え
ひさぐ	ひさげ
あそびあるく	あそびあるけ
もうしこめる	もうしこめろ
払戻す	払戻せ
逃げ出す	逃げ出せ
ふてる	ふてろ
ひねれる	ひねれろ
勢い付く	勢い付け
ぬれそぼつ	ぬれそぼて
指せる	指せろ
あじわえる	あじわえろ
流す	流せ
つぼむ	つぼめ
わたくしする	わたくししろ
いただく	いただけ
打ち直す	打ち直せ
やぶる	やぶれ
かきあつめる	かきあつめろ
おびる	おびろ
取り落とす	取り落とせ
もうしおくる	もうしおくれ
畳む	畳め
よす	よせ
やむを得る	やむを得ろ
なまる	なまれ
語り明かす	語り明かせ
飛び渡る	飛び渡れ
問い詰める	問い詰めろ
取っつく	取っつけ
揺がす	揺がせ
さきんじる	さきんじろ
取越す	取越せ
似かよう	似かよえ
見捨てる	見捨てろ
封ずる	見捨てろ
せき止める	せき止めろ
眠らす	眠らせ
取りつかれる	取りつかれろ
蕩かす	蕩かせ
上がれる	上がれろ
読みあさる	読みあされ
こわがる	こわがれ
刷り込める	刷り込めろ
怒鳴りつける	怒鳴りつけろ
申込む	申込め
さえる	さえろ
くろみがかる	くろみがかれ
垢抜ける	垢抜けろ
派する	派しろ
ちちくる	ちちくれ
生らす	生らせ
ものおもう	ものおもえ
読上げる	読上げろ
潜まる	潜まれ
抛り出す	抛り出せ
ずれ込む	ずれ込め
驚かす	驚かせ
羽織る	羽織れ
にあがる	にあがれ
角立てる	角立てろ
窶す	窶せ
呈する	呈しろ
きる	きれ
差し固める	差し固めろ
知れる	知れろ
乗りこなす	乗りこなせ
聞き流せる	聞き流せろ
みつくろう	みつくろえ
とりかこめる	とりかこめろ
ほねばる	ほねばれ
入替る	入替れ
いただける	いただけろ
たわける	たわけろ
よみだす	よみだせ
かんがえなおす	かんがえなおせ
取り仕切れる	取り仕切れろ
送り届ける	送り届けろ
引っくり返す	引っくり返せ
見廻す	見廻せ
聞き外す	聞き外せ
飲み込む	飲み込め
しらべる	しらべろ
みならう	みならえ
であう	であえ
奪い返す	奪い返せ
はう	はえ
取り拉ぐ	取り拉げ
見届ける	見届けろ
ころがす	ころがせ
しめだす	しめだせ
たたみかける	たたみかけろ
さげる	さげろ
売りこむ	売りこめ
流し入れる	流し入れろ
包み隠す	包み隠せ
救い出せる	救い出せろ
あく	あけ
湛える	湛えろ
招き入れる	招き入れろ
より分ける	より分けろ
化す	化せ
釣りあがる	釣りあがれ
抗える	抗えろ
切り付ける	切り付けろ
のりこえる	のりこえろ
いれかえる	いれかえろ
よびこめる	よびこめろ
間引く	間引け
こきつかえる	こきつかえろ
利する	利しろ
活ける	活けろ
下卑る	下卑ろ
進み出せる	進み出せろ
組み込む	組み込め
突き付ける	突き付けろ
ねりあるく	ねりあるけ
応ずる	ねりあるけ
まぜかえす	まぜかえせ
書立てる	書立てろ
はしりこめる	はしりこめろ
乗り入れる	乗り入れろ
引き継ぐ	引き継げ
あいいとなむ	あいいとなめ
おれ合う	おれ合え
吹き飛ばす	吹き飛ばせ
憬れる	憬れろ
見下げる	見下げろ
採る	採れ
和ぐ	和げ
さびる	さびろ
やつれる	やつれろ
穿く	穿け
おちる	おちろ
耀く	耀け
寄あつまる	寄あつまれ
至る	至れ
かよえる	かよえろ
あかみがかる	あかみがかれ
たがねる	たがねろ
書き成す	書き成せ
突戻す	突戻せ
つくれる	つくれろ
擦り寄る	擦り寄れ
競上げる	競上げろ
起き直る	起き直れ
すごもる	すごもれ
うちよせる	うちよせろ
留る	留れ
つきぬく	つきぬけ
いそしむ	いそしめ
入乱れる	入乱れろ
扇ぐ	扇げ
清ます	清ませ
放つ	放て
ごった返す	ごった返せ
削ぐ	削げ
磨る	磨れ
押えつける	押えつけろ
考え抜く	考え抜け
戴く	戴け
いたぶる	いたぶれ
わする	わしろ
つきそえる	つきそえろ
切りとれる	切りとれろ
睡る	睡れ
働ける	働けろ
すえつける	すえつけろ
取りとめる	取りとめろ
ふす	ふせ
閉じこめる	閉じこめろ
おっかぶせる	おっかぶせろ
見せびらかす	見せびらかせ
うかばれる	うかばれろ
よびかける	よびかけろ
もちだせる	もちだせろ
抱き合える	抱き合えろ
勝ち進める	勝ち進めろ
うきあがれる	うきあがれろ
うむ	うめ
番える	番えろ
とつぐ	とつげ
誘いかける	誘いかけろ
言い争える	言い争えろ
まかなえる	まかなえろ
突っ立てる	突っ立てろ
しゃれる	しゃれろ
取澄ます	取澄ませ
うかれ出る	うかれ出ろ
粘つく	粘つけ
思い余る	思い余れ
押付ける	押付けろ
削る	削れ
直す	直せ
うちあう	うちあえ
つっぷす	つっぷせ
繰り下げる	繰り下げろ
つきすすむ	つきすすめ
踏みつぶす	踏みつぶせ
見送れる	見送れろ
裁ち切る	裁ち切れ
生き残れる	生き残れろ
憧れる	憧れろ
すり減る	すり減れ
割り引く	割り引け
ぬたくる	ぬたくれ
よじれる	よじれろ
すげかえる	すげかえろ
強ばる	強ばれ
やりすごす	やりすごせ
起てる	起てろ
痩せさらばえる	痩せさらばえろ
押し返す	押し返せ
言いあう	言いあえ
あったまる	あったまれ
のりつける	のりつけろ
持運ぶ	持運べ
広げる	広げろ
崩れ落ちる	崩れ落ちろ
ほうける	ほうけろ
ひなびる	ひなびろ
固まれる	固まれろ
還す	還せ
とりなおせる	とりなおせろ
飲みまわす	飲みまわせ
しかる	しかれ
うごく	うごけ
下す	下せ
肥やす	肥やせ
さしかえる	さしかえろ
まちうける	まちうけろ
おいこむ	おいこめ
青ざめる	青ざめろ
踏み外す	踏み外せ
まかりこす	まかりこせ
取り片付ける	取り片付けろ
たちかわる	たちかわれ
書き取る	書き取れ
かきあらわす	かきあらわせ
引き締める	引き締めろ
入り雑じる	入り雑じれ
くみあう	くみあえ
浮き立つ	浮き立て
こもる	こもれ
おりなす	おりなせ
しにかける	しにかけろ
さんずる	しにかけろ
相営む	相営め
招ずる	相営め
つりこむ	つりこめ
いきのこる	いきのこれ
いかる	いかれ
ふくらせる	ふくらせろ
かみ殺す	かみ殺せ
任す	任せ
制す	制せ
取りかえる	取りかえろ
差し込む	差し込め
にげこむ	にげこめ
行える	行えろ
さ迷う	さ迷え
おいぬける	おいぬけろ
しなびる	しなびろ
掲げる	掲げろ
充ちる	充ちろ
みつかる	みつかれ
もつれ合う	もつれ合え
携わる	携われ
狩出す	狩出せ
ひっくりかえす	ひっくりかえせ
注ぐ	注げ
くり貫く	くり貫け
おがむ	おがめ
吊る	吊れ
方向づける	方向づけろ
回せる	回せろ
撃ち落とす	撃ち落とせ
降り注ぐ	降り注げ
駆り出す	駆り出せ
掴みかかる	掴みかかれ
願う	願え
煮上がる	煮上がれ
立込める	立込めろ
つっ込む	つっ込め
誉めちぎる	誉めちぎれ
うつせる	うつせろ
狙える	狙えろ
したまわる	したまわれ
うちおとす	うちおとせ
生まれでる	生まれでろ
くじけかかる	くじけかかれ
かいしめる	かいしめろ
とりまける	とりまけろ
懸け隔たる	懸け隔たれ
よみこむ	よみこめ
引出す	引出せ
むすびつく	むすびつけ
観る	観ろ
演じる	演じろ
揃える	揃えろ
消えはてる	消えはてろ
すきおこす	すきおこせ
揺り起こす	揺り起こせ
後らせる	後らせろ
謙る	謙れ
とりおこなえる	とりおこなえろ
取り逃がす	取り逃がせ
おりゃる	おりゃれ
住み着く	住み着け
縮くれる	縮くれろ
そりくりかえる	そりくりかえれ
転ぶ	転べ
きりぬける	きりぬけろ
のみあかす	のみあかせ
かぎつける	かぎつけろ
しゃうぞく	しゃうぞけ
逸らす	逸らせ
まきかえせる	まきかえせろ
巻ける	巻けろ
繰り替える	繰り替えろ
踏みこたえる	踏みこたえろ
うる	うれ
ふせぐ	ふせげ
叫ぶ	叫べ
立ち去れる	立ち去れろ
白む	白め
持ち出す	持ち出せ
剥ぐ	剥げ
励む	励め
研げる	研げろ
剥がれる	剥がれろ
のりつげる	のりつげろ
つきまとう	つきまとえ
被さる	被され
かけもつ	かけもて
やどれる	やどれろ
しらす	しらせ
吹っ切れる	吹っ切れろ
とりしまれる	とりしまれろ
合さる	合され
まつわりつく	まつわりつけ
つかみ合う	つかみ合え
圧す	圧せ
振り捨てる	振り捨てろ
はぎとる	はぎとれ
傷む	傷め
微睡む	微睡め
はりだす	はりだせ
撃ち込める	撃ち込めろ
打払える	打払えろ
組込める	組込めろ
突き進む	突き進め
連合う	連合え
またぐ	またげ
燐む	燐め
緩む	緩め
付合う	付合え
踏倒す	踏倒せ
見越す	見越せ
寄り倒す	寄り倒せ
はしょる	はしょれ
いれかわる	いれかわれ
がたつく	がたつけ
みそめる	みそめろ
おわらせる	おわらせろ
つかいこなせる	つかいこなせろ
数えあげる	数えあげろ
もとまる	もとまれ
垂らす	垂らせ
笑える	笑えろ
おれる	おれろ
葬れる	葬れろ
躄る	躄れ
無くなす	無くなせ
吹き降ろす	吹き降ろせ
折り合える	折り合えろ
無くす	無くせ
もちあげる	もちあげろ
沈む	沈め
ぬけかわる	ぬけかわれ
たしなめる	たしなめろ
張り出す	張り出せ
立添う	立添え
除ける	除けろ
掬う	掬え
揺らせる	揺らせろ
立ち代われる	立ち代われろ
あきれ返る	あきれ返れ
とまどう	とまどえ
聞きはずす	聞きはずせ
天翔る	天翔れ
生み落す	生み落せ
からす	からせ
取り澄ます	取り澄ませ
つきささる	つきさされ
案ずる	つきさされ
言い伝える	言い伝えろ
誘き出す	誘き出せ
熾る	熾れ
腫れ上がる	腫れ上がれ
よみさす	よみさせ
いだく	いだけ
すます	すませ
なげきあかす	なげきあかせ
くさす	くさせ
ふやかす	ふやかせ
暴れだす	暴れだせ
負かす	負かせ
あいする	あいしろ
ねむりこむ	ねむりこめ
引き返せる	引き返せろ
とおりかかる	とおりかかれ
伏せる	伏せれ
学びとる	学びとれ
爆ぜる	爆ぜろ
うまれつく	うまれつけ
出会える	出会えろ
聞きすます	聞きすませ
流れ出る	流れ出ろ
淫する	淫しろ
食らう	食らえ
引く	引け
吊り出す	吊り出せ
まわる	まわれ
苦みばしる	苦みばしれ
込み上げる	込み上げろ
じれ込む	じれ込め
懸ける	懸けろ
書き起す	書き起せ
さえかえる	さえかえれ
見識張る	見識張れ
ねかしつける	ねかしつけろ
あがれる	あがれろ
まぎれこむ	まぎれこめ
すくめる	すくめろ
おきなおれる	おきなおれろ
摩れる	摩れろ
見抜く	見抜け
入雑じる	入雑じれ
よわる	よわれ
ひる	ひれ
出しゃばる	出しゃばれ
おぼれる	おぼれろ
おりたためる	おりたためろ
究める	究めろ
陣どる	陣どれ
投げ込める	投げ込めろ
受けとる	受けとれ
喪う	喪え
振り絞る	振り絞れ
さきがける	さきがけろ
締め括る	締め括れ
そらせる	そらせろ
味付ける	味付けろ
咲こぼれる	咲こぼれろ
遅らす	遅らせ
ときあかす	ときあかせ
とっくめる	とっくめろ
黙する	黙しろ
もむ	もめ
ほじくる	ほじくれ
ひもとける	ひもとけろ
打ちあぐむ	打ちあぐめ
想える	想えろ
脱ぐ	脱げ
諮れる	諮れろ
けずれる	けずれろ
謀れる	謀れろ
おす	おせ
上れる	上れろ
目ざめる	目ざめろ
はしりまわれる	はしりまわれろ
やすめる	やすめろ
攻めのぼる	攻めのぼれ
荒む	荒め
はなしかける	はなしかけろ
はたす	はたせ
まする	ましろ
憶える	憶えろ
割切れる	割切れろ
こなせる	こなせろ
太る	太れ
まみれる	まみれろ
積込む	積込め
居座る	居座れ
ききいる	ききいれ
躍りでる	躍りでろ
過つ	過て
とる	とれ
みかえせる	みかえせろ
のけ反る	のけ反れ
揺さぶれる	揺さぶれろ
おしのける	おしのけろ
値切れる	値切れろ
縊れる	縊れろ
はいれる	はいれろ
思いきる	思いきれ
聰る	聰れ
ほころぶ	ほころべ
口篭る	口篭れ
遇う	遇え
酬いる	酬いろ
冬篭る	冬篭れ
ふみきる	ふみきれ
かき消せる	かき消せろ
なげとばす	なげとばせ
死に遅れる	死に遅れろ
近付く	近付け
なきしずむ	なきしずめ
仕留める	仕留めろ
醂す	醂せ
たおせる	たおせろ
はえる	はえろ
いりかわる	いりかわれ
見回る	見回れ
差戻す	差戻せ
腹だつ	腹だて
厭き厭きする	厭き厭きしろ
縛りあげる	縛りあげろ
買取る	買取れ
またたく	またたけ
立ち竦む	立ち竦め
足る	足れ
温もる	温もれ
惹ける	惹けろ
立掛ける	立掛けろ
譲り渡す	譲り渡せ
ひろまる	ひろまれ
焦る	焦れ
ひっさげる	ひっさげろ
死かわる	死かわれ
まざる	まざれ
透ける	透けろ
追込む	追込め
ほりこむ	ほりこめ
ばかす	ばかせ
さがる	さがれ
まもりそだてる	まもりそだてろ
移り変る	移り変れ
混ぜ合わす	混ぜ合わせ
はね上げる	はね上げろ
かがる	かがれ
潤びる	潤びろ
押し負ける	押し負けろ
突ぱる	突ぱれ
よびこむ	よびこめ
かろんずる	よびこめ
搾れる	搾れろ
こげつく	こげつけ
おもんずる	こげつけ
ささめく	ささめけ
突き通る	突き通れ
請けおう	請けおえ
打しおれる	打しおれろ
解する	解しろ
植える	植えろ
なみだつ	なみだて
取り広げる	取り広げろ
はからえる	はからえろ
腫れる	腫れろ
飛交う	飛交え
高める	高めろ
つまずく	つまずけ
がぶる	がぶれ
捲し立てる	捲し立てろ
のこれる	のこれろ
駆け付ける	駆け付けろ
引き寄せる	引き寄せろ
写る	写れ
解合う	解合え
たちおくれる	たちおくれろ
くずおれる	くずおれろ
立会う	立会え
思ふ	思へ
つる	つれ
当込む	当込め
なぐりつける	なぐりつけろ
とりつぐ	とりつげ
きらう	きらえ
耕せる	耕せろ
散じる	散じろ
けしとぶ	けしとべ
こびる	こびろ
取り囲む	取り囲め
一皮剥く	一皮剥け
馳せ参ずる	一皮剥け
むらがる	むらがれ
刳る	刳れ
かきとめる	かきとめろ
出っ張る	出っ張れ
ひきつれる	ひきつれろ
しんぜる	しんぜろ
もえる	もえろ
やつす	やつせ
知り合う	知り合え
鍛え上げる	鍛え上げろ
持て余す	持て余せ
差し違える	差し違えろ
おりまぜる	おりまぜろ
のべる	のべろ
わきまえる	わきまえろ
封じる	封じろ
覚める	覚めろ
殉ずる	覚めろ
思い付く	思い付け
努まる	努まれ
陳ぶ	陳べ
がかる	がかれ
たかれる	たかれろ
やりこなす	やりこなせ
ふざける	ふざけろ
売り悩む	売り悩め
向かい合わせる	向かい合わせろ
佇つ	佇て
よりそう	よりそえ
曇らす	曇らせ
弔う	弔え
生かせる	生かせろ
撚る	撚れ
なきつく	なきつけ
わる	われ
入れる	入れろ
行き着く	行き着け
盛り上がる	盛り上がれ
締まる	締まれ
はしりでる	はしりでろ
なえる	なえろ
亡ぶ	亡べ
燻る	燻れ
すすりなく	すすりなけ
ひきのばす	ひきのばせ
にごす	にごせ
くりこす	くりこせ
狭まる	狭まれ
取り捌く	取り捌け
娶る	娶れ
急かす	急かせ
ながらえる	ながらえろ
転がりこむ	転がりこめ
おもひよる	おもひよれ
振切る	振切れ
羽ばたく	羽ばたけ
請負う	請負え
落行く	落行け
そろう	そろえ
揺れる	揺れろ
だまりこむ	だまりこめ
とりすます	とりすませ
おしだまる	おしだまれ
なみうつ	なみうて
ずる	ずれ
詰まる	詰まれ
合わす	合わせ
ききこむ	ききこめ
折る	折れ
正せる	正せろ
すり替える	すり替えろ
連出す	連出せ
つけくわわる	つけくわわれ
かきなおせる	かきなおせろ
小突き回す	小突き回せ
荒らす	荒らせ
とりこわす	とりこわせ
きわめる	きわめろ
待つ	待て
巧む	巧め
さんする	さんしろ
くみ取れる	くみ取れろ
おもいだせる	おもいだせろ
ふきならす	ふきならせ
ごする	ごしろ
心行く	心行け
食み出す	食み出せ
支う	支え
溜め込む	溜め込め
ことわれる	ことわれろ
とびはねる	とびはねろ
繰り込める	繰り込めろ
ふきはらえる	ふきはらえろ
殉じる	殉じろ
注ぎ込む	注ぎ込め
沿う	沿え
泊まり込む	泊まり込め
炊きあがる	炊きあがれ
すすける	すすけろ
飛離れる	飛離れろ
ひねり回す	ひねり回せ
取分ける	取分けろ
流せる	流せろ
光らす	光らせ
すがれる	すがれろ
折返す	折返せ
へこむ	へこめ
漱ぐ	漱げ
借りる	借りろ
問い合わせる	問い合わせろ
みせる	みせろ
呼出す	呼出せ
数える	数えろ
着飾る	着飾れ
出来上がる	出来上がれ
いたる	いたれ
召す	召せ
先んずる	召せ
こらしめる	こらしめろ
腐れる	腐れろ
受けいれる	受けいれろ
切り抜ける	切り抜けろ
巡らせる	巡らせろ
ずらす	ずらせ
爪立つ	爪立て
売急ぐ	売急げ
翻す	翻せ
くちばしる	くちばしれ
捻くれる	捻くれろ
錆付く	錆付け
しょうじる	しょうじろ
まいる	まいれ
歪める	歪めろ
突き合す	突き合せ
羽ばたける	羽ばたけろ
ひす	ひせ
引下げる	引下げろ
かんさびる	かんさびろ
削り倒す	削り倒せ
備え付ける	備え付けろ
操る	操れ
よれる	よれろ
ねばりぬく	ねばりぬけ
いいだせる	いいだせろ
さげわたす	さげわたせ
叩き起す	叩き起せ
きりかわる	きりかわれ
諭せる	諭せろ
きける	きけろ
打砕く	打砕け
売り込む	売り込め
ひやかせる	ひやかせろ
捩じ伏せる	捩じ伏せろ
おしながす	おしながせ
使う	使え
みすてる	みすてろ
嚼む	嚼め
フケる	フケろ
積出す	積出せ
めっする	めっしろ
言い放つ	言い放て
殺気立つ	殺気立て
せきたてる	せきたてろ
みとおせる	みとおせろ
渡れる	渡れろ
見かねる	見かねろ
出回る	出回れ
啜る	啜れ
心ゆく	心ゆけ
引連れる	引連れろ
よりそえる	よりそえろ
じゅくする	じゅくしろ
酔い潰れる	酔い潰れろ
剃る	剃れ
ではじめる	ではじめろ
せめたてる	せめたてろ
ゆき交う	ゆき交え
かちすすむ	かちすすめ
くいこむ	くいこめ
じめつく	じめつけ
ふんまえる	ふんまえろ
しそんじる	しそんじろ
撃ち殺す	撃ち殺せ
綰ねる	綰ねろ
医する	医しろ
噛み付く	噛み付け
間切る	間切れ
しまふ	しまへ
送り込める	送り込めろ
だんじこむ	だんじこめ
みちびきだす	みちびきだせ
造れる	造れろ
打ちとける	打ちとけろ
行く	行け
のたうつ	のたうて
つま弾く	つま弾け
存じ上げる	存じ上げろ
汲み出す	汲み出せ
抱締める	抱締めろ
罪する	罪しろ
勝ち取る	勝ち取れ
撮す	撮せ
濡れそぼつ	濡れそぼて
くるしめる	くるしめろ
泣かす	泣かせ
売り切れる	売り切れろ
食い倒す	食い倒せ
踏みだす	踏みだせ
きれあがる	きれあがれ
咬む	咬め
飾る	飾れ
へばりつく	へばりつけ
すねる	すねろ
座する	座しろ
あおみがかる	あおみがかれ
引き落とす	引き落とせ
はなしこむ	はなしこめ
ふりかける	ふりかけろ
申出る	申出ろ
漏れる	漏れろ
つきあたる	つきあたれ
ふりかえる	ふりかえれ
とっつく	とっつけ
むすびつける	むすびつけろ
かたどれる	かたどれろ
萎む	萎め
耀かす	耀かせ
刺殺す	刺殺せ
よう	よえ
たたき出せる	たたき出せろ
接する	接しろ
放す	放せ
掴み掛る	掴み掛れ
遊びあきる	遊びあきろ
すべり込む	すべり込め
追いまわす	追いまわせ
挑む	挑め
押し入る	押し入れ
のぼせる	のぼせろ
ざわめく	ざわめけ
いりつける	いりつけろ
質せる	質せろ
たえしのぶ	たえしのべ
給する	給しろ
擦付ける	擦付けろ
ひきつくろう	ひきつくろえ
そやす	そやせ
引き延ばす	引き延ばせ
付き添う	付き添え
刺し違える	刺し違えろ
売り上げる	売り上げろ
よだつ	よだて
聞きだす	聞きだせ
利く	利け
染み入る	染み入れ
うなずける	うなずけろ
ぞんずる	うなずけろ
よびおこす	よびおこせ
はなせる	はなせろ
冷える	冷えろ
読みくだす	読みくだせ
盛り返す	盛り返せ
わきたつ	わきたて
溺らす	溺らせ
やきあげる	やきあげろ
振り落とせる	振り落とせろ
まきつく	まきつけ
ひっ返す	ひっ返せ
引っぱる	引っぱれ
まちかまえる	まちかまえろ
よこす	よこせ
使われだす	使われだせ
じゃれる	じゃれろ
賞する	賞しろ
借り越す	借り越せ
買いつける	買いつけろ
はおる	はおれ
はしる	はしれ
焦げ付く	焦げ付け
借受ける	借受けろ
さしでる	さしでろ
さかまく	さかまけ
きんじる	きんじろ
はらせる	はらせろ
生める	生めろ
つるし上げる	つるし上げろ
口説ける	口説けろ
まねく	まねけ
あやす	あやせ
染る	染れ
かじりつく	かじりつけ
煮える	煮えろ
持直す	持直せ
かきちらす	かきちらせ
慕う	慕え
載る	載れ
頼みこむ	頼みこめ
引っ篭る	引っ篭れ
更ける	更けろ
咳き込む	咳き込め
押しかける	押しかけろ
引っ剥がす	引っ剥がせ
はずれる	はずれろ
切り合う	切り合え
あやぶむ	あやぶめ
捉える	捉えろ
むすべる	むすべろ
取り替える	取り替えろ
寝返る	寝返れ
そっする	そっしろ
乗込む	乗込め
こころえる	こころえろ
潰せる	潰せろ
持越す	持越せ
混ぜっ返す	混ぜっ返せ
こいねがう	こいねがえ
ちゃかす	ちゃかせ
焚きしめる	焚きしめろ
打ち落とす	打ち落とせ
け飛ばす	け飛ばせ
まぜ返す	まぜ返せ
よう	よえ
ふりあう	ふりあえ
わらわす	わらわせ
寄りつく	寄りつけ
はじきだせる	はじきだせろ
ひらめかす	ひらめかせ
嗣げる	嗣げろ
かきまぜる	かきまぜろ
怖じける	怖じけろ
うりだせる	うりだせろ
擦り込む	擦り込め
ゆきたつ	ゆきたて
しかける	しかけろ
うつしだせる	うつしだせろ
押しきる	押しきれ
勿体ぶる	勿体ぶれ
ふる	ふれ
尽くす	尽くせ
みてとる	みてとれ
まるめ込む	まるめ込め
束ねる	束ねろ
ねがいさげる	ねがいさげろ
もじる	もじれ
粒立つ	粒立て
まよわす	まよわせ
たがう	たがえ
集える	集えろ
寄り掛る	寄り掛れ
じとつく	じとつけ
払える	払えろ
つきあわせる	つきあわせろ
嫌う	嫌え
奉る	奉れ
受けとめる	受けとめろ
息詰まる	息詰まれ
紛う	紛え
ゆきかえる	ゆきかえれ
うつしだす	うつしだせ
したてる	したてろ
押しつめる	押しつめろ
悲しむ	悲しめ
あずかる	あずかれ
年寄る	年寄れ
かぶせる	かぶせろ
むける	むけろ
泣き伏す	泣き伏せ
ちゃらつかす	ちゃらつかせ
さぐり合う	さぐり合え
絶する	絶しろ
縮かむ	縮かめ
よばれる	よばれろ
おどりでる	おどりでろ
うちとる	うちとれ
泣沈む	泣沈め
おちつく	おちつけ
すいだす	すいだせ
貴べる	貴べろ
心づく	心づけ
握り締める	握り締めろ
負える	負えろ
はりめぐらせる	はりめぐらせろ
刺す	刺せ
作りあげる	作りあげろ
訊く	訊け
ふさぐ	ふさげ
脅し取る	脅し取れ
召し上がれる	召し上がれろ
かたちづくれる	かたちづくれろ
ためこめる	ためこめろ
わすれる	わすれろ
つくり上げる	つくり上げろ
競い合う	競い合え
こる	これ
ききあわせる	ききあわせろ
のぞき込める	のぞき込めろ
追っぱらう	追っぱらえ
受け合える	受け合えろ
ぎゅうじる	ぎゅうじれ
ふみはずす	ふみはずせ
はたせる	はたせろ
賺す	賺せ
かきむしる	かきむしれ
踏出す	踏出せ
つかれはてる	つかれはてろ
やり過す	やり過せ
仕上がる	仕上がれ
取回す	取回せ
ズレる	ズレろ
面する	面しろ
言尽す	言尽せ
割当てる	割当てろ
怒れる	怒れろ
ときおこす	ときおこせ
引立てる	引立てろ
競合う	競合え
素見す	素見せ
切り返す	切り返せ
砕く	砕け
しめきる	しめきれ
息づく	息づけ
囲える	囲えろ
引っ張る	引っ張れ
打ち壊す	打ち壊せ
いう	いえ
押し返せる	押し返せろ
入り浸る	入り浸れ
いら立つ	いら立て
襲いかかる	襲いかかれ
熾きる	熾きろ
くり出す	くり出せ
きかざれる	きかざれろ
かられる	かられろ
呼ぶ	呼べ
書出す	書出せ
くぐり抜ける	くぐり抜けろ
ざんする	ざんしろ
そりおとす	そりおとせ
しめつける	しめつけろ
たんずる	しめつけろ
好む	好め
競べる	競べろ
切り捨てる	切り捨てろ
ほりあげる	ほりあげろ
のたうちまわる	のたうちまわれ
捕らわれる	捕らわれろ
凍みる	凍みろ
こころゆく	こころゆけ
つっきる	つっきれ
どやす	どやせ
笑い転げる	笑い転げろ
掛る	掛れ
住む	住め
約まる	約まれ
あいしあう	あいしあえ
頑張れる	頑張れろ
させる	させろ
おかす	おかせ
あます	あませ
泣き付く	泣き付け
あわれむ	あわれめ
積み重ねる	積み重ねろ
うちあわす	うちあわせ
訳せる	訳せろ
詫びる	詫びろ
創り出せる	創り出せろ
担げる	担げろ
追い上げる	追い上げろ
根づく	根づけ
立ち会える	立ち会えろ
祭り上げる	祭り上げろ
こもどす	こもどせ
乗かかる	乗かかれ
創る	創れ
練直す	練直せ
かがやく	かがやけ
うちあわせる	うちあわせろ
遜る	遜れ
かする	かしろ
戦く	戦け
腹立てる	腹立てろ
擦り込める	擦り込めろ
勝ち得る	勝ち得ろ
みごもる	みごもれ
討ち果たせる	討ち果たせろ
野次る	野次れ
よみがえる	よみがえれ
踏み抜く	踏み抜け
生かす	生かせ
おいつめる	おいつめろ
採れる	採れろ
つきやぶる	つきやぶれ
めぐりあう	めぐりあえ
尽くせる	尽くせろ
進む	進め
赴く	赴け
くりいれる	くりいれろ
しゃっちょこ張る	しゃっちょこ張れ
めしぐす	めしぐせ
煮つまる	煮つまれ
渦巻く	渦巻け
動く	動け
くり抜く	くり抜け
試みる	試みろ
汚す	汚せ
食い入る	食い入れ
反らせる	反らせろ
晴らせる	晴らせろ
取っ組める	取っ組めろ
選ぶ	選べ
彫る	彫れ
振りしぼる	振りしぼれ
吸寄せる	吸寄せろ
かぎだす	かぎだせ
紛らす	紛らせ
詰めこむ	詰めこめ
どうきづける	どうきづけろ
見過す	見過せ
つけ入る	つけ入れ
ぬきあわせる	ぬきあわせろ
巻き込む	巻き込め
結上げる	結上げろ
才弾ける	才弾けろ
ときほぐす	ときほぐせ
結ぼれる	結ぼれろ
まいれる	まいれろ
うりとばす	うりとばせ
すりむく	すりむけ
剥げる	剥げろ
たくする	たくしろ
したがう	したがえ
見せる	見せろ
そまる	そまれ
煮付ける	煮付けろ
ぶっつける	ぶっつけろ
しずむ	しずめ
切り結ぶ	切り結べ
納める	納めろ
引さがる	引さがれ
陥れる	陥れろ
つまみだす	つまみだせ
引き絞れる	引き絞れろ
取留める	取留めろ
預かる	預かれ
図抜ける	図抜けろ
安らぐ	安らげ
瞬ぐ	瞬げ
くべる	くべろ
おちくぼむ	おちくぼめ
擦り付ける	擦り付けろ
組合う	組合え
たすかる	たすかれ
俯ける	俯けろ
かみあわせる	かみあわせろ
購う	購え
はね返る	はね返れ
振れる	振れろ
とびまわる	とびまわれ
廻らす	廻らせ
持ち寄れる	持ち寄れろ
折りあえる	折りあえろ
めかす	めかせ
来れる	来れろ
えりわける	えりわけろ
ふんぞる	ふんぞれ
おせる	おせろ
搖れる	搖れろ
にえたつ	にえたて
罵る	罵れ
欺ける	欺けろ
まがりくねる	まがりくねれ
涼む	涼め
祝する	祝しろ
立ち合う	立ち合え
疑る	疑れ
慶べる	慶べろ
連れ添える	連れ添えろ
やり返せる	やり返せろ
燃えたつ	燃えたて
あがりこむ	あがりこめ
拗れる	拗れろ
かつぎこむ	かつぎこめ
ひきずる	ひきずれ
埋れる	埋れろ
ほかす	ほかせ
静める	静めろ
成かわる	成かわれ
かげる	かげれ
つぶれる	つぶれろ
出し切る	出し切れ
吸い取れる	吸い取れろ
諭す	諭せ
取り紛れる	取り紛れろ
取りまわす	取りまわせ
おしむ	おしめ
みだれとぶ	みだれとべ
買い進む	買い進め
うる	買い進め
あう	あえ
捕まる	捕まれ
足せる	足せろ
うわむく	うわむけ
だれる	だれろ
わかいしあう	わかいしあえ
振り返る	振り返れ
おいすがる	おいすがれ
はねる	はねろ
直せる	直せろ
重ね合う	重ね合え
いたす	いたせ
埋もる	埋もれ
取り崩す	取り崩せ
かける	かけろ
かみくだける	かみくだけろ
見る	見ろ
中る	中れ
あらいおとす	あらいおとせ
おしながせる	おしながせろ
蹴倒す	蹴倒せ
噛みくだく	噛みくだけ
まなぶ	まなべ
あおばむ	あおばめ
攻め懸ける	攻め懸けろ
研ぎ澄ます	研ぎ澄ませ
訛る	訛れ
おがめる	おがめろ
吊りあがる	吊りあがれ
履き違える	履き違えろ
封じこめる	封じこめろ
ねめる	ねめろ
魘われる	魘われろ
押し付ける	押し付けろ
散残る	散残れ
書き古す	書き古せ
抜きとる	抜きとれ
わき起こせる	わき起こせろ
絞り出せる	絞り出せろ
逃げ出せる	逃げ出せろ
うかれでる	うかれでろ
相次ぐ	相次げ
差付ける	差付けろ
聞取る	聞取れ
どうける	どうけろ
被れる	被れろ
とり入れる	とり入れろ
飛び乗る	飛び乗れ
乗捨てる	乗捨てろ
うけつげる	うけつげろ
しぼりだせる	しぼりだせろ
刺し殺す	刺し殺せ
追いちらす	追いちらせ
かいいれる	かいいれろ
とりみだす	とりみだせ
おもほす	おもほせ
すぼまる	すぼまれ
殴り飛ばす	殴り飛ばせ
思い知らせる	思い知らせろ
甘える	甘えろ
きりかかる	きりかかれ
坐す	坐せ
おもいあわせる	おもいあわせろ
ぎしきばる	ぎしきばれ
取りつぐ	取りつげ
延ばす	延ばせ
報える	報えろ
うまれかわれる	うまれかわれろ
組み直せる	組み直せろ
うりさばける	うりさばけろ
うりつくす	うりつくせ
仕分ける	仕分けろ
こだわる	こだわれ
崇める	崇めろ
味わう	味わえ
ふりはなす	ふりはなせ
しゃちほこばる	しゃちほこばれ
ぶっ飛ばす	ぶっ飛ばせ
おぼえこむ	おぼえこめ
痺れる	痺れろ
なぎ払う	なぎ払え
保つ	保て
抱き上げる	抱き上げろ
紡ぐ	紡げ
切返す	切返せ
しかりつける	しかりつけろ
ひあがる	ひあがれ
へがす	へがせ
戦がす	戦がせ
煌めく	煌めけ
見当たる	見当たれ
雑ざる	雑ざれ
うごめく	うごめけ
見込める	見込めろ
飛廻る	飛廻れ
引っ張れる	引っ張れろ
飲み明かす	飲み明かせ
負かせる	負かせろ
張りつめる	張りつめろ
検する	検しろ
打ち込む	打ち込め
のせる	のせろ
うなづける	うなづけろ
もらう	もらえ
請け合う	請け合え
考え付く	考え付け
成すます	成すませ
はべる	はべれ
挑める	挑めろ
みちゆく	みちゆけ
はね返す	はね返せ
繰り越せる	繰り越せろ
即する	即しろ
さっきだつ	さっきだて
触れまわる	触れまわれ
押し流す	押し流せ
碾く	碾け
隠し持つ	隠し持て
詰め込める	詰め込めろ
追い付ける	追い付けろ
まくる	まくれ
欺く	欺け
うだる	うだれ
取上せる	取上せろ
摺れる	摺れろ
あずかれる	あずかれろ
アテる	アテろ
けあげる	けあげろ
ふりほどく	ふりほどけ
張れる	張れろ
たる	たれ
だましこむ	だましこめ
頼み入る	頼み入れ
取りつくろう	取りつくろえ
かいうける	かいうけろ
きりきざむ	きりきざめ
はぎ合せる	はぎ合せろ
かえる	かえろ
引絞る	引絞れ
曲りくねる	曲りくねれ
養う	養え
笑割れる	笑割れろ
走り出す	走り出せ
取廻す	取廻せ
にくめる	にくめろ
打続く	打続け
うるむ	うるめ
めしとる	めしとれ
漕ぐ	漕げ
担わす	担わせ
めしだす	めしだせ
厭う	厭え
泣き伏せる	泣き伏せろ
たぎつ	たぎて
なれあう	なれあえ
しみる	しみろ
みつけだす	みつけだせ
仰れる	仰れろ
しみとおる	しみとおれ
こげつかす	こげつかせ
おもいもうける	おもいもうけろ
断ち切れる	断ち切れろ
取決める	取決めろ
ぬぐい去れる	ぬぐい去れろ
やって来る	ぬぐい去れろ
あいせる	あいせろ
つっ走る	つっ走れ
おとしめる	おとしめろ
開け払う	開け払え
関連付ける	関連付けろ
誇れる	誇れろ
かいす	かいせ
踏んづける	踏んづけろ
動き回る	動き回れ
炒める	炒めろ
になえる	になえろ
がめる	がめれ
受け止める	受け止めろ
消す	消せ
擡げる	擡げろ
うりこむ	うりこめ
よみふける	よみふけれ
差しかえる	差しかえろ
擂りつぶす	擂りつぶせ
ゆする	ゆすれ
見積もる	見積もれ
めいじる	めいじろ
もちまわれる	もちまわれろ
てりつける	てりつけろ
かきだせる	かきだせろ
容体ぶる	容体ぶれ
立ち入れる	立ち入れろ
待ち侘びる	待ち侘びろ
捜し出せる	捜し出せろ
申し込める	申し込めろ
取直す	取直せ
かたりあえる	かたりあえろ
振捨てる	振捨てろ
のりあわす	のりあわせ
いななく	いななけ
しそこなう	しそこなえ
招く	招け
つき合える	つき合えろ
曲げる	曲げろ
すり寄る	すり寄れ
語り明かせる	語り明かせろ
苛める	苛めろ
通う	通え
巻込む	巻込め
暖める	暖めろ
まちあぐむ	まちあぐめ
いかりくるう	いかりくるえ
組む	組め
殴る	殴れ
たちかかる	たちかかれ
たなびく	たなびけ
差し越す	差し越せ
さしころせる	さしころせろ
まぎらかす	まぎらかせ
冷ませる	冷ませろ
しくめる	しくめろ
引き延ばせる	引き延ばせろ
つかみかかる	つかみかかれ
付従う	付従え
わかがえれる	わかがえれろ
ふりすてる	ふりすてろ
ひかす	ひかせ
たちゆく	たちゆけ
悄気込む	悄気込め
引きあげる	引きあげろ
引っ繰り返す	引っ繰り返せ
取り纏める	取り纏めろ
うかびあがる	うかびあがれ
照り映える	照り映えろ
きく	きけ
飛び越える	飛び越えろ
つけこむ	つけこめ
そめかえす	そめかえせ
かちとれる	かちとれろ
慢ずる	かちとれろ
打ちあける	打ちあけろ
さそいあわせる	さそいあわせろ
ききながす	ききながせ
かざれる	かざれろ
まける	まけろ
かきみだす	かきみだせ
いせる	いせろ
脅かす	脅かせ
やすむ	やすめ
溶け込む	溶け込め
済ます	済ませ
いきつく	いきつけ
見当る	見当れ
崩れさる	崩れされ
くいきる	くいきれ
じんどる	じんどれ
かんがえこむ	かんがえこめ
よこたえる	よこたえろ
居並ぶ	居並べ
見過ごす	見過ごせ
持ち掛ける	持ち掛けろ
あとづける	あとづけろ
想う	想え
勧める	勧めろ
つのめだつ	つのめだて
画く	画け
かえりざく	かえりざけ
やってのける	やってのけろ
のみつぶす	のみつぶせ
打抜く	打抜け
参ずる	打抜け
かきふるす	かきふるせ
たむける	たむけろ
旅立つ	旅立て
フッカケる	フッカケろ
御する	御しろ
踏む	踏め
あわれがる	あわれがれ
移り変わる	移り変われ
たげる	たげろ
打ち寄せる	打ち寄せろ
寝静まる	寝静まれ
さきんずる	寝静まれ
うかぶ	うかべ
しょぼぬれる	しょぼぬれろ
ゆきくれる	ゆきくれろ
おける	おけろ
組みたてる	組みたてろ
押し詰める	押し詰めろ
駆りたてる	駆りたてろ
押しまくる	押しまくれ
ぶち込む	ぶち込め
すべりおちる	すべりおちろ
抜かわる	抜かわれ
いなす	いなせ
総毛立つ	総毛立て
裏返せる	裏返せろ
かす	かせ
はりつける	はりつけろ
みはからう	みはからえ
めがける	めがけろ
流れ出す	流れ出せ
もてあつかう	もてあつかえ
経つ	経て
眩く	眩け
うねる	うねれ
くちずさむ	くちずさめ
どなりつける	どなりつけろ
湧き出る	湧き出ろ
いいつける	いいつけろ
つれ去る	つれ去れ
引き合う	引き合え
よりつく	よりつけ
奪い合う	奪い合え
終える	終えろ
潤す	潤せ
食う	食え
旧びる	旧びろ
切下げる	切下げろ
いきおいこむ	いきおいこめ
くる	いきおいこめ
なじむ	なじめ
ふるいたつ	ふるいたて
責立てる	責立てろ
しるす	しるせ
連れ合う	連れ合え
引っぱたく	引っぱたけ
建て直す	建て直せ
とりかたづける	とりかたづけろ
押しつける	押しつけろ
足す	足せ
行き着ける	行き着けろ
わかる	わかれ
愛する	愛しろ
いばえる	いばえろ
粧う	粧え
おくりだせる	おくりだせろ
説ける	説けろ
ながれつける	ながれつけろ
せり出す	せり出せ
芽だつ	芽だて
鑑みる	鑑みろ
たちいれる	たちいれろ
突き立てる	突き立てろ
めり込む	めり込め
言い張る	言い張れ
くくる	くくれ
ついばむ	ついばめ
かろしめる	かろしめろ
引離す	引離せ
しだく	しだけ
つくる	つくれ
懸隔たる	懸隔たれ
うわむける	うわむけろ
乗後れる	乗後れろ
泣きはらす	泣きはらせ
立ちふさがる	立ちふさがれ
わがねる	わがねろ
取離す	取離せ
ねじ上げる	ねじ上げろ
うずく	うずけ
取り壊す	取り壊せ
でなおす	でなおせ
あてこする	あてこすれ
つげる	つげろ
光る	光れ
くされる	くされろ
くぐれる	くぐれろ
押し退ける	押し退けろ
くどく	くどけ
のぼせあがる	のぼせあがれ
死ねる	死ねろ
ながれる	ながれろ
落ちのびる	落ちのびろ
おしたおす	おしたおせ
継ぐ	継げ
勤める	勤めろ
詰む	詰め
こらえる	こらえろ
連れ込める	連れ込めろ
蒸せる	蒸せろ
依る	依れ
したしめる	したしめろ
要する	要しろ
粟立つ	粟立て
使いこなす	使いこなせ
物慣れる	物慣れろ
かちすすめる	かちすすめろ
よびもどす	よびもどせ
みだせる	みだせろ
捩じくれる	捩じくれろ
取りもつ	取りもて
かけあわす	かけあわせ
しにかわる	しにかわれ
終わらす	終わらせ
見い出す	見い出せ
伐る	伐れ
うみおとす	うみおとせ
ほうじる	ほうじろ
泡立てる	泡立てろ
誉める	誉めろ
ながしこめる	ながしこめろ
伏し拝む	伏し拝め
取り結ぶ	取り結べ
のりくむ	のりくめ
企む	企め
独りごつ	独りごて
とりけせる	とりけせろ
調子付く	調子付け
縫える	縫えろ
なくす	なくせ
からみつく	からみつけ
愚図る	愚図れ
持ち込める	持ち込めろ
しょっぴく	しょっぴけ
尖らす	尖らせ
送れる	送れろ
吹きとばす	吹きとばせ
撫でる	撫でろ
差せる	差せろ
潜む	潜め
おしうつる	おしうつれ
質す	質せ
付ける	付けろ
取り回す	取り回せ
みはらせる	みはらせろ
勝ち進む	勝ち進め
ふるえあがる	ふるえあがれ
見下す	見下せ
伸べる	伸べろ
取り揃う	取り揃え
うちしずむ	うちしずめ
をろがむ	をろがめ
ぬきんでる	ぬきんでろ
一皮むく	一皮むけ
ふうじこむ	ふうじこめ
抱きつく	抱きつけ
混ぜ合わせる	混ぜ合わせろ
荒らせる	荒らせろ
おわす	おわせ
なぐさむ	なぐさめ
伏し沈む	伏し沈め
失ふ	失へ
追い払う	追い払え
かぎわける	かぎわけろ
凭れる	凭れろ
歓べる	歓べろ
つれる	つれろ
持ち回れる	持ち回れろ
はくす	はくせ
規則立つ	規則立て
ねじける	ねじけろ
りゃくせる	りゃくせろ
摸する	摸しろ
泊まれる	泊まれろ
とりこす	とりこせ
つらねる	つらねろ
付け足せる	付け足せろ
待合せる	待合せろ
立て直す	立て直せ
あらえる	あらえろ
入れかえる	入れかえろ
ビビる	ビビれ
祷る	祷れ
みおとす	みおとせ
くう	くえ
かいこす	かいこせ
結びつく	結びつけ
与える	与えろ
得る	与えろ
撃止める	撃止めろ
増せる	増せろ
溶く	溶け
逃げ延びる	逃げ延びろ
ねがいでる	ねがいでろ
勝れる	勝れろ
うらぎる	うらぎれ
きょうずる	うらぎれ
ひきまわす	ひきまわせ
だらける	だらけろ
和む	和め
くらす	くらせ
つっ切る	つっ切れ
きりむすぶ	きりむすべ
追い抜く	追い抜け
うるおう	うるおえ
つかる	つかれ
そんずる	つかれ
くみ出す	くみ出せ
なり変わる	なり変われ
うかびでる	うかびでろ
くみたてる	くみたてろ
差し入れる	差し入れろ
つかまる	つかまれ
歪む	歪め
抜かす	抜かせ
干からびる	干からびろ
扠措く	扠措け
寝忘れる	寝忘れろ
旅立てる	旅立てろ
崩せる	崩せろ
引き合せる	引き合せろ
えがける	えがけろ
類える	類えろ
継ぎ合せる	継ぎ合せろ
突っ返せる	突っ返せろ
うみつける	うみつけろ
ねだる	ねだれ
打合う	打合え
飛び降りる	飛び降りろ
ぬるむ	ぬるめ
ほっする	ほっしろ
噛み分ける	噛み分けろ
置き忘れる	置き忘れろ
もみ消す	もみ消せ
尋め行く	尋め行け
かっとばす	かっとばせ
かつぎこめる	かつぎこめろ
釣り上げる	釣り上げろ
取り込める	取り込めろ
逆上せる	逆上せろ
おしわける	おしわけろ
打ち取る	打ち取れ
引きずり回せる	引きずり回せろ
後れる	後れろ
住み替える	住み替えろ
成り下がる	成り下がれ
せかせる	せかせろ
責め付ける	責め付けろ
差し回す	差し回せ
いいかえす	いいかえせ
減らす	減らせ
あてる	あてろ
しらちゃける	しらちゃけろ
とけこめる	とけこめろ
さく	さけ
ねとつく	ねとつけ
飾り付ける	飾り付けろ
生み出せる	生み出せろ
切羽詰る	切羽詰れ
きりさく	きりさけ
すりむける	すりむけろ
ばける	ばけろ
居残る	居残れ
せいする	せいしろ
こみあげる	こみあげろ
たぶ	たべ
引き下ろせる	引き下ろせろ
偲ぶ	偲べ
張り倒す	張り倒せ
おかせる	おかせろ
肥る	肥れ
引裂く	引裂け
染み透る	染み透れ
騰がる	騰がれ
散り残る	散り残れ
梳く	梳け
綴り合せる	綴り合せろ
うりなやむ	うりなやめ
賄う	賄え
ふきこむ	ふきこめ
賭ける	賭けろ
事足る	事足れ
ころげる	ころげろ
ポシャる	ポシャれ
飛びだす	飛びだせ
明け払う	明け払え
噛みころす	噛みころせ
ねとる	ねとれ
ズレ込む	ズレ込め
成す	成せ
覚え込む	覚え込め
おくりだす	おくりだせ
運び込める	運び込めろ
はぎ合わす	はぎ合わせ
はらえる	はらえろ
立ちのぼる	立ちのぼれ
咽ぶ	咽べ
さしきる	さしきれ
慶ぶ	慶べ
張回す	張回せ
根差す	根差せ
辷る	辷れ
もうしつける	もうしつけろ
立合う	立合え
思い出せる	思い出せろ
読み分ける	読み分けろ
くらう	くらえ
うねりくねる	うねりくねれ
泣崩れる	泣崩れろ
蝕む	蝕め
たくす	たくせ
とどまる	とどまれ
やせほそる	やせほそれ
打込める	打込めろ
もうしうける	もうしうけろ
だしあう	だしあえ
うちあげる	うちあげろ
押し出す	押し出せ
いどむ	いどめ
拉げる	拉げろ
がいす	がいせ
見おろす	見おろせ
切り払う	切り払え
ひんまがる	ひんまがれ
打付ける	打付けろ
投げ込む	投げ込め
ねつく	ねつけ
乗り掛る	乗り掛れ
踏みならせる	踏みならせろ
さえぎる	さえぎれ
いやまさる	いやまされ
ようだてる	ようだてろ
波うつ	波うて
差し掛ける	差し掛けろ
詰切る	詰切れ
はりとばす	はりとばせ
出かける	出かけろ
すぐる	すぐれ
頑張る	頑張れ
織りなす	織りなせ
生延びる	生延びろ
スレ違う	スレ違え
投げ飛ばす	投げ飛ばせ
おごる	おごれ
せきいる	せきいれ
判じる	判じろ
さしまわせる	さしまわせろ
だきおこす	だきおこせ
勝ち誇る	勝ち誇れ
押隠す	押隠せ
へこたれる	へこたれろ
でばる	でばれ
脱す	脱せ
生きながらえる	生きながらえろ
戦慄く	戦慄け
すたれる	すたれろ
張り上げる	張り上げろ
よみこなせる	よみこなせろ
待ちかねる	待ちかねろ
ほうる	ほうれ
ろくする	ろくしろ
くわれる	くわれろ
すすり上げる	すすり上げろ
担う	担え
まかなう	まかなえ
騰る	騰れ
さからえる	さからえろ
はせまわる	はせまわれ
読む	読め
受け入れる	受け入れろ
引き連れる	引き連れろ
儲ける	儲けろ
ハマる	ハマれ
もちこす	もちこせ
押し上げる	押し上げろ
召上がる	召上がれ
割込む	割込め
くりだせる	くりだせろ
もつれ込む	もつれ込め
こまりはてる	こまりはてろ
立てかける	立てかけろ
いきかえれる	いきかえれろ
こぎ着く	こぎ着け
立去る	立去れ
りっする	りっしろ
取り上げる	取り上げろ
ひれ伏す	ひれ伏せ
思い知る	思い知れ
下掛る	下掛れ
差迫る	差迫れ
くみかえる	くみかえろ
差し合う	差し合え
出立つ	出立て
ひもとく	ひもとけ
うずくまる	うずくまれ
温む	温め
あけはなせる	あけはなせろ
洒落る	洒落ろ
こそぐる	こそぐれ
はばむ	はばめ
積み出せる	積み出せろ
くいのばす	くいのばせ
なずらえる	なずらえろ
乗り込める	乗り込めろ
しねる	しねろ
押し流せる	押し流せろ
雇う	雇え
模する	模しろ
嘆く	嘆け
しぐれる	しぐれろ
したう	したえ
投げ飛ばせる	投げ飛ばせろ
起きる	起きろ
切払う	切払え
やけだす	やけだせ
ふき取る	ふき取れ
知れ渡る	知れ渡れ
訳す	訳せ
住み込む	住み込め
荒れる	荒れろ
こごむ	こごめ
まつりあげる	まつりあげろ
休する	休しろ
あらわす	あらわせ
智慧づく	智慧づけ
生い茂る	生い茂れ
垂れ篭める	垂れ篭めろ
翔ぶ	翔べ
あみあげる	あみあげろ
なまける	なまけろ
取り切れる	取り切れろ
もり立てる	もり立てろ
飲みほす	飲みほせ
まきこむ	まきこめ
纏う	纏え
乗り回せる	乗り回せろ
すすりあげる	すすりあげろ
助け合える	助け合えろ
ものもうす	ものもうせ
すてさる	すてされ
免じる	免じろ
うけだせる	うけだせろ
和解し合う	和解し合え
とりくめる	とりくめろ
受け持つ	受け持て
振りほどく	振りほどけ
卒する	卒しろ
つづりあわす	つづりあわせ
一皮剥ける	一皮剥けろ
先駆ける	先駆けろ
えらびだす	えらびだせ
うちすえる	うちすえろ
使い込む	使い込め
さまたげる	さまたげろ
すたる	すたれ
書する	書しろ
不貞てる	不貞てろ
とびこめる	とびこめろ
見蕩れる	見蕩れろ
慥かめる	慥かめろ
つまみ上げる	つまみ上げろ
のます	のませ
涸らす	涸らせ
撰する	撰しろ
寝かしつける	寝かしつけろ
歩きつめる	歩きつめれ
診る	診ろ
ぬいこむ	ぬいこめ
きりこむ	きりこめ
膨らます	膨らませ
ちゃう	ちゃえ
宿る	宿れ
取りかかる	取りかかれ
巻き返せる	巻き返せろ
すり込む	すり込め
追回す	追回せ
登れる	登れろ
差し立てる	差し立てろ
打ち勝てる	打ち勝てろ
ふきぬける	ふきぬけろ
切回す	切回せ
うつす	うつせ
つみだせる	つみだせろ
切合う	切合え
はいする	はいしろ
裏切る	裏切れ
かいきれる	かいきれろ
埋め込む	埋め込め
取りあわせる	取りあわせろ
閉め出す	閉め出せ
出来合う	出来合え
騒がせる	騒がせろ
ほどこす	ほどこせ
習わせる	習わせろ
ぬけだす	ぬけだせ
追越す	追越せ
ばらつく	ばらつけ
ばてる	ばてろ
傷付ける	傷付けろ
うちやぶれる	うちやぶれろ
ふきわける	ふきわけろ
棲む	棲め
頻る	頻れ
きそう	きそえ
ねじ込む	ねじ込め
たてこむ	たてこめ
いく	いけ
ひずむ	ひずめ
取り置く	取り置け
はしゃぐ	はしゃげ
とう	とえ
どかす	どかせ
あらわれる	あらわれろ
かりうける	かりうけろ
繰り寄せる	繰り寄せろ
まくれる	まくれろ
とりちらす	とりちらせ
ものなれる	ものなれろ
角ぐむ	角ぐめ
思いまどう	思いまどえ
押し隠す	押し隠せ
あらそう	あらそえ
取っ付く	取っ付け
血迷う	血迷え
だする	だしろ
絡げる	絡げろ
言い合せる	言い合せろ
かかげる	かかげろ
おいかえせる	おいかえせろ
かつぎ込む	かつぎ込め
切替える	切替えろ
軋む	軋め
切り捲る	切り捲れ
綻ばす	綻ばせ
しのびなく	しのびなけ
つくりだせる	つくりだせろ
ひきしぼれる	ひきしぼれろ
乗回す	乗回せ
かんじとる	かんじとれ
控える	控えろ
わりびく	わりびけ
呼びいれる	呼びいれろ
切伏せる	切伏せろ
掻きたてる	掻きたてろ
煮えたつ	煮えたて
補い合う	補い合え
住み着ける	住み着けろ
寝付く	寝付け
念じる	念じろ
きりまわせる	きりまわせろ
吹っ切る	吹っ切れ
甘ったれる	甘ったれろ
勝ち残る	勝ち残れ
慌てる	慌てろ
癒せる	癒せろ
乗組む	乗組め
咳き上げる	咳き上げろ
つきとめる	つきとめろ
潰れる	潰れろ
わりだせる	わりだせろ
博す	博せ
組み入れる	組み入れろ
かしぐ	かしげ
やり過ごせる	やり過ごせろ
崩ずる	やり過ごせろ
言いおく	言いおけ
有り余る	有り余れ
わらいとばす	わらいとばせ
逃がす	逃がせ
まちがう	まちがえ
ねじきる	ねじきれ
神しずまる	神しずまれ
やとえる	やとえろ
切り伏せる	切り伏せろ
滲む	滲め
あせる	あせろ
ひょうする	ひょうしろ
吸取る	吸取れ
よじのぼる	よじのぼれ
殖やせる	殖やせろ
ちんずる	殖やせろ
またげる	またげろ
繰回す	繰回せ
笑わせる	笑わせろ
ふりしぼる	ふりしぼれ
かつぎあげる	かつぎあげろ
使い切る	使い切れ
脅す	脅せ
歩き疲れる	歩き疲れろ
かたよる	かたよれ
裂ける	裂けろ
帰す	帰せ
かみ合う	かみ合え
分る	分れ
戦える	戦えろ
切りつめる	切りつめろ
言い表せる	言い表せろ
啼く	啼け
たたむ	たため
おこたる	おこたれ
せめる	せめろ
もちなおす	もちなおせ
譲り渡せる	譲り渡せろ
よみする	よみしろ
彌増さる	彌増され
やむ	やめ
長ける	長けろ
おとせる	おとせろ
きがまえる	きがまえろ
乗越す	乗越せ
見渡せる	見渡せろ
かくしもてる	かくしもてろ
かんがえる	かんがえろ
うたがう	うたがえ
損する	損しろ
うめく	うめけ
くらいつく	くらいつけ
返せる	返せろ
すっこむ	すっこめ
運べる	運べろ
まわる	まわれ
おとる	おとれ
萌え出る	萌え出ろ
晴渡る	晴渡れ
果てる	果てろ
録する	録しろ
移せる	移せろ
悄気げる	悄気げろ
言い返せる	言い返せろ
ぎんずる	言い返せろ
止る	止れ
みさげる	みさげろ
阻む	阻め
来なさる	来なされ
折重なる	折重なれ
ふっ飛ぶ	ふっ飛べ
通がる	通がれ
てまどる	てまどれ
しにはてる	しにはてろ
向かい合わす	向かい合わせ
当てはめる	当てはめろ
とびこせる	とびこせろ
ためる	ためろ
なきふす	なきふせ
さらう	さらえ
ぬりたてる	ぬりたてろ
かたりあかせる	かたりあかせろ
接ぎ合せる	接ぎ合せろ
とりだせる	とりだせろ
募る	募れ
ひっこぬく	ひっこぬけ
つけ足す	つけ足せ
見通せる	見通せろ
みあきる	みあきろ
思いあまる	思いあまれ
追う	追え
もれきく	もれきけ
ふゆごもる	ふゆごもれ
飛び歩く	飛び歩け
刷り込む	刷り込め
くいつめる	くいつめろ
くぐる	くぐれ
いいきる	いいきれ
かき合せる	かき合せろ
荒立てる	荒立てろ
閲する	閲しろ
焦げつかす	焦げつかせ
のりまわせる	のりまわせろ
隠す	隠せ
そだつ	そだて
被える	被えろ
でる	でろ
殴れる	殴れろ
洩れる	洩れろ
いびりだす	いびりだせ
しがみつく	しがみつけ
いただく	いただけ
打見る	打見ろ
討取る	討取れ
誤る	誤れ
受流す	受流せ
責め立てる	責め立てろ
尋ねる	尋ねろ
かびる	かびろ
ほおばる	ほおばれ
射抜く	射抜け
啄む	啄め
よりすがる	よりすがれ
浸ける	浸けろ
撃ち破れる	撃ち破れろ
突合せる	突合せろ
謡う	謡え
立ち篭める	立ち篭めろ
のりだす	のりだせ
立ちつくす	立ちつくせ
吹き分ける	吹き分けろ
香る	香れ
せめあぐむ	せめあぐめ
払い戻せる	払い戻せろ
さしかざす	さしかざせ
ひっぱる	ひっぱれ
似つく	似つけ
用いる	用いろ
とりさげる	とりさげろ
取り混ぜる	取り混ぜろ
ほだされる	ほだされろ
いきつける	いきつけろ
目指す	目指せ
立ち直れる	立ち直れろ
惑う	惑え
てつだえる	てつだえろ
きりたおせる	きりたおせろ
ならう	ならえ
拝める	拝めろ
落ちこむ	落ちこめ
かつ	かて
ねらう	ねらえ
焙る	焙れ
としとる	としとれ
犇めく	犇めけ
ごろつく	ごろつけ
翻せる	翻せろ
くずす	くずせ
扱える	扱えろ
哭く	哭け
とびでる	とびでろ
書き留める	書き留めろ
悩む	悩め
のがれる	のがれろ
突き刺さる	突き刺され
役だつ	役だて
とげる	とげろ
勝る	勝れ
ぶった切る	ぶった切れ
読み解く	読み解け
惹く	惹け
きらす	きらせ
穿つ	穿て
巻き付ける	巻き付けろ
るいする	るいしろ
うけあえる	うけあえろ
差し響く	差し響け
ふみつける	ふみつけろ
ならわせる	ならわせろ
りゃくする	りゃくしろ
へせる	へせろ
通いつめる	通いつめろ
なげく	なげけ
みつぐ	みつげ
かがす	かがせ
伸し歩く	伸し歩け
くばれる	くばれろ
縛り付ける	縛り付けろ
みすえる	みすえろ
暮らす	暮らせ
持ちこむ	持ちこめ
掛かる	掛かれ
掻い繕う	掻い繕え
噎せ返る	噎せ返れ
混じる	混じれ
付きまとう	付きまとえ
しんじこめる	しんじこめろ
ゆであがる	ゆであがれ
寇する	寇しろ
振りだす	振りだせ
にごらせる	にごらせろ
取繕う	取繕え
みくだせる	みくだせろ
巻き起こす	巻き起こせ
せり合う	せり合え
こいしたう	こいしたえ
焼付ける	焼付けろ
ほとびる	ほとびろ
怨む	怨め
はじまる	はじまれ
取り直せる	取り直せろ
飽かす	飽かせ
おしいれる	おしいれろ
まぎれる	まぎれろ
かぶりつく	かぶりつけ
あつまる	あつまれ
にげまどう	にげまどえ
誤らせる	誤らせろ
生き抜く	生き抜け
急がす	急がせ
煽る	煽れ
ひねくれる	ひねくれろ
とめゆく	とめゆけ
働き掛ける	働き掛けろ
やきなます	やきなませ
引きずり回す	引きずり回せ
ゆれうごく	ゆれうごけ
伸し掛る	伸し掛れ
消える	消えろ
習う	習え
振掛ける	振掛けろ
おぼめく	おぼめけ
もうしおくれる	もうしおくれろ
しゃぶりつく	しゃぶりつけ
浮出す	浮出せ
喚く	喚け
染みとおる	染みとおれ
標す	標せ
奪える	奪えろ
縁付く	縁付け
歩み寄れる	歩み寄れろ
たいす	たいせ
だまかす	だまかせ
湧く	湧け
コケる	コケろ
ひっ付く	ひっ付け
思いつく	思いつけ
焚ける	焚けろ
溺れる	溺れろ
はかなむ	はかなめ
きりはらえる	きりはらえろ
みまわす	みまわせ
巣ごもる	巣ごもれ
そびやかす	そびやかせ
きずつける	きずつけろ
傷つける	傷つけろ
のっとれる	のっとれろ
えつにいる	えつにいれ
はらだつ	はらだて
預かれる	預かれろ
たる	たれ
煎じる	煎じろ
毀れる	毀れろ
おいさらばえる	おいさらばえろ
おれあう	おれあえ
つき刺さる	つき刺され
笑われる	笑われろ
かき回す	かき回せ
かみあわす	かみあわせ
たかる	たかれ
はたらかす	はたらかせ
織りまぜる	織りまぜろ
縁る	縁れ
取りすがる	取りすがれ
うっちゃらかす	うっちゃらかせ
表わす	表わせ
型どる	型どれ
乗り越せる	乗り越せろ
作り直す	作り直せ
さしちがえる	さしちがえろ
浮き上がる	浮き上がれ
かけはなれる	かけはなれろ
眺める	眺めろ
見離す	見離せ
説き明かす	説き明かせ
すっぽかす	すっぽかせ
いなむ	いなめ
てく	てけ
とうずる	てけ
連れ込む	連れ込め
漉す	漉せ
持ち回る	持ち回れ
しとげる	しとげろ
かき混ぜる	かき混ぜろ
差し掛かる	差し掛かれ
取り散らす	取り散らせ
癒える	癒えろ
晴れ上がる	晴れ上がれ
失する	失しろ
つぎこむ	つぎこめ
言い漏らす	言い漏らせ
おぼす	おぼせ
バレる	バレろ
ほそる	ほそれ
とまどう	とまどえ
ゆる	ゆれ
こさえる	こさえろ
鬻ぐ	鬻げ
めざす	めざせ
蕾む	蕾め
ぬがす	ぬがせ
しゃがめる	しゃがめろ
追い詰める	追い詰めろ
押し通せる	押し通せろ
戸惑う	戸惑え
とりはずせる	とりはずせろ
そむく	そむけ
浮かす	浮かせ
選びとれる	選びとれろ
からむ	からめ
銘打つ	銘打て
振るえる	振るえろ
心得る	心得ろ
混じる	混じろ
付け足す	付け足せ
立ちこめる	立ちこめろ
跳ぶ	跳べ
引抜く	引抜け
出向ける	出向けろ
差つかえる	差つかえろ
わたりあるく	わたりあるけ
つぶる	つぶれ
打捨てる	打捨てろ
申しかねる	申しかねろ
速める	速めろ
賜わる	賜われ
怒らす	怒らせ
なだめる	なだめろ
きどる	きどれ
追い散らす	追い散らせ
知る	知れ
かかれる	かかれろ
かいもどせる	かいもどせろ
笑わす	笑わせ
振舞う	振舞え
うりまくる	うりまくれ
きぶくれる	きぶくれろ
借る	借れ
呼び込む	呼び込め
蹴違える	蹴違えろ
そくす	そくせ
いましめる	いましめろ
さそいあわす	さそいあわせ
ふるい落とせる	ふるい落とせろ
扱く	扱け
平伏す	平伏せ
あぶらぎる	あぶらぎれ
わりだす	わりだせ
突っ放す	突っ放せ
へだてる	へだてろ
なりさがれる	なりさがれろ
呼掛ける	呼掛けろ
点く	点け
せきこむ	せきこめ
かくばる	かくばれ
涙ぐむ	涙ぐめ
画する	画しろ
つまむ	つまめ
靠れる	靠れろ
つかえる	つかえろ
にぎりしめる	にぎりしめろ
小戻す	小戻せ
減ずる	小戻せ
にぎやかす	にぎやかせ
ぶら下がる	ぶら下がれ
売りさばける	売りさばけろ
さておく	さておけ
伸び上がる	伸び上がれ
よびつづける	よびつづけろ
託つ	託て
たずさえる	たずさえろ
つき合せる	つき合せろ
吊り上がる	吊り上がれ
出廻る	出廻れ
かき消える	かき消えろ
したたらす	したたらせ
すがめる	すがめろ
ことづかる	ことづかれ
見通す	見通せ
はがせる	はがせろ
手慣れる	手慣れろ
聞き分ける	聞き分けろ
きあわす	きあわせ
しりあえる	しりあえろ
見破る	見破れ
反る	反れ
しぼむ	しぼめ
才走る	才走れ
形作る	形作れ
片付ける	片付けろ
くる	片付けろ
いあわせる	いあわせろ
引っ被る	引っ被れ
噛み合せる	噛み合せろ
振りさけみる	振りさけみろ
見回す	見回せ
あおむく	あおむけ
すだく	すだけ
えんする	えんしろ
結え付ける	結え付けろ
病む	病め
膨らむ	膨らめ
追いまくる	追いまくれ
捲揚げる	捲揚げろ
引き返す	引き返せ
寝ころべる	寝ころべろ
擦り剥ける	擦り剥けろ
出つくす	出つくせ
思い設ける	思い設けろ
しめせる	しめせろ
終える	終えろ
落とし込める	落とし込めろ
呼寄せる	呼寄せろ
いきのびる	いきのびろ
施せる	施せろ
たもつ	たもて
立てこもれる	立てこもれろ
ふんづける	ふんづけろ
こわす	こわせ
嵩張る	嵩張れ
区切れる	区切れろ
押し込む	押し込め
あらいながす	あらいながせ
おびき出せる	おびき出せろ
とけ込む	とけ込め
持ち寄る	持ち寄れ
もちあるく	もちあるけ
振絞る	振絞れ
しりあう	しりあえ
とまりこむ	とまりこめ
談ずる	とまりこめ
かてる	かてろ
焦がす	焦がせ
思える	思えろ
たどり着ける	たどり着けろ
ひきあわせる	ひきあわせろ
泊り込む	泊り込め
追いはらう	追いはらえ
目ざす	目ざせ
割り切れる	割り切れろ
科する	科しろ
みはなす	みはなせ
しむける	しむけろ
ねじ伏せる	ねじ伏せろ
かえりみる	かえりみろ
引き回す	引き回せ
しく	しけ
かする	かすれ
みちびく	みちびけ
載っかる	載っかれ
ほめる	ほめろ
さきのこる	さきのこれ
悩ます	悩ませ
世慣れる	世慣れろ
にらみ合う	にらみ合え
だぶつく	だぶつけ
住み成す	住み成せ
わく	わけ
垣間見る	垣間見ろ
かくせる	かくせろ
論る	論れ
あたう	あたえ
かけ込む	かけ込め
融かす	融かせ
簸る	簸ろ
きあわせる	きあわせろ
わりつける	わりつけろ
つきあわす	つきあわせ
ひきあう	ひきあえ
まわせる	まわせろ
切裂く	切裂け
たくましゅうする	たくましゅうしろ
かきのこす	かきのこせ
浮く	浮け
いじめる	いじめろ
食らえる	食らえろ
飛び下りる	飛び下りろ
踏み止まる	踏み止まれ
囲う	囲え
なきくずれる	なきくずれろ
賣る	賣れ
掛け合せる	掛け合せろ
射し込む	射し込め
御座る	御座れ
さしあげる	さしあげろ
ふるいおこす	ふるいおこせ
しょぼたれる	しょぼたれろ
ちょろまかす	ちょろまかせ
使いこなせる	使いこなせろ
もえうつる	もえうつれ
いいつかる	いいつかれ
はねのける	はねのけろ
焼払う	焼払え
楽しめる	楽しめろ
たらし込む	たらし込め
這いだす	這いだせ
呼び続ける	呼び続けろ
あわ立つ	あわ立て
めす	めせ
句切る	句切れ
触れこむ	触れこめ
いなおる	いなおれ
分捕る	分捕れ
葺く	葺け
痩せる	痩せろ
引き受ける	引き受けろ
寂れる	寂れろ
たたき込む	たたき込め
判る	判れ
暖まる	暖まれ
漕ぎつける	漕ぎつけろ
咲く	咲け
ほりこめる	ほりこめろ
かみくだく	かみくだけ
伸び上がれる	伸び上がれろ
かいあさる	かいあされ
すが立つ	すが立て
いきせききる	いきせききれ
もえつきる	もえつきろ
ひねりまわす	ひねりまわせ
おいこす	おいこせ
からげる	からげろ
践む	践め
割り込む	割り込め
受け継ぐ	受け継げ
思ひ寄る	思ひ寄れ
こじらす	こじらせ
おしもどす	おしもどせ
はじき返す	はじき返せ
冷やせる	冷やせろ
まじる	まじれ
きりおとす	きりおとせ
さらせる	さらせろ
食い下がれる	食い下がれろ
つくす	つくせ
時雨れる	時雨れろ
座る	座れ
まねる	まねろ
済む	済め
疎んずる	済め
すべりだす	すべりだせ
霜枯れる	霜枯れろ
かんじる	かんじろ
えづく	えづけ
煮立てる	煮立てろ
あびせかける	あびせかけろ
もつれる	もつれろ
押し遣る	押し遣れ
凍りつく	凍りつけ
達っする	達っしろ
資する	資しろ
透かす	透かせ
濁る	濁れ
込み合う	込み合え
えっする	えっしろ
絞り上げる	絞り上げろ
擦り切る	擦り切れ
産す	産せ
仰げる	仰げろ
まいくるう	まいくるえ
寄せ掛ける	寄せ掛けろ
陳ずる	寄せ掛けろ
捲き込む	捲き込め
うちとめる	うちとめろ
ふすべる	ふすべろ
得する	得しろ
ずり上がる	ずり上がれ
踏まえる	踏まえろ
まわれる	まわれろ
いいけす	いいけせ
じゅんじる	じゅんじろ
いてつく	いてつけ
ちらす	ちらせ
遺す	遺せ
拱く	拱け
のめる	のめろ
となりあわす	となりあわせ
ふみこえる	ふみこえろ
誘ふ	誘へ
まいあがる	まいあがれ
打ちだせる	打ちだせろ
蹴返す	蹴返せ
浴びせる	浴びせろ
背く	背け
きめつける	きめつけろ
暮す	暮せ
継る	継れ
問ただす	問ただせ
つかわれだす	つかわれだせ
なさる	なされ
連れあう	連れあえ
ぶんどる	ぶんどれ
押詰める	押詰めろ
ちらかす	ちらかせ
おどしとる	おどしとれ
ひっこせる	ひっこせろ
介す	介せ
ぱさつく	ぱさつけ
抜放つ	抜放て
取出す	取出せ
であえる	であえろ
損なう	損なえ
ほどく	ほどけ
刃向かえる	刃向かえろ
苦しむ	苦しめ
身ごもる	身ごもれ
うすずく	うすずけ
生れる	生れろ
かきのこせる	かきのこせろ
行きつく	行きつけ
飛び違う	飛び違え
むらす	むらせ
やにさがる	やにさがれ
うたう	うたえ
見知る	見知れ
ききとれる	ききとれろ
おいつく	おいつけ
語らう	語らえ
武張る	武張れ
請じ入れる	請じ入れろ
さきだてる	さきだてろ
あがなう	あがなえ
かけ合う	かけ合え
さしころす	さしころせ
ほする	ほしろ
もがける	もがけろ
尽くす	尽くせ
塗る	塗れ
引き取る	引き取れ
出る	出ろ
手掛ける	手掛けろ
かいまみる	かいまみろ
かたむく	かたむけ
開きなおる	開きなおれ
映ろう	映ろえ
にこむ	にこめ
たちどまる	たちどまれ
こいする	こいしろ
現す	現せ
すいつける	すいつけろ
ひき殺す	ひき殺せ
いびる	いびれ
引き退ける	引き退けろ
愛し合える	愛し合えろ
生る	生れ
ぬぐい去る	ぬぐい去れ
表れる	表れろ
寄り添える	寄り添えろ
てばなせる	てばなせろ
表す	表せ
動きだす	動きだせ
せりあえる	せりあえろ
おいあげる	おいあげろ
いいおよぼす	いいおよぼせ
吼える	吼えろ
へんする	へんしろ
ひきかえせる	ひきかえせろ
在りあわせる	在りあわせろ
聞込む	聞込め
よせる	よせろ
ゆりうごかせる	ゆりうごかせろ
むしゃぶりつく	むしゃぶりつけ
にぎりつぶせる	にぎりつぶせろ
おいはらえる	おいはらえろ
見つかる	見つかれ
閃かす	閃かせ
浮き足立つ	浮き足立て
廃る	廃れ
振り向く	振り向け
書き表す	書き表せ
燃え尽きる	燃え尽きろ
生みつける	生みつけろ
みつめる	みつめろ
のぞき込む	のぞき込め
交わる	交われ
思わす	思わせ
やる	やれ
聴く	聴け
にる	にろ
つまる	つまれ
上せる	上せろ
たきしめる	たきしめろ
げする	げしろ
うちきる	うちきれ
触込む	触込め
靡く	靡け
さしつかわす	さしつかわせ
遣りこなす	遣りこなせ
青みがかる	青みがかれ
攻め落す	攻め落せ
掻き混ぜる	掻き混ぜろ
蹶る	蹶れ
せめつける	せめつけろ
引き抜く	引き抜け
ふりおこす	ふりおこせ
仰向ける	仰向けろ
定義付ける	定義付けろ
染めわける	染めわけろ
押し出せる	押し出せろ
しす	しせ
うかれだす	うかれだせ
申し立てる	申し立てろ
いだける	いだけろ
好き好む	好き好め
点ずる	好き好め
枯らす	枯らせ
のびる	のびろ
綴り合す	綴り合せ
見紛う	見紛え
澱む	澱め
巣立てる	巣立てろ
知合う	知合え
紐解ける	紐解けろ
わき起こす	わき起こせ
おもいおよぶ	おもいおよべ
暮れる	暮れろ
かんがえぬく	かんがえぬけ
吐かす	吐かせ
俯く	俯け
空惚ける	空惚けろ
にげだす	にげだせ
色めく	色めけ
からめる	からめろ
いう	いえ
だんずる	いえ
こびへつらう	こびへつらえ
読み込む	読み込め
よじる	よじれ
いたわる	いたわれ
引合う	引合え
行う	行え
押し掛ける	押し掛けろ
捏ねる	捏ねろ
ひきわける	ひきわけろ
分かれる	分かれろ
習わす	習わせ
立のく	立のけ
見やる	見やれ
引き留める	引き留めろ
入り込める	入り込めろ
ひっくり返す	ひっくり返せ
べたつく	べたつけ
のす	のせ
かきすてる	かきすてろ
こびり付く	こびり付け
うきあがる	うきあがれ
吸い込む	吸い込め
きよめる	きよめろ
だいする	だいしろ
写せる	写せろ
さめる	さめろ
補う	補え
起き上がれる	起き上がれろ
とりこめる	とりこめろ
攻める	攻めろ
待ち焦がれる	待ち焦がれろ
にらみ合わす	にらみ合わせ
跡づける	跡づけろ
よりたおせる	よりたおせろ
わりきれる	わりきれろ
報ずる	わりきれろ
およぶ	およべ
備わる	備われ
晴れ渡る	晴れ渡れ
とりはこべる	とりはこべろ
つつみこむ	つつみこめ
てわたせる	てわたせろ
値切る	値切れ
干す	干せ
浮かび上がる	浮かび上がれ
おくりかえす	おくりかえせ
ふっとぶ	ふっとべ
張り合わす	張り合わせ
逃げる	逃げろ
吹まくる	吹まくれ
いいたてる	いいたてろ
行き届く	行き届け
罹る	罹れ
汚れる	汚れろ
罷る	罷れ
立て掛ける	立て掛けろ
すむ	すめ
ぎす	ぎせ
書散らす	書散らせ
涌かす	涌かせ
伝える	伝えろ
そえる	そえろ
打ち消せる	打ち消せろ
ずらかる	ずらかれ
やすらぐ	やすらげ
はしりさる	はしりされ
乱せる	乱せろ
うわまわる	うわまわれ
剥く	剥け
巣くう	巣くえ
引きずる	引きずれ
ゆでこぼす	ゆでこぼせ
押切る	押切れ
草生す	草生せ
撒ける	撒けろ
昂る	昂れ
ひきあわす	ひきあわせ
ぬう	ぬえ
うらがえる	うらがえれ
受け流せる	受け流せろ
たでる	たでろ
つつく	つつけ
籠る	籠れ
余す	余せ
くれのこる	くれのこれ
書き入れる	書き入れろ
取りつける	取りつけろ
飾れる	飾れろ
まねきいれる	まねきいれろ
買いためる	買いためろ
ぬぐい取る	ぬぐい取れ
焼け付く	焼け付け
衰える	衰えろ
げすばる	げすばれ
言捨てる	言捨てろ
開け放つ	開け放て
躍り出る	躍り出ろ
おぼらす	おぼらせ
ため込める	ため込めろ
竄する	竄しろ
ぬいあわせる	ぬいあわせろ
しゃくれる	しゃくれろ
かせげる	かせげろ
素っ破抜く	素っ破抜け
突破る	突破れ
うつろう	うつろえ
もちこたえる	もちこたえろ
見合せる	見合せろ
なびかす	なびかせ
旧る	旧れ
行き暮す	行き暮せ
食い延す	食い延せ
行ける	行けろ
ごまかす	ごまかせ
でっち上げる	でっち上げろ
ひびかす	ひびかせ
もたらす	もたらせ
置く	置け
聞き合わせる	聞き合わせろ
さわげる	さわげろ
勉める	勉めろ
ひびわれる	ひびわれろ
競い立つ	競い立て
瞬く	瞬け
売飛ばす	売飛ばせ
かどわかす	かどわかせ
遷り変る	遷り変れ
ささる	さされ
たりる	たりろ
け落とせる	け落とせろ
いきむ	いきめ
攻め上る	攻め上れ
みれる	みれろ
和する	和しろ
ふるい落す	ふるい落せ
あおのける	あおのけろ
ひきぬける	ひきぬけろ
みはれる	みはれろ
為成す	為成せ
まきちらす	まきちらせ
ねじ合う	ねじ合え
なやみぬく	なやみぬけ
わたりあえる	わたりあえろ
思い切る	思い切れ
できあう	できあえ
とろける	とろけろ
迷う	迷え
おぎなえる	おぎなえろ
熾す	熾せ
高鳴る	高鳴れ
つかわす	つかわせ
立まじる	立まじれ
渫う	渫え
暮れ残る	暮れ残れ
穢す	穢せ
組合す	組合せ
膨らせる	膨らせろ
反らす	反らせ
練り歩く	練り歩け
反っくり返る	反っくり返れ
使い古す	使い古せ
けなす	けなせ
措く	措け
踏みやぶる	踏みやぶれ
殺気だつ	殺気だて
開く	開け
つけたす	つけたせ
ゆき過ぎる	ゆき過ぎろ
刑する	刑しろ
おます	おませ
すみつべる	すみつべろ
付き添える	付き添えろ
うらやむ	うらやめ
しばれる	しばれろ
言い触らす	言い触らせ
委する	委しろ
燃やす	燃やせ
おしかえす	おしかえせ
はせ向う	はせ向え
たどれる	たどれろ
ねじる	ねじれ
やせおとろえる	やせおとろえろ
相うつ	相うて
いいくるめる	いいくるめろ
さざめく	さざめけ
連れ去る	連れ去れ
つらぬける	つらぬけろ
熟す	熟せ
呼び出せる	呼び出せろ
書き表せる	書き表せろ
削げる	削げろ
つとまる	つとまれ
舐る	舐れ
涼める	涼めろ
隠し持てる	隠し持てろ
切りくずす	切りくずせ
眠り込む	眠り込め
つきもどす	つきもどせ
打消せる	打消せろ
激つ	激て
さる	され
混ぜる	混ぜろ
言い残す	言い残せ
雪崩込む	雪崩込め
登りつめる	登りつめろ
銘ずる	登りつめろ
ふせる	ふせろ
みそなはす	みそなはせ
なきしきる	なきしきれ
聞きおよぶ	聞きおよべ
もどす	もどせ
苅る	苅れ
押し寄せる	押し寄せろ
騒ぎ出す	騒ぎ出せ
思う	思え
みくらべる	みくらべろ
まわりこむ	まわりこめ
曲がる	曲がれ
てびかえる	てびかえろ
含む	含め
費える	費えろ
ずるける	ずるけろ
ばたつかせる	ばたつかせろ
能くする	能くしろ
捩じ上げる	捩じ上げろ
くみかわす	くみかわせ
煤ける	煤けろ
入りかわる	入りかわれ
見詰める	見詰めろ
仰せる	仰せろ
ひきよせる	ひきよせろ
うちかさなる	うちかさなれ
獲る	獲ろ
差し遣わす	差し遣わせ
温める	温めろ
吐き出せる	吐き出せろ
問合せる	問合せろ
満たせる	満たせろ
すすり泣く	すすり泣け
ひっこもる	ひっこもれ
うなだれる	うなだれろ
振り切れる	振り切れろ
味わえる	味わえろ
摂る	摂れ
押しだす	押しだせ
ふみこめる	ふみこめろ
待ち受ける	待ち受けろ
事足りる	事足りろ
とりすがる	とりすがれ
喰える	喰えろ
憾む	憾め
こきまぜる	こきまぜろ
済す	済せ
抜連ねる	抜連ねろ
入れ合せる	入れ合せろ
天てらす	天てらせ
言い旧す	言い旧せ
秋めく	秋めけ
払い下げる	払い下げろ
禁ずる	払い下げろ
つりあう	つりあえ
あみ出す	あみ出せ
封じこむ	封じこめ
ひっつく	ひっつけ
なのりでる	なのりでろ
作り上げる	作り上げろ
すみこむ	すみこめ
持あがる	持あがれ
吹すさぶ	吹すさべ
ランクづける	ランクづけろ
野次れる	野次れろ
削り倒せる	削り倒せろ
切あがる	切あがれ
しゃがむ	しゃがめ
突っ転ばす	突っ転ばせ
はしれる	はしれろ
のぞける	のぞけろ
取り抑える	取り抑えろ
奮いおこす	奮いおこせ
つるせる	つるせろ
やすんずる	つるせろ
充たす	充たせ
かけこむ	かけこめ
捲ける	捲けろ
いたす	いたせ
積重なる	積重なれ
言いだす	言いだせ
燃え立つ	燃え立て
はきかける	はきかけろ
引きしぼる	引きしぼれ
経る	経ろ
しでかす	しでかせ
交ぜっ返す	交ぜっ返せ
欠かす	欠かせ
きらめく	きらめけ
綯い交ぜる	綯い交ぜろ
恥づ	綯い交ぜろ
はき出す	はき出せ
引っ提げる	引っ提げろ
好く	好け
ぬく	ぬけ
鋤き起す	鋤き起せ
みいだす	みいだせ
撃ち込む	撃ち込め
繰広げる	繰広げろ
走りでる	走りでろ
もうしわたす	もうしわたせ
取り次ぐ	取り次げ
座れる	座れろ
夾める	夾めろ
ききすます	ききすませ
紛らわす	紛らわせ
装束く	装束け
圧する	圧しろ
ハネ上がる	ハネ上がれ
もちさる	もちされ
食荒らす	食荒らせ
のみほす	のみほせ
取り組む	取り組め
はせる	はせろ
ひっ込める	ひっ込めろ
突き飛ばす	突き飛ばせ
当てる	当てろ
込み入る	込み入れ
痛み入る	痛み入れ
申しあげる	申しあげろ
ではずれる	ではずれろ
やすらう	やすらえ
即す	即せ
ゆりうごかす	ゆりうごかせ
律する	律しろ
言い募る	言い募れ
発す	発せ
煮え立つ	煮え立て
まくしたてる	まくしたてろ
突きだす	突きだせ
言張る	言張れ
でさかる	でさかれ
ききただす	ききただせ
書捨てる	書捨てろ
用立てる	用立てろ
迷い込む	迷い込め
申し付ける	申し付けろ
こきつかう	こきつかえ
ほころばす	ほころばせ
寝っ転がる	寝っ転がれ
わだかまる	わだかまれ
くじける	くじけろ
世離れる	世離れろ
しみ付く	しみ付け
すいこめる	すいこめろ
剰る	剰れ
揺り動かす	揺り動かせ
起る	起れ
掻い込む	掻い込め
撥ねつける	撥ねつけろ
刷り上げる	刷り上げろ
恋焦がれる	恋焦がれろ
覆す	覆せ
脈打つ	脈打て
包み込める	包み込めろ
思い煩う	思い煩え
咎める	咎めろ
ひとなれる	ひとなれろ
ぬぐ	ぬげ
まぜあわす	まぜあわせ
ぶらさげる	ぶらさげろ
当る	当れ
のみこめる	のみこめろ
這いまつわる	這いまつわれ
ふさぎ込む	ふさぎ込め
つぐなう	つぐなえ
曲がれる	曲がれろ
歩み寄る	歩み寄れ
はじらう	はじらえ
ちびる	ちびろ
かき暮れる	かき暮れろ
突きぬける	突きぬけろ
取立てる	取立てろ
己惚れる	己惚れろ
噛みつく	噛みつけ
打返せる	打返せろ
からまる	からまれ
もとづく	もとづけ
まみえる	まみえろ
かんする	かんしろ
擂る	擂れ
薙ぎ払う	薙ぎ払え
高ずる	薙ぎ払え
ゆく	ゆけ
かくしもつ	かくしもて
悟れる	悟れろ
欠ける	欠けろ
切離す	切離せ
諌む	諌め
めもる	めもれ
食い潰す	食い潰せ
組み込める	組み込めろ
もぐる	もぐれ
凄む	凄め
おいぼれる	おいぼれろ
小切る	小切れ
諷する	諷しろ
否む	否め
くいつなぐ	くいつなげ
ことたる	ことたれ
引っ立てる	引っ立てろ
そめだせる	そめだせろ
ひっかかる	ひっかかれ
しぼりだす	しぼりだせ
乗り出す	乗り出せ
弛む	弛め
とりかわせる	とりかわせろ
ききあきる	ききあきろ
流し込める	流し込めろ
みせる	みせろ
たずねあわせる	たずねあわせろ
走り込む	走り込め
ぶっぱなす	ぶっぱなせ
おりたつ	おりたて
供える	供えろ
振り替える	振り替えろ
笑い返す	笑い返せ
憑かれる	憑かれろ
とえる	とえろ
めく	めけ
買い越す	買い越せ
むれる	むれろ
でんぐり返る	でんぐり返れ
書きとる	書きとれ
振払う	振払え
引き起こす	引き起こせ
降り暮す	降り暮せ
よづく	よづけ
にらみあわせる	にらみあわせろ
みかわす	みかわせ
もちまわる	もちまわれ
節くれだつ	節くれだて
増やせる	増やせろ
のぞかせる	のぞかせろ
そよがす	そよがせ
退る	退れ
紛れこむ	紛れこめ
繰上げる	繰上げろ
くっつく	くっつけ
ばらす	ばらせ
かんぐる	かんぐれ
解きほぐす	解きほぐせ
おどりあがる	おどりあがれ
彌次る	彌次れ
せまる	せまれ
列ねる	列ねろ
うつ向く	うつ向け
溶合う	溶合え
配れる	配れろ
ずりあがる	ずりあがれ
困りきる	困りきれ
謂う	謂え
うちつれる	うちつれろ
打くつろぐ	打くつろげ
安んずる	打くつろげ
いいあう	いいあえ
おこなう	おこなえ
示し合せる	示し合せろ
しなす	しなせ
たたきおこせる	たたきおこせろ
向かい合う	向かい合え
飲み回す	飲み回せ
評する	評しろ
言い返す	言い返せ
立直る	立直れ
遠ざかる	遠ざかれ
くりぬける	くりぬけろ
とり除く	とり除け
みかねる	みかねろ
びくつく	びくつけ
ぎょする	ぎょしろ
振りまわす	振りまわせ
けつまずく	けつまずけ
のぼりつめるる	のぼりつめるろ
支える	支えろ
にらみあう	にらみあえ
割振る	割振れ
われる	われろ
行き当る	行き当れ
切りつける	切りつけろ
引き起す	引き起せ
売りまくれる	売りまくれろ
狂する	狂しろ
厭く	厭け
住替る	住替れ
うかれる	うかれろ
折り畳める	折り畳めろ
しょうじいれる	しょうじいれろ
あそびほうける	あそびほうけろ
見分ける	見分けろ
慰む	慰め
立上がる	立上がれ
あたえる	あたえろ
駆けずりまわる	駆けずりまわれ
項垂れる	項垂れろ
ふるまう	ふるまえ
かたぶく	かたぶけ
おさえつける	おさえつけろ
探し求める	探し求めろ
投ずる	探し求めろ
まげる	まげろ
点てる	点てろ
蹴っとばす	蹴っとばせ
富める	富めろ
片づく	片づけ
作り替える	作り替えろ
おもいたつ	おもいたて
祷れる	祷れろ
まとめる	まとめろ
だしきる	だしきれ
させる	させろ
とびちがう	とびちがえ
かけよる	かけよれ
うちぬける	うちぬけろ
つみかえる	つみかえろ
けし飛ぶ	けし飛べ
もちかける	もちかけろ
呼び戻せる	呼び戻せろ
浮かぶ	浮かべ
そだてる	そだてろ
うちこむ	うちこめ
しっける	しっけろ
飛び越せる	飛び越せろ
くつがえす	くつがえせ
かんづく	かんづけ
忍び泣く	忍び泣け
いきあたる	いきあたれ
めくる	めくれ
つきだす	つきだせ
責める	責めろ
咲におう	咲におえ
くらます	くらませ
うらなう	うらなえ
言付かる	言付かれ
バラつく	バラつけ
始める	始めろ
引き止める	引き止めろ
引っかかる	引っかかれ
製する	製しろ
寝ぼける	寝ぼけろ
尽かす	尽かせ
そらんずる	尽かせ
搗く	搗け
思いやる	思いやれ
引受ける	引受けろ
はきかえる	はきかえろ
だきつく	だきつけ
醸し出せる	醸し出せろ
来合せる	来合せろ
睨み合せる	睨み合せろ
すくむ	すくめ
さませる	さませろ
ならせる	ならせろ
燃え広がる	燃え広がれ
紛れ込む	紛れ込め
張り足す	張り足せ
垂こめる	垂こめろ
漉せる	漉せろ
打抜ける	打抜けろ
はさまる	はさまれ
差っ引く	差っ引け
炊く	炊け
とりおく	とりおけ
倦む	倦め
組み合う	組み合え
つくばう	つくばえ
立ちはだかる	立ちはだかれ
打ち返せる	打ち返せろ
繰り出す	繰り出せ
ちかよせる	ちかよせろ
噛む	噛め
べんずる	噛め
わりふれる	わりふれろ
計らう	計らえ
駁する	駁しろ
力づける	力づけろ
書きたてる	書きたてろ
せおいこむ	せおいこめ
乗りかかる	乗りかかれ
取り除ける	取り除けろ
らっしゃる	らっしゃれ
見下ろす	見下ろせ
召し寄せる	召し寄せろ
浮かべる	浮かべろ
あばれる	あばれろ
醒める	醒めろ
つくりあげる	つくりあげろ
憎む	憎め
こけむす	こけむせ
突付ける	突付けろ
きざみつける	きざみつけろ
すり混ぜる	すり混ぜろ
こわせる	こわせろ
塗りつぶす	塗りつぶせ
ほける	ほけろ
おもいなおせる	おもいなおせろ
押しつぶせる	押しつぶせろ
引きだす	引きだせ
あむ	あめ
はしりまわる	はしりまわれ
すくいだせる	すくいだせろ
開き直る	開き直れ
打連れる	打連れろ
わきばさむ	わきばさめ
おもいとどまる	おもいとどまれ
だしきれる	だしきれろ
下る	下れ
鯱張る	鯱張れ
覆る	覆れ
ふきでる	ふきでろ
とりころす	とりころせ
ながしこむ	ながしこめ
受けあう	受けあえ
おっぱらう	おっぱらえ
積める	積めろ
清める	清めろ
有る	有れ
到る	到れ
吸いつける	吸いつけろ
取り離す	取り離せ
突きあわせる	突きあわせろ
貼る	貼れ
片づける	片づけろ
おっことす	おっことせ
掻きまぜる	掻きまぜろ
がんばれる	がんばれろ
撤する	撤しろ
飛び出でる	飛び出でろ
追い込む	追い込め
きたえる	きたえろ
取り外す	取り外せ
ふみにじれる	ふみにじれろ
さしひびく	さしひびけ
放りだす	放りだせ
ゆらす	ゆらせ
けたてる	けたてろ
立ちあがる	立ちあがれ
くりこめる	くりこめろ
さけべる	さけべろ
きめこむ	きめこめ
飛び越す	飛び越せ
しむ	しめ
だせる	だせろ
霜がれる	霜がれろ
だっする	だっしろ
ふやせる	ふやせろ
言い誤る	言い誤れ
引っ越す	引っ越せ
あるきまわれる	あるきまわれろ
むしかえす	むしかえせ
のりきれる	のりきれろ
打立てる	打立てろ
合す	合せ
とりのぼせる	とりのぼせろ
やり直せる	やり直せろ
務まる	務まれ
炊ける	炊けろ
かう	かえ
ぬげる	ぬげろ
数えたてる	数えたてろ
きりすてる	きりすてろ
見出す	見出せ
うえつける	うえつけろ
くちごもる	くちごもれ
こう	こえ
読みかける	読みかけろ
おだてる	おだてろ
とじこむ	とじこめ
ゆう	ゆえ
綴じる	綴じろ
悦に入る	悦に入れ
せせら笑う	せせら笑え
申し上げる	申し上げろ
寝過ごす	寝過ごせ
作りだす	作りだせ
うちとれる	うちとれろ
たしかめる	たしかめろ
なづける	なづけろ
あっする	あっしろ
きわだつ	きわだて
打合わす	打合わせ
けんする	けんしろ
そい遂げる	そい遂げろ
推し移る	推し移れ
擦れあう	擦れあえ
相成る	相成れ
口走る	口走れ
為損なう	為損なえ
変わる	変われ
抑える	抑えろ
継ぎ足せる	継ぎ足せろ
振向ける	振向けろ
溶かせる	溶かせろ
打ちつける	打ちつけろ
煤ばむ	煤ばめ
よろめく	よろめけ
見切れる	見切れろ
とり上げる	とり上げろ
虐げる	虐げろ
おいもとめる	おいもとめろ
燻らす	燻らせ
立ち直る	立ち直れ
ふりはらう	ふりはらえ
すくみあがる	すくみあがれ
とりあわせる	とりあわせろ
突っきる	突っきれ
誘く	誘け
漬ける	漬けろ
そわる	そわれ
つみたてる	つみたてろ
はかどる	はかどれ
萌す	萌せ
きりとる	きりとれ
あやまらす	あやまらせ
乾く	乾け
打砕ける	打砕けろ
たのみこめる	たのみこめろ
並び立てる	並び立てろ
痛む	痛め
冒す	冒せ
買いたたく	買いたたけ
選びだす	選びだせ
渡り歩く	渡り歩け
張り切れる	張り切れろ
爪繰る	爪繰れ
取りのける	取りのけろ
切放す	切放せ
いつくしむ	いつくしめ
ゆきとどく	ゆきとどけ
ぐちる	ぐちれ
耳だつ	耳だて
またせる	またせろ
さがしあてる	さがしあてろ
成り変わる	成り変われ
待たす	待たせ
みはる	みはれ
そめつける	そめつけろ
取り仕切る	取り仕切れ
呪う	呪え
とりよせる	とりよせろ
さそいだせる	さそいだせろ
すいよせる	すいよせろ
汲みだす	汲みだせ
立て直せる	立て直せろ
うごける	うごけろ
うずまる	うずまれ
しらける	しらけろ
零れる	零れろ
くける	くけろ
けずる	けずれ
おしつぶせる	おしつぶせろ
明け暮れる	明け暮れろ
おどりあかす	おどりあかせ
勇み立つ	勇み立て
ふるえ上がる	ふるえ上がれ
塞げる	塞げろ
かすめる	かすめろ
乗りこなせる	乗りこなせろ
抉る	抉れ
差し上げる	差し上げろ
行きあたる	行きあたれ
薄らぐ	薄らげ
救ける	救けろ
きりそろえる	きりそろえろ
ぬらつく	ぬらつけ
けどる	けどれ
成りすます	成りすませ
移す	移せ
推せる	推せろ
当て嵌る	当て嵌れ
はり合う	はり合え
馴れあう	馴れあえ
繰越す	繰越せ
刈り取る	刈り取れ
ぬりたくる	ぬりたくれ
見霽かす	見霽かせ
断ち切る	断ち切れ
捲したてる	捲したてろ
まとめあげる	まとめあげろ
うちみる	うちみろ
添わせる	添わせろ
釣上がる	釣上がれ
すみつぶ	すみつべ
こぎつく	こぎつけ
涙す	涙せ
待ち合わせる	待ち合わせろ
くみだす	くみだせ
貼れる	貼れろ
願える	願えろ
詰め寄る	詰め寄れ
ゆき着く	ゆき着け
属す	属せ
通える	通えろ
焼き切る	焼き切れ
干上がる	干上がれ
縫い合わす	縫い合わせ
かたりあう	かたりあえ
しおたれる	しおたれろ
断ずる	しおたれろ
うきあしだつ	うきあしだて
そぼつ	そぼて
おしひろめる	おしひろめろ
追付く	追付け
急き込む	急き込め
射すくめる	射すくめろ
話しこむ	話しこめ
うらがれる	うらがれろ
煮えくり返る	煮えくり返れ
組立てる	組立てろ
煌む	煌め
おもいかえす	おもいかえせ
捧げる	捧げろ
すく	すけ
会う	会え
はんする	はんしろ
つかみあう	つかみあえ
はらいだせる	はらいだせろ
いきおいづく	いきおいづけ
剪む	剪め
泣きじゃくる	泣きじゃくれ
とびまわれる	とびまわれろ
押し開く	押し開け
くだける	くだけろ
そめる	そめろ
上げる	上げろ
溯る	溯れ
長らえる	長らえろ
ちらかる	ちらかれ
相継ぐ	相継げ
引越す	引越せ
ふりさけみる	ふりさけみろ
ちらつく	ちらつけ
透る	透れ
ほお張る	ほお張れ
干割れる	干割れろ
骨張る	骨張れ
打ち破れる	打ち破れろ
こする	こしろ
尋ね合せる	尋ね合せろ
成り代わる	成り代われ
まがれる	まがれろ
とりくずす	とりくずせ
揺るぐ	揺るげ
略せる	略せろ
かまえる	かまえろ
組み伏せる	組み伏せろ
具する	具しろ
傾く	傾け
生き残る	生き残れ
のし上がれる	のし上がれろ
命ずる	のし上がれろ
よろこぶ	よろこべ
狩る	狩れ
繋がる	繋がれ
すぼむ	すぼめ
ねらいうてる	ねらいうてろ
さわがす	さわがせ
竦める	竦めろ
そぼ降る	そぼ降れ
うりこめる	うりこめろ
負う	負え
くすぶる	くすぶれ
みなれる	みなれろ
知り抜く	知り抜け
とりまく	とりまけ
こころざす	こころざせ
吹雪く	吹雪け
用だつ	用だて
もどれる	もどれろ
ころげこむ	ころげこめ
くいとめる	くいとめろ
かんれんづける	かんれんづけろ
曲る	曲れ
出会す	出会せ
透す	透せ
涙する	涙しろ
そうなる	そうなれ
生き返る	生き返れ
損ずる	生き返れ
鋏む	鋏め
軋る	軋れ
おじゃる	おじゃれ
やって退ける	やって退けろ
さらす	さらせ
いんしょうづける	いんしょうづけろ
いからせる	いからせろ
似せる	似せろ
立ち代る	立ち代れ
みやぶる	みやぶれ
まぎらす	まぎらせ
ささやきあう	ささやきあえ
身じろぐ	身じろげ
しりぞく	しりぞけ
おきだせる	おきだせろ
記す	記せ
攻め落とせる	攻め落とせろ
そそぎいれる	そそぎいれろ
透き通る	透き通れ
かいこむ	かいこめ
みせかける	みせかけろ
片付く	片付け
釣上げる	釣上げろ
のける	のけろ
おもいしらせる	おもいしらせろ
やせ細る	やせ細れ
理解し合える	理解し合えろ
ていぎづける	ていぎづけろ
つなぎとめる	つなぎとめろ
残せる	残せろ
突放す	突放せ
請する	請しろ
落とせる	落とせろ
縮らす	縮らせ
うつ伏す	うつ伏せ
絶え果てる	絶え果てろ
起きあがれる	起きあがれろ
まつれる	まつれろ
でる	でろ
力む	力め
ダブる	ダブれ
一皮むける	一皮むけろ
糺す	糺せ
抜きだす	抜きだせ
逃げ切る	逃げ切れ
すべれる	すべれろ
突っ撥ねる	突っ撥ねろ
秀でる	秀でろ
つけ狙う	つけ狙え
抱込む	抱込め
きっする	きっしろ
泣かせる	泣かせろ
打ち据える	打ち据えろ
酔潰れる	酔潰れろ
捜し出す	捜し出せ
たたす	たたせ
くるめく	くるめけ
充つ	充て
巫山戯る	巫山戯ろ
暴く	暴け
蹴上げる	蹴上げろ
咲き揃う	咲き揃え
そぐう	そぐえ
捏ち上げる	捏ち上げろ
躍り上がる	躍り上がれ
乗りかえる	乗りかえろ
約める	約めろ
読み取れる	読み取れろ
漂わす	漂わせ
あせする	あせしろ
瞑する	瞑しろ
けおとせる	けおとせろ
めぐる	めぐれ
きりはなせる	きりはなせろ
差替える	差替えろ
もちこせる	もちこせろ
打ち払う	打ち払え
たえしのべる	たえしのべろ
坐り込む	坐り込め
読みふける	読みふけれ
かじける	かじけろ
聞入れる	聞入れろ
呻く	呻け
けんしきばる	けんしきばれ
書き込む	書き込め
仄めく	仄めけ
滲みる	滲みろ
言える	言えろ
解き離す	解き離せ
口説き落とす	口説き落とせ
引回す	引回せ
買い取れる	買い取れろ
出し抜く	出し抜け
めんずる	出し抜け
立迷う	立迷え
いいはなつ	いいはなて
すかす	すかせ
やくだつ	やくだて
消え去る	消え去れ
待ちこがれる	待ちこがれろ
長びく	長びけ
しぼりとる	しぼりとれ
斎う	斎え
脂下がる	脂下がれ
かきしるす	かきしるせ
知ろし食す	知ろし食せ
やきはらう	やきはらえ
めぐむ	めぐめ
働かす	働かせ
手間どる	手間どれ
呟く	呟け
投げだす	投げだせ
かぶる	かぶれ
くりゃる	くりゃれ
凍る	凍れ
書き出す	書き出せ
喋る	喋れ
へいする	へいしろ
言い表す	言い表せ
ふきこぼれる	ふきこぼれろ
疵付ける	疵付けろ
はねあげる	はねあげろ
吹飛ばす	吹飛ばせ
有りふれる	有りふれろ
行き詰る	行き詰れ
りきむ	りきめ
おもいとまる	おもいとまれ
にたつ	にたて
追っ掛ける	追っ掛けろ
しめる	しめれ
侍る	侍れ
しおる	しおれ
へるる	へるろ
攻め立てる	攻め立てろ
ついやす	ついやせ
づく	づけ
説き付ける	説き付けろ
振り出す	振り出せ
おどりこむ	おどりこめ
吟ずる	おどりこめ
篭める	篭めろ
近寄れる	近寄れろ
きばれる	きばれろ
すみきる	すみきれ
訪ねる	訪ねろ
そわせる	そわせろ
しのばせる	しのばせろ
接ぐ	接げ
たぐる	たぐれ
せぎる	せぎれ
耐える	耐えろ
よりあう	よりあえ
あいてどる	あいてどれ
攻寄せる	攻寄せろ
棚びく	棚びけ
うながす	うながせ
射止める	射止めろ
担ぐ	担げ
よびたてる	よびたてろ
落ち着ける	落ち着けろ
吊るせる	吊るせろ
広める	広めろ
うらがえす	うらがえせ
ねむる	ねむれ
ふんぞり返る	ふんぞり返れ
骨折る	骨折れ
托す	托せ
どく	どけ
さんじる	さんじろ
撃ち取る	撃ち取れ
取りあつめる	取りあつめろ
並み居る	並み居ろ
集める	集めろ
給わる	給われ
逢える	逢えろ
端折る	端折れ
たちわる	たちわれ
取崩す	取崩せ
あるきはじめる	あるきはじめろ
ひきしめる	ひきしめろ
かきなす	かきなせ
決めつける	決めつけろ
くみいれる	くみいれろ
はげる	はげろ
めぐまれる	めぐまれろ
為る	為れ
強がる	強がれ
鳴らせる	鳴らせろ
舁く	舁け
かきくだす	かきくだせ
浮かれだす	浮かれだせ
達す	達せ
つるむ	つるめ
詰め切る	詰め切れ
訳する	訳しろ
淀む	淀め
はなしあう	はなしあえ
かっぱらう	かっぱらえ
聞き出す	聞き出せ
持ち堪える	持ち堪えろ
たばさむ	たばさめ
切り落とせる	切り落とせろ
散らかる	散らかれ
載っける	載っけろ
笑い飛ばす	笑い飛ばせ
かいする	かいしろ
かきならす	かきならせ
吹こぼれる	吹こぼれろ
考え出せる	考え出せろ
よくする	よくしろ
裁く	裁け
ふみやぶる	ふみやぶれ
組み付く	組み付け
繰り広げる	繰り広げろ
きりつめる	きりつめろ
翳す	翳せ
閊える	閊えろ
さす	させ
ききかじる	ききかじれ
欹てる	欹てろ
投棄てる	投棄てろ
かたる	かたれ
馨る	馨れ
おほとのごもる	おほとのごもれ
かち取れる	かち取れろ
存える	存えろ
さまよえる	さまよえろ
切りとる	切りとれ
ゆがく	ゆがけ
すれる	すれろ
徹する	徹しろ
燃え付く	燃え付け
かどばる	かどばれ
まいる	まいれ
結び付く	結び付け
気負い立つ	気負い立て
組みつける	組みつけろ
代われる	代われろ
舞える	舞えろ
しみ入る	しみ入れ
つきたてる	つきたてろ
入りこむ	入りこめ
包む	包め
咬める	咬めろ
飾りつける	飾りつけろ
はらだてる	はらだてろ
あえぐ	あえげ
鳴り渡る	鳴り渡れ
執り行える	執り行えろ
忍ばす	忍ばせ
召捕る	召捕れ
突き通す	突き通せ